ܐܦܪܝܩܐ	Африка
ܝܦܢ	Япония
ܐܡܪܝܩܐ ܬܝܡܢܝܬܐ	Южная Америка
ܢܘܪܒܝܓ	Норвегия
ܩܘܛܢܝܘܬܐ ܕܐܝܪܠܢܕ	Ирландия
ܡܓܪ	Венгрия
ܐܣܦܢܝܐ	Испания
ܐܘܚܕܢܐ ܡܚܝܕܐ	Соединённые Штаты Америки
ܒܠܓܝܩܐ	Бельгия
ܠܘܟܣܡܒܘܪܓ	Люксембург
ܬܒܝܠ	Вселенная
ܐܪܥܐ	Земля
ܡܘܬܐ	Смерть
ܒܪ ܐܢܫܐ	Человек разумный
ܓܘܪܓ ܘܐܫܝܢܓܛܘܢ	Вашингтон, Джордж
ܦܝܢܠܢܕ	Финляндия
ܣܘܝܕ	Швеция
ܕܐܢܡܐܪܩ	Дания
ܦܘܠܢܕ	Польша
ܠܬܘܢܝܐ	Литва
ܐܝܛܠܝܐ	Италия
ܣܘܝܣܪܐ	Швейцария
ܢܡܣܐ	Австрия
ܝܘܢ	Греция
ܛܘܪܩܝܐ	Турция
ܦܘܪܛܘܓܠ	Португалия
ܐܘܪܘܦܐ (ܝܒܫܬܐ)	Европа
ܐܣܝܐ (ܝܒܫܬܐ)	Азия
ܐܡܪܝܩܐ ܓܪܒܝܝܬܐ	Северная Америка
ܐܢܛܐܪܩܛܝܩܐ	Антарктида
ܘܝܩܝܦܕܝܐ	Википедия
ܗܘܠܢܕܐ	Нидерланды
ܢܝܘ ܝܘܪܩ (ܡܕܝܢܬܐ)	Нью-Йорк
ܘܐܫܢܓܛܘܢ (ܐܪܫܟܝܬܐ)	Вашингтон (округ Колумбия)
ܒܪܠܝܢ	Берлин
ܚܫܘܒܐ (ܡܐܟܢܐ)	Компьютер
ܒܪܢ	Берн
ܬܣܝܪܝܟ	Цюрих
ܐܢܛܪܢܛ	Интернет
ܒܪܐܩ ܐܘܒܐܡܐ	Обама, Барак
ܠܘܢܕܘܢ	Лондон
ܐܠܟܣܢܕܪܝܐ	Александрия
ܚܙܘܪܐ	Яблоко
ܦܐܪܝܣ	Париж
ܡܟܣܝܩܘ	Мексика
ܐܘܩܝܢܘܣ ܐܛܠܢܛܝܐ	Атлантический океан
ܐܘܩܝܢܘܣ ܫܝܢܝܐ	Тихий океан
ܒܘܣܛܘܢ	Бостон
ܬܪܝܢܒܫܒܐ	Понедельник
ܟܢܘܢ ܒ	Январь
ܫܒܛ	Февраль
ܐܕܪ	Март
ܟܘܫ	Эфиопия
ܢܝܣܢ	Апрель
ܐܝܪ	Май
ܚܙܝܪܢ	Июнь
ܬܡܘܙ	Июль
ܐܒ	Август
ܐܝܠܘܠ	Сентябрь
ܬܫܪܝܢ ܐ	Октябрь
ܬܫܪܝܢ ܒ	Ноябрь
ܟܢܘܢ ܐ	Декабрь
ܬܠܬܒܫܒܐ	Вторник
ܐܪܒܥܒܫܒܐ	Среда
ܚܡܫܒܫܒܐ	Четверг
ܥܪܘܒܬܐ	Пятница
ܫܒܬܐ (ܙܒܢܐ)	Суббота
ܚܕܒܫܒܐ	Воскресенье
ܐܪܝܐ	Лев
ܦܪܢܣܐ	Франция
ܟܠܒܐ	Собака
ܡܠܟܘܬܐ ܡܚܝܕܬܐ	Великобритания
ܩܛܐ	Кошка
ܩܘܛܢܝܘܬܐ ܥܡܡܝܬܐ ܕܨܝܢ	Китайская Народная Республика
ܠܫܢܐ ܦܪܢܣܝܐ	Французский язык
ܒܪܐܙܝܠ	Бразилия
ܪܘܣܝܐ	Россия
ܝܡܐ	Море
ܝܡܐ ܐܘܟܡܐ	Чёрное море
Π	Пи (буква)
ܐܠܒܐܡܐ	Алабама
ܣܐܘ ܦܐܘܠܘ	Сан-Паулу
ܩܝܒܩ (ܗܘܦܪܟܝܐ)	Квебек
ܓܪܡܢ	Германия
ܒܠܐܪܘܣ	Белоруссия
ܠܫܢܐ ܓܪܡܢܝܐ	Немецкий язык
ܐܠܗܐ	Бог
ܐܣܛܘܢܝܐ	Эстония
ܛܝܣܬܐ	Самолёт
ܩܪܒܐ	Война
1 (ܡܢܝܢܐ)	1 (число)
2 (ܡܢܝܢܐ)	2 (число)
3 (ܡܢܝܢܐ)	3 (число)
4 (ܡܢܝܢܐ)	4 (число)
5 (ܡܢܝܢܐ)	5 (число)
ܠܐܛܒܝܐ	Латвия
ܐܘܩܪܐܝܢܐ	Украина
ܬܫܝܟ	Чехия
ܣܠܘܒܩܝܐ	Словакия
ܣܠܘܒܢܝܐ	Словения
ܡܘܠܕܘܒܐ	Молдавия
ܪܘܡܢܝܐ	Румыния
ܒܘܠܓܐܪܝܐ	Болгария
ܪܗܘܡܐ (ܡܕܝܢܬܐ)	Рим
ܩܘܛܢܝܘܬܐ ܕܡܩܕܘܢܝܐ	Республика Македония
ܐܠܒܢܝܐ	Албания
ܩܪܘܐܛܝܐ	Хорватия
ܒܘܣܢܐ ܘܗܪܬܣܓܘܒܝܢܐ	Босния и Герцеговина
ܐܙܪܒܝܓܐܢ	Азербайджан
ܐܢܕܘܪܐ	Андорра
ܩܘܦܪܘܣ	Республика Кипр
ܓܘܪܓܝܐ (ܐܬܪܐ)	Грузия
ܩܙܩܣܛܐܢ	Казахстан
ܡܝܠܛܐ	Мальта
ܡܘܢܐܩܘ	Монако
ܛܘܪܐ ܐܘܟܡܐ	Черногория
ܡܕܝܢܬܐ ܕܘܛܝܩܢ	Ватикан
ܣܢ ܡܪܝܢܘ	Сан-Марино
ܒܪܘܟܣܠ	Брюссельский столичный регион
ܠܘܕܒܝܓ ܒܐܢ ܒܝܛܗܘܒܢ	Бетховен, Людвиг ван
ܠܫܢܐ ܛܘܪܩܝܐ	Турецкий язык
ܓܙܐܐܪ	Алжир
ܐܘܙܒܩܣܛܐܢ	Узбекистан
ܘܐܪܣܘ	Варшава
ܚܡܪܐ (ܫܬܝܐ)	Вино
ܡܝܐ	Вода
ܦܪܣ ܚܙܘܐ	Телевидение
ܬܫܝܠܝ	Чили
ܐܠ ܓܪܝܩܘ	Эль Греко
ܝܫܘܥ	Иисус Христос
ܠܫܢܐ (ܡܡܠܠܐ)	Язык
ܫܘܠܛܢ ܛܪܘܢܘܬܐ	Диктатура
ܡܡܠܠܘܬ ܟܘܟܒܐ	Астрономия
ܡܪܝܡ (ܐܡܗ ܕܝܫܘܥ)	Богородица
ܠܝܟܛܢܫܛܝܢ	Лихтенштейн
ܐܕܘܠܦ ܗܝܛܠܪ	Гитлер, Адольф
ܠܝܢܘܟܣ	Linux
ܠܫܢܐ ܠܐܛܝܢܝܐ	Латинский язык
ܒܚܪܝܢ	Бахрейн
ܐܪܡܢܝܐ	Армения
ܣܪܒܝܐ	Сербия
ܣܗܪܐ	Луна
ܐܝܣܛܢܒܘܠ (ܡܕܝܢܬܐ)	Стамбул
ܐܘܣܛܪܠܝܐ (ܐܬܪܐ)	Австралия
ܦܝܣܝܟ	Физика
ܩܘܪܐܢ	Коран
ܐܣܠܐܡ	Ислам
ܟܡܬܪܐ	Груша
ܠܟ ܒܐܘܢܣܐ	Валенса, Лех
ܫܠܡܐ (ܫܝܢܐ)	Мир (отсутствие войны)
ܚܘܝܕܐ ܐܘܪܘܦܝܐ	Европейский союз
ܐܢܬܬܐ	Женщина
ܛܝܙܐ	Анус
ܫܚܬܐ (ܝܘܠܦܢ ܨܪܘܝܘܬܐ)	Подмышка
ܗܒܒܐ	Цветок
ܝܘܠܦܢ ܨܪܘܝܘܬܐ	Анатомия
ܡܕܝܢܬܐ	Город
ܢܐܦܠܝܘܢ ܒܘܢܐܦܪܛ	Наполеон I
ܟܘܟܒܐ	Звезда
ܫܡܫܐ	Солнце
ܩܪܝܬܐ	Село
ܝܡܐ ܕܡܕܢܚܐ	Балтийское море
ܫܢܐ	Зуб (биология)
ܘܝܩܝܡܝܕܝܐ ܩܘܡܡܘܢܣ	Викисклад
ܟܬܒܐ (ܣܦܪܐ)	Книга
ܝܘܡܐ	Сутки
ܠܠܝܐ	Ночь
ܫܢܬܐ (ܙܒܢܐ)	Год
ܕܪܐ	Век
ܐܘܣܠܘ	Осло
ܠܫܒܘܢܐ	Лиссабон
ܦܠܝܛܐ	Планета
ܙܡܪܘܬܐ	Музыка
ܡܘܣܩܒܐ	Москва
ܠܫܢܐ ܐܝܛܠܝܐ	Итальянский язык
ܬܫܐܕ	Чад
ܬܝܡܢܐ	Север
ܢܝܘ ܙܝܠܢܕ	Новая Зеландия
ܓܪܒܝܐ	Юг
ܗܢܕܘ	Индия
ܦܪܙܠܐ	Железо
ܡܥܪܒܐ	Запад
ܡܕܢܚܐ	Восток
ܒܢܙܘܝܠܐ	Венесуэла
ܛܠܦܣܢܐ	Шахматы
ܡܝܢ	Мэн (штат)
ܣܘܣܝܐ	Домашняя лошадь
ܐܡܣܛܪܕܐܡ	Амстердам
ܙܝܢܐ	Оружие
ܚܝܘܬܐ	Животные
ܩܘܠܘܡܒܝܐ	Колумбия
ܢܝܘ ܗܐܡܦܫܪ	Нью-Гэмпшир
ܠܝܘܢܪܕܘ ܕܗ ܒܢܬܫܝ	Леонардо да Винчи
ܡܐܣܐܬܫܘܣܬܣ	Массачусетс
ܐܘܛܪܝܟܛ (ܗܘܦܪܟܝܐ)	Утрехт (провинция)
ܟܘܢܝܬܝܟܬ	Коннектикут
ܐܝܪܐܢ	Иран
ܥܝܪܐܩ	Ирак
ܐܠܐܣܟܐ	Аляска
ܐܝܣܪܐܝܠ	Израиль
ܐܘܛܪܝܟܛ (ܡܕܝܢܬܐ)	Утрехт
ܝܡܢ	Йемен
ܠܫܢܐ ܦܘܠܢܕܝܐ	Польский язык
ܝܘܪܕܢܢ	Иордания
ܩܝܪܓܝܙܣܛܐܢ	Киргизия
ܐܪܝܙܘܢܐ	Аризона
ܟܘܘܝܬ (ܐܬܪܐ)	Кувейт
ܠܒܢܢ	Ливан
ܐܘܪܝܓܘܢ	Орегон
ܐܡܪܝܩܐ	Америка
ܝܘܬܐ	Юта
ܥܘܡܐܢ	Оман
ܦܐܩܣܛܐܢ	Пакистан
ܩܛܪ	Катар
ܣܥܘܕܝܐ	Саудовская Аравия
ܝܘܣܦ ܣܛܐܠܝܢ	Сталин, Иосиф Виссарионович
ܣܘܪܝܐ	Сирия
ܛܐܓܝܩܣܛܐܢ	Таджикистан
ܦܪܣ ܩܠܐ	Радио
ܛܘܪܩܡܢܣܛܐܢ	Туркмения
ܐܡܝܪܘܬܐ ܥܪܒܝܬܐ ܡܚܝܕܬܐ	Объединённые Арабские Эмираты
ܐܦܓܐܢܣܛܐܢ	Афганистан
ܕܗܒܐ	Золото
ܡܠܝ	Мали
ܦܝܠܝܦܝܢܝܐ	Филиппины
ܩܘܛܢܝܘܬܐ ܕܐܦܪܝܩܐ ܡܨܥܝܬܐ	Центральноафриканская Республика
ܐܝܣܚܩ ܢܝܘܛܢ	Ньютон, Исаак
ܫܥܘܬܐ (ܓܘܢܐ)	Жёлтый цвет
ܬܘܢܣ (ܐܬܪܐ)	Тунис
ܬܝܡܢܐ ܕܣܘܕܐܢ	Южный Судан
ܩܘܛܢܝܘܬܐ ܕܩܘܢܓܘ	Республика Конго
ܩܘܛܢܝܘܬܐ ܕܩܘܢܓܘ ܕܝܡܘܩܪܛܝܬܐ	Демократическая Республика Конго
ܦܐܦܐ ܝܘܚܢܢ ܦܘܠܘܣ ܬܪܝܢܐ	Иоанн Павел II
ܛܒܝܠܝܣܝ	Тбилиси
ܩܐܡܪܘܢ	Камерун
ܠܘܒܐ	Ливия
ܡܘܪܝܛܢܝܐ	Мавритания
ܡܓܪܒ	Марокко
ܢܝܓܪ	Нигер
ܣܘܕܐܢ	Судан
ܩܫܬܐ ܕܡܪܢ	Радуга
ܗܐܡܒܘܪܓ	Гамбург
ܝܡܬܐ ܕܐܘܢܛܪܝܘ	Онтарио (озеро)
ܝܡܬܐ ܕܣܘܦܝܪܝܘܪ	Верхнее (озеро)
ܓܐܘܓܪܦܝܐ	География
ܠܒܐ	Сердце
ܡܘܚܐ	Головной мозг
ܓܠܕܐ	Кожа
ܓܘܢܐ	Цвет
ܦܪܐܓ	Прага
ܙܪܩܐ	Синий цвет
ܟܣܦܐ (ܣܐܡܐ)	Серебро
ܡܫܝܓܢ	Мичиган
ܝܡܬܐ ܕܡܝܫܝܓܢ	Мичиган (озеро)
ܐܠܝܢܘܝ	Иллинойс
ܢܘܪܬ ܕܐܟܘܬܐ	Северная Дакота
ܣܐܘܬ ܕܐܟܘܬܐ	Южная Дакота
ܡܘܢܬܐܢܐ	Монтана
ܘܐܝܘܡܝܢܓ	Вайоминг
ܐܘܪܫܠܡ	Иерусалим
ܐܝܕܐܗܘ	Айдахо
ܢܝܒܐܕܐ	Невада
ܐܘܩܝܢܘܣ ܗܢܕܘܝܐ	Индийский океан
ܟܘܠܘܪܐܕܘ	Колорадо
ܫܝܩܓܘ	Чикаго
ܣܬܘܐ	Зима
ܬܕܐܐ	Весна
ܩܝܛܐ	Лето
ܬܫܪܝܬܐ	Осень
ܨܕܐܡ ܚܘܣܝܢ	Саддам Хусейн
ܠܫܢܐ ܐܣܦܢܝܐ	Испанский язык
ܓܘܓܝ	Пауки
ܐܒܐ (ܦܐܪܐ)	Плод
ܩܘܦܐ	Обезьяны
ܒܪܓܝܢܝܐ	Виргиния
ܝܡܬܐ ܕܝܘܪܘܢ	Гурон
ܢܝܘ ܝܘܪܩ (ܐܘܚܕܢܐ ܡܚܝܕܐ)	Нью-Йорк (штат)
ܪܘܕ ܐܝܠܐܢܕ	Род-Айленд
ܪܚܫܐ	Насекомые
ܡܐܪܝܠܐܢܕ	Мэриленд
ܕܝܠܐܘܝܪ	Делавэр
ܐܘܗܐܝܘ	Огайо
ܦܢܣܝܠܒܐܢܝܐ	Пенсильвания
ܐܝܛܙܢ	Итерзен
ܐܓܘܣܛܘܣ ܩܣܪ	Октавиан Август
ܢܝܘ ܓܝܪܣܝ	Нью-Джерси
ܐܢܕܝܐܢܐ	Индиана
ܪܕܝܬܐ	Автомобиль
ܓܘܪܓܝܐ (ܐܘܚܕܢܐ ܡܚܝܕܐ)	Джорджия
ܣܩܠܝܐ	Сицилия
ܣܢ (ܢܗܪܐ)	Сена
ܛܘܩܝܘ	Токио
ܦܪܕܝܢܢܕ ܡܓܝܠܢ	Магеллан, Фернан
ܢܝܘ ܡܝܟܣܝܟܘ	Нью-Мексико
ܐܬܢܘܣ	Афины
ܡܢܝܣܘܬܐ	Миннесота
ܒܓܕܐܕ (ܡܕܝܢܬܐ)	Багдад
ܘܝܣܟܘܢܣܢ	Висконсин
ܐܝܐܘܐ	Айова
ܢܝܒܪܐܣܟܐ	Небраска
ܟܐܢܣܐܣ	Канзас
ܡܝܙܘܪܝ	Миссури (штат)
ܐܪܟܢܣܐܣ	Арканзас
ܠܫܢܐ ܕܐܘܪܕܘ	Урду
ܐܘܟܠܐܗܘܡܐ	Оклахома
ܝܡܐ ܕܓܪܒܝܐ	Северное море
ܒܝܝܢܐ	Вена
ܩܘܦܢܗܐܓܢ	Копенгаген
ܣܛܘܩܗܘܠܡ	Стокгольм
ܗܠܣܢܩܝ	Хельсинки
ܕܒܠܢ	Дублин
ܒܪܛܝܣܠܐܒܐ	Братислава
ܟܬܒܐ ܩܕܝܫܐ	Библия
ܥܕܬܐ ܫܪܝܪܬܐ ܕܝܫܘܥ	Церковь истинного Иисуса
ܠܫܢܐ ܐܢܓܠܝܐ	Английский язык
ܩܘܢܣܦܣܝܘܢ (ܬܫܝܠܝ)	Консепсьон (город, Чили)
ܐܘܢܛܐܪܝܘ	Онтарио
ܡܐܢܝܛܘܒܐ	Манитоба
ܐܠܒܪܛܐ	Альберта
ܢܘܒܐ ܣܩܘܛܝܐ	Новая Шотландия
ܩܘܢܣܩܘܒܘܠܐ	Коньсковоля
ܢܝܘ ܒܪܘܢܙܘܝܩ	Нью-Брансуик
ܩܘܠܘܡܒܝܐ ܒܪܝܛܝܬܐ	Британская Колумбия
ܓܙܪܬܐ ܕܐܡܝܪܐ ܐܕܘܐܪܕ	Остров Принца Эдуарда
ܣܐܣܩܐܬܫܘܐܢ	Саскачеван
2012	2012 год
2011	2011 год
2010	2010 год
2009	2009 год
ܢܝܘܦܐܘܢܕܠܢܕ ܘܠܐܒܪܐܕܘܪ	Ньюфаундленд и Лабрадор
2008	2008 год
ܐܘܚܕܢܐ ܓܪܒܝܝܐ-ܡܥܪܒܝܐ	Северо-Западные территории
ܝܘܩܘܢ	Юкон (территория)
2005	2005 год
2006	2006 год
ܢܘܢܐܒܘܛ	Нунавут
2007	2007 год
ܡܐܟܘܠܬܐ	Пища
ܚܘܝܐ	Змеи
ܩܘܪܘܦ	Курув
ܟܝܡܝܐ	Химия
1968	1968 год
ܩܛܠܥܡܐ ܝܗܘܕܝܐ	Холокост
ܡܕܪܝܕ (ܡܕܝܢܬܐ)	Мадрид
ܗܘܦܪܟܝܣ ܘܐܘܚܕܢܐ ܕܩܢܕܐ	Провинции и территории Канады
ܣܢܛܝܐܓܘ ܕܐ ܬܫܝܠܝ	Сантьяго
ܚܐܪܘܬܐ	Свобода
ܣܝܕܢܝ	Сидней
ܝܪܘܩܐ	Зелёный цвет
ܡܠܒܘܪܢ	Мельбурн
ܣܘܡܩܐ	Красный цвет
ܢܘܪܐ (ܕܠܩܐ)	Огонь
ܢܝܠܘܣ	Нил
ܓܙܐܐܪ (ܡܕܝܢܬܐ)	Алжир (город)
ܬܘܢܣ (ܡܕܝܢܬܐ)	Тунис (город)
ܛܗܪܐܢ	Тегеран
ܐܢܩܪܐ	Анкара
ܢܝܐܡܝ	Ниамей
ܒܡܩܘ	Бамако
ܕܪܡܣܘܩ	Дамаск
ܥܡܐܢ	Амман
ܒܝܪܘܬ	Бейрут
ܒܝܬ ܨܘܒܐ	Университет
ܒܝܬܐ (ܒܢܝܢܐ)	Жилище
ܐܘܣܛܪܠܝܐ (ܝܒܫܬܐ)	Австралия (континент)
ܢܗܪܐ	Река
ܪܝܫܐ ܕܣܒܪܐ ܛܒܐ	Мыс Доброй Надежды
ܫܘܚܡܠܐ	Инвестиции
ܩܘܪܝܛܝܒܐ	Куритиба
ܥܒܐ	Лес
ܩܘܢܦܘܫܝܘܣ	Конфуций
ܩܢܐ	Гнездо
ܐܘܪܘ	Евро
ܝܡܐ ܚܘܪܐ ܡܨܥܝܐ	Средиземное море
ܓܘܪܓܝܐ	Джорджия (значения)
ܡܫܝܚܝܘܬܐ	Христианство
ܩܠܒܐ:ܐܘܝܐ	Шаблон:За
ܪܘܙܐ	Рис (продукт питания)
ܝܒܫܬܐ	Континент
ܛܝܪܐ	Птицы
ܐܪܫܟܝܬܐ	Столица
ܠܫܢܐ ܦܘܪܛܘܓܠܝܐ	Португальский язык
ܝܪܚܐ	Месяц
ܡܘܨܛܦܐ ܟܡܐܠ ܐܛܐܛܘܪܩ	Ататюрк, Мустафа Кемаль
ܐܠܡܐܙܢ	Альмасан
ܠܫܢܐ ܝܦܢܝܐ	Японский язык
ܦܐܬܐ ܪܝܫܝܬܐ	Заглавная страница
ܦܪܢܣܝܣܩܘ ܓܘܝܐ	Гойя, Франсиско
ܝܡܐ ܐܚܪܝܐ	Каспийское море
ܝܡܬܐ ܕܐܝܪܝ	Эри (озеро)
ܣܠܒܐܕܘܪ ܕܐܠܝ	Дали, Сальвадор
ܒܢܣܢܬ ܦܢ ܟܘܟ	Ван Гог, Винсент
ܦܪܝܕܐ ܩܐܠܘ	Кало, Фрида
ܗܢܪܝ ܡܐܛܝܣ	Матисс, Анри
ܡܝܟܠܐܢܓܠܘ	Микеланджело
ܦܒܠܘ ܦܝܩܐܣܘ	Пикассо, Пабло
ܪܡܒܪܢܛ	Рембрандт
ܐܢܕܝ ܘܘܪܗܘܠ	Уорхол, Энди
ܢܝܢܘܐ (ܡܕܝܢܬܐ)	Ниневия
ܒܒܠ	Вавилон
ܐܝܪܝܚܘ	Иерихон
ܩܛܠܘܢܝܐ	Каталония
ܡܕܪܝܕ (ܗܘܦܪܟܝܐ)	Мадрид (автономное сообщество)
ܒܝܬ ܠܚܡ	Вифлеем
ܣܕܪܐ:Candidates for speedy deletion	Категория:Википедия:К быстрому удалению
ܪܫܡܠܘܬܐ	Капитализм
ܐܘܡܬܐ	Нация
ܩܪܬܐܓܘ	Карфаген (город)
ܣܕܪܐ:ܐܣܛܪܘܢܘܡܝܐ	Категория:Астрономия
ܨܚܪܐܐ	Сахара
ܫܐܕܐ	Бес (христианство)
ܒܝܬ ܟܬܒܐ	Библиотека
ܫܘܠܛܢܘܬܐ (ܫܘܬܐܣܐ)	Правительство
ܬܫܝܢ ܫܝ ܗܘܐܢܓ	Цинь Шихуанди
ܡܕܢܚܐ ܡܨܥܝܬܐ	Средний Восток
ܡܠܟܘܬܐ	Монархия
ܩܘܛܢܝܘܬܐ	Республика
ܐܬܪܐ	Государство
ܓܒܐ	Политическая партия
ܝܗܘܕܝܐ	Евреи
ܝܡܡܬܐ ܪܘܪܒܬܐ	Великие озёра
ܐܘܩܝܢܘܣ ܬܝܡܢܝܐ	Южный океан
ܐܕܢܐ (ܝܘܠܦܢ ܨܪܘܝܘܬܐ)	Ухо
ܢܚܝܪܐ	Нос
ܥܝܢܐ (ܝܘܠܦܢ ܨܪܘܝܘܬܐ)	Глаз
ܥܘܩܒܪܬܐ	Мышцы
ܙܡܝܪܬܐ	Песня
ܓܡܠܐ	Верблюды
ܫܘܫܡܢܐ	Муравьи
ܕܒܫܬܐ	Пчёлы
ܠܫܢܐ ܗܘܠܢܕܝܐ	Нидерландский язык
ܐܡܐ (ܒܝܬܝܘܬܐ)	Мать
ܐܒܐ (ܒܝܬܝܘܬܐ)	Отец
1847	1847 год
ܨܦܪܐ (ܙܒܢܐ)	Утро
ܪܡܫܐ	Вечер
ܩܛܝܢܬܐ	Минута
ܠܫܢܐ ܪܘܣܝܐ	Русский язык
ܩܢܘܢܐ	Право
ܠܫܢܐ ܨܝܢܝܐ	Китайский язык
ܕܡܐ	Кровь
ܬܓܪܘܡܬܐ	Скелет
ܪܐܬܐ	Лёгкие
ܠܫܢܐ ܪܘܡܢܝܐ	Румынский язык
ܡܛܪܐ	Дождь
ܢܠܣܘܢ ܡܐܢܕܝܠܐ	Мандела, Нельсон
ܐܒܢܐ	Горная порода
ܥܢܢܐ	Облака
ܩܢܘܢܐ ܕܠܥܙܐ	Грамматика
ܠܫܢܐ ܓܘܪܓܝܐ	Грузинский язык
ܝܘܠܦܢ ܡܡܫܚܘܬܐ	Экономика (наука)
ܙܘܙܐ	Валюта
ܡܕܐܬܐ	Налог
ܐܠܦܒܝܬ ܥܪܒܝܐ	Арабское письмо
ܐܠܦܒܝܬ ܝܘܢܝܐ	Греческий алфавит
ܐܠܦܒܝܬ ܠܐܛܝܢܝܐ	Латинский алфавит
ܣܕܪܐ:ܦܪܢܣܐ	Категория:Франция
ܟܢܫܐ	Общество
ܓܒܪܐ	Мужчина
ܙܘܘܓܐ	Брачный союз
ܙܕܩܐ ܕܒܪܢܫܐ	Права человека
ܩܪܒܐ ܓܘܝܐ	Гражданская война
ܬܪܝܢܐ	Сок
ܚܠܒܐ (ܕܝܘܒܐ)	Молоко
ܛܘܪܐ	Гора
ܡܕܒܪܐ	Пустыня
ܠܫܢܐ ܐܠܒܢܝܐ	Албанский язык
ܠܫܢܐ ܐܪܡܢܝܐ	Армянский язык
ܝܘܗܐܢ ܓܘܛܢܒܪܓ	Гутенберг, Иоганн
ܠܫܢܐ ܣܘܝܕܝܐ	Шведский язык
ܢܝܩܘܠܐ ܛܣܠܐ	Тесла, Никола
ܡܘܫܐ	Моисей
ܬܕܐ	Женская грудь
ܢܘܗܪܐ (ܚܙܝܬܐ)	Свет
ܠܫܢܐ ܝܘܢܝܐ	Греческий язык
ܠܫܢܐ ܦܪܣܝܐ	Персидский язык
ܬܘܕܝܬܐ	Религия
ܐܒܪܗܡ	Авраам
ܣܦܪܐ ܕܒܪܝܬܐ	Книга Бытия
ܠܫܢܐ ܩܢܛܘܢܝܐ	Кантонский диалект
ܠܫܢܐ ܡܢܕܪܝܢܝܐ	Севернокитайский язык
ܦܘܠܘܣ ܫܠܝܚܐ	Апостол Павел
ܙܝܓܡܘܢܕ ܦܪܘܝܕ	Фрейд, Зигмунд
ܙܠܛܐ	Салат (блюдо)
ܝܗܘܕܝܘܬܐ	Иудаизм
ܠܫܢܐ ܥܒܪܝܐ	Иврит
ܟܒܕܐ	Печень
ܛܚܠܐ	Селезёнка
ܟܘܠܝܬܐ	Почка (анатомия)
ܫܠܦܘܚܬܐ	Мочевой пузырь
ܐܫܟܐ	Яички
ܐܘܩܝܢܘܣ	Океан
ܒܘܕܗܐ	Будда Шакьямуни
ܡܘܚܡܕ	Мухаммед
ܟܪܣܐ	Брюшко
ܚܒܠܐ ܟܘܒܝܐ	Спинной мозг
ܘܪܝܕܐ	Вена (анатомия)
ܡܪܒܥܐ	Матка женщины
ܠܫܢܐ (ܗܕܡܐ)	Язык (анатомия)
ܓܝܕܐ	Нерв
ܨܘܪܐ (ܝܘܠܦܢ ܨܪܘܝܘܬܐ)	Шея
ܦܘܡܐ	Рот
ܓܓܪܬܐ	Гортань
ܡܥܝܐ	Кишечник
ܫܪܝܬܐ	Сустав
ܚܕܝܐ	Грудная клетка
ܬܝܪܬܐ	Железа
ܚܠܒܐ (ܝܘܠܦܢ ܨܪܘܝܘܬܐ)	Диафрагма (анатомия)
ܫܪܝܢܐ	Артерия
A	A (латиница)
B	B (латиница)
ܢܘܛܦܬܐ	Сперма
G	G (латиница)
U	U (латиница)
Z	Z (латиница)
F	F (латиница)
J	J (латиница)
ܐܠܦܒܝܬ	Алфавит
T	T (латиница)
C	C (латиница)
R	R (латиница)
D	D (латиница)
Α	Альфа (буква)
Ω	Омега (буква)
I	I (латиница)
Μ	Мю
E	E (латиница)
H	H (латиница)
ܗܐܪܠܡ (ܗܘܠܢܕܐ)	Харлем
K	K (латиница)
L	L (латиница)
M	M (латиница)
N	N (латиница)
O	O (латиница)
Q	Q (латиница)
S	S (латиница)
V	V (латиница)
W	W (латиница)
X	X (латиница)
Y	Y (латиница)
ܐܢܫܟܕܐ	Энсхеде
ܗܢܓܠܘ	Хенгело
Φ	Фи
ܝܘܢܐ	Голубиные
ܐܝܠܢܐ	Дерево
Λ	Лямбда
ܓܒܬܐ	Сыр
ܥܢܒܬܐ	Виноград (ягода)
ܕܒܫܐ	Мёд
ܒܣܪܐ	Мясо
ܫܟܪ	Сахар
ܣܦܪܙܒܢܐ	Газета
ܙܥܘܩܐ	Телефон
ܡܪܕܘܬܐ	Культура
ܡܥܝܐ ܥܒܝܐ	Толстая кишка
ܡܥܝܐ ܩܛܝܢܐ	Тонкая кишка
ܣܘܪܓܕܐ ܝܘܠܝܝܐ	Юлианский календарь
ܐܣܝܘܬܐ	Медицина
ܡܠܚܐ (ܐܨܪܐ)	Поваренная соль
ܣܕܪܐ:ܒܪܐܙܝܠ	Категория:Бразилия
ܙܘܝܬܐ (ܡܚܪܘܬܐ)	Угол
ܬܘܩܦܐ	Энергия
ܣܦܝܢܬܐ	Судно
ܩܠܐ (ܨܘܬܐ)	Звук
ܙܓܘܓܝܬܐ	Стекло
ܫܛܝܚܘܬܐ	Площадь
ܡܢܝܢܐ	Число
ܪܦܦܐ	Секунда
ܣܥܪܬܐ	Ячмень обыкновенный
ܘܘܗܐܢ	Ухань
ܡܟܬܒܢܘܬܐ ܕܐܬܪܘܬܐ	Алфавитный список стран и территорий
ܒܝܬ ܢܗܪܝܢ	Месопотамия
ܕܒܐ	Медвежьи
ܬܠܗܝܐ	Злокачественная опухоль
ܡܠܟܐ	Король
ܚܛܬܐ	Пшеница
ܣܘܪܓܕܐ	Календарь
ܟܘܪܗܢܐ	Болезнь
ܣܘܪܓܕܐ ܓܪܝܓܘܪܝܐ	Григорианский календарь
ܟܦܣܐ	Менструация
ܥܡܐ ܩܪܕܘܝܐ	Курды
ܓܫܪܐ	Мост
ܡܓܕܠܐ (ܒܢܝܢܐ)	Башня
ܐܡܪܝܩܐ ܠܐܛܝܢܝܬܐ	Латинская Америка
ܟܗܪܒܐ	Электричество
ܡܙܝܥܢܐ ܕܩܝܕܐ ܓܘܝܐ	Двигатель внутреннего сгорания
ܣܝܦܐ (ܙܝܢܐ)	Меч
ܫܡܥܘܢ ܩܢܢܝܐ	Симон Кананит
ܩܪܩܦܬܐ	Череп
ܓܘܡܠܐ!	Joomla!
ܐܦܫܬܐ	Изюм
ܠܫܢܐ ܕܗܣܝܐܢܓ	Сян (язык)
ܠܫܢܐ ܥܪܒܝܐ	Арабский язык
ܠܫܢܐ ܐܦܪܝܩܐܢܝܐ	Африкаанс
Β	Бета (буква)
Γ	Гамма (буква)
Δ	Дельта (буква)
Ε	Эпсилон
Ζ	Дзета
Η	Эта
Θ	Тета
Ι	Йота
Κ	Каппа (буква)
Ν	Ню (буква)
Ξ	Кси (буква)
Ο	Омикрон
Ρ	Ро (буква)
Σ	Сигма (буква)
Τ	Тау
Υ	Ипсилон
Χ	Хи
Ψ	Пси (буква)
ܐܬܐ	Флаг
ܟܪܦܬܐ	Мебель
ܟܘܪܣܝܐ	Стул
ܣܦܬܐ	Губы
ܦܣܡܐ	Усы
ܥܩܠܐ	Стопа
1000000000 (ܡܢܝܢܐ)	Миллиард
ܓܪܡܐ ܕܨܕܥܐ	Височная кость
ܩܠܝܕܐ (ܓܪܡܐ)	Ключица
ܟܬܦܐ	Плечевой сустав
ܦܟܐ ܬܚܬܝܐ	Нижняя челюсть
ܥܠܡܐ (ܐܪܥܐ)	Мир (Земля)
ܘܝܩܝܦܕܝܐ:ܬܪܥܐ ܕܟܢܫܐ	Википедия:Форум
ܒܝܪܡܘܢܬ	Вермонт
ܩܘܣܛܢܛܝܢܘܦܘܠܝܣ	Константинополь
ܒܝܬ ܟܪܝܗܐ	Больница
ܥܕܬܐ	Церковь (сооружение)
ܕܝܬܝܩܝ ܚܕܬܐ	Новый Завет
9 (ܡܢܝܢܐ)	9 (число)
1002	1002 год
ܦܘܕܘܠܣܟ	Подольск
ܦܐܦܐ	Папство
5	5 год
4	4 год
ܢܝܒܐ	Клыки
3	3 год
2	2 год
ܒܝܬ ܥܬܩܐ ܕܠܘܒܪ	Лувр
ܓܒܐ ܕܚܐܪܘܬܐ ܕܦܘܐܪܛܘ ܪܝܩܘ	Партия независимости Пуэрто-Рико
6	6 год
ܕܝܬܝܩܝ ܥܬܝܩܬܐ	Ветхий Завет
ܥܐܕܐ ܕܒܝܬ ܝܠܕܐ	Рождество Христово
ܠܫܢܐ ܪܘܡܐܢܣܝܐ	Романские языки
ܡܬܠܬܐ	Треугольник
ܫܢܬܐ ܟܒܝܫܬܐ	Високосный год
ܡܘܥܡܪ ܐܠܩܕܐܦܝ	Каддафи, Муаммар
ب	Ба (буква арабского алфавита)
ܥܐܕܐ ܕܩܝܡܬܐ	Пасха
ܢܝܘ ܝܘܪܩ	Нью-Йорк (значения)
ܢܦܛܐ	Нефть
ܣܐܘܢܐ	Лёгкая обувь
ܒܝܬ ܥܘܪܦܢܐ	Банк
ܟܪܡܐ	Виноградник
ܐܝܪܠܢܕ (ܓܙܪܬܐ)	Ирландия (остров)
1	1 год
ܠܘ ܫܘܢ	Лу Синь
10	10 год
20	20 год
9	9 год
7	7 год
8	8 год
7 (ܡܢܝܢܐ)	7 (число)
8 (ܡܢܝܢܐ)	8 (число)
12	12 год
ܡܠܐܐ ܘܬܘܒܐ	Прилив и отлив
ܫܒܘܥܐ	Неделя
ܓܠܝܕܐ	Лёд
ܨܠܘܬܐ ܡܪܢܝܬܐ	Отче наш
ܝܡܬܐ	Озеро
ܝܡܐ ܣܘܡܩܐ	Красное море
13	13 год
ܩܛܘܬܐ (ܝܥܝܬܐ)	Огурец обыкновенный
ܓܙܪܬܐ	Остров
ܚܘܪܐ	Белый цвет
ܐܘܟܡܐ	Чёрный цвет
6 (ܡܢܝܢܐ)	6 (число)
ܠܫܢܐ ܪܘܫܡܝܐ	Официальный язык
11	11 год
15	15 год
14	14 год
17	17 год
ܣܦܪ ܡܠܐ	Словарь
18	18 год
19	19 год
16	16 год
21	21 год
ܦܠܣܛܝܢ	Палестина
10 (ܡܢܝܢܐ)	10 (число)
ܡܣܘܪܩܐ (ܡܐܢܐ)	Расчёска
ܠܝܠܐ ܕܘܢܤ	Даунс, Лила
ܝܡܐ ܕܡܠܚܐ	Мёртвое море
ܫܘܚܠܦܐ ܕܫܢܬܐ	Времена года
ܠܝܒܪܦܘܠ	Ливерпуль
ܩܘܦܬܐ (ܛܝܪܐ)	Совообразные
ܫܥܬܐ	Час
ܢܐܘܝ ܕܘܪ ܟܪܘܠܣܟܝ	Новый-Двор-Кролевский
ܐܪܙܦܬܐ	Молоток
ܝܘܢܫܘܦܝܢ	Йёнчёпинг
ܥܘܠܐ ܚܝܐ	Плод (анатомия)
ܐܠܦܒܝܬ ܣܘܪܝܝܐ	Сирийское письмо
ܐܠܦܒܝܬ ܐܪܡܝܐ	Арамейское письмо
ܙܡܪܐ	Пение
ܫܓܠܐ	Классики (игра)
ܩܠܦܬܐ ܕܒܣܡܐ	Корица (пряность)
ܡܙܬܐ	Волосы
ܠܫܢܐ ܐܪܡܝܐ	Арамейские языки
ܨܦܪܐ (ܛܝܪܐ)	Воробьиные
ܐܦܣܩܘܦܐ	Епископ
ܨܝܢ (ܐܪܥܐ)	Китайская цивилизация
ܓܒܐ ܕܝܡܘܩܪܛܝܐ (ܐܘܚܕܢܐ ܡܚܝܕܐ)	Демократическая партия (США)
ܒܝܐܛܪܝܟܣ ܕܒܝܬ ܗܘܠܢܕܝܐ	Беатрикс
ܡܠܟܘܬܐ ܕܗܘܠܢܕܐ	Королевство Нидерландов
ܐܒܪܝܠ ܠܐܒܝܢ	Лавин, Аврил
ܪܝܫ ܩܘܛܢܝܘܬܐ	Президент
ܐܚܐ (ܒܝܬܝܘܬܐ)	Сиблинги
ܐܪܒܝܐ	Аравийский полуостров
ܡܪܩܘܣ ܐܘܢܓܠܣܛܐ	Апостол Марк
ܥܘܠܐ	Эмбрион
ܠܫܢܐ ܕܗܟܐ	Хакка (язык)
ܫܘܫܡܢܝܬܐ (ܝܥܝܬܐ)	Кардамон
ܠܫܢܐ ܕܓܐܢ	Гань
ܒܝܬ ܥܬܩܐ	Музей
ܐܠܦܒܝܬ ܥܒܪܝܐ	Еврейский алфавит
ܠܫܢܐ ܣܘܪܝܝܐ	Сирийский язык
ܒܪܩܐ	Молния
ܐܝܕܐ	Кисть (анатомия)
ܫܡܥܘܢ ܟܐܦܐ	Апостол Пётр
ܬܠ ܐܒܝܒ	Тель-Авив
ܒܐܠܦܐܪܐܝܣܘ	Вальпараисо
ܛܘܪܝܐ	Туройо
ܠܫܢܐ ܫܝܡܝܐ	Семитские языки
ܚܘܣܢܝ ܡܘܒܐܪܟ	Мубарак, Хосни
ܘܐܟܐܩܐ	Оахака (штат)
ܚܐܘܬܐ	Сливочное масло
ܐܘܢܓܠܝܘܢ	Евангелие
ܠܫܢܐ ܕܘܘ	У (язык)
ܪܘܛܪܕܐܡ	Роттердам
ܩܪܛܐ	Крит
ܐܘܪܚܐ	Дорога
ܩܘܪܨܐ ܚܠܝܨܐ	Компакт-диск
ܨܒܥܐ	Палец
ܦܪܬ	Евфрат
ܩܝܘܛܘ	Киото
ܥܣܪܐ ܦܘܩܕܢܐ	Десять заповедей
ܒܪܩܩܐ ܦܪܣܝܐ	Персидский залив
ܚܠܐ (ܕܚܝܚܐ)	Песок
ܘܪܕܐ	Шиповник
ܓܙܪܬܐ ܝܒܫܢܝܬܐ	Полуостров
ܐܘܪܝܬܐ	Тора
ܟܘܘܝܬ (ܡܕܝܢܬܐ)	Эль-Кувейт
ܡܚܙܝܬܐ	Зеркало
ܥܡܐ ܥܪܒܝܐ	Арабы
ܟܘܬܐ	Окно
ܠܫܢܐ ܝܘܢܝܐ ܥܬܝܩܐ	Древнегреческий язык
ܠܫܢܐ ܐܟܕܝܐ	Аккадский язык
ܕܩܠܬ	Тигр (река)
ܐܬܪܘܬܐ ܕܐܬܪܘܬܐ ܡܚܝܕܐ ܕܐܡܪܝܩܐ	Штат США
ܡܥܡܘܕܝܬܐ	Крещение
ܩܘܢܓܘ	Конго
ܐܝܢܛܪܠܝܢܓܘܐ	Интерлингва
ܐܘܪܟܐ	Длина
ܚܠܡܐ	Сновидение
ܠܫܢܐ ܩܪܕܘܝܐ	Курдские языки
ܩܡܚܐ	Мука
ܕܢ ܗܐܟ	Гаага
ܠܫܢܐ ܦܘܢܝܩܝܐ	Финикийский язык
ܣܝܢܝ (ܓܙܪܬܐ ܝܒܫܢܝܬܐ)	Синайский полуостров
ܟܪܘܙܘܬܐ ܕܝܘܚܢܢ	Евангелие от Иоанна
ܬܪܥܐ (ܒܒܐ)	Дверь
ܪܝܗܐܢܐ	Рианна
ܛܦܪܐ	Ногти
ܐܦܐ	Лицо
ܨܨܐ (ܨܢܥܬܐ)	Гвоздь
ܙܝܬܐ	Олива европейская
ܬܠܝܬܝܘܬܐ	Троица
ܓܠܠܐ	Волна
ܟܬܒܬܐ	Письмо (письменность)
ܪܘܚܐ ܕܩܘܕܫܐ	Святой Дух
100 (ܡܢܝܢܐ)	100 (число)
ܒܘܪܟܐ	Коленный сустав
ܫܘܩܐ (ܬܐܓܪܘܬܐ)	Рынок
ܠܫܢܐ ܥܪܒܝܐ ܝܗܘܕܝܐ	Еврейско-арабские диалекты
ܒܠܛܝ	Бельцы
1000000 (ܡܢܝܢܐ)	Миллион
ܛܐܒܐ	Новости
ܐܫܬܐ (ܐܣܝܘܬܐ)	Лихорадка
ܩܫܬܐ ܓܪܒܝܝܬܐ ܕܐܪܥܐ	Северное полушарие
ܡܡܘܢܐ ܕܡܝܟܪܐ	Микроэкономика
ܠܝܕܣ	Лидс
ܥܘܩܒܪܐ	Домовые мыши
ܦܘܪܬܩܠܐ	Оранжевый цвет
ܒܪܩܩܐ	Залив
ܒܝܬ ܩܒܘܪܐ	Кладбище
ܐܣܝܐ (ܫܕܬܐ)	Врач
ܡܩܕܘܢܝܐ	Македония
ܦܢܛܝܩܘܣܛܝ	День Святой Троицы
ܫܓܕܬܐ	Миндаль
ܟܪܘܙܘܬܐ ܕܠܘܩܐ	Евангелие от Луки
ܩܘܢܣܦܣܝܘܢ (ܗܘܦܪܟܝܐ)	Консепсьон (провинция, Чили)
ܢܗܪܐ ܕܝܘܪܕܢܢ	Иордан
ܣܦܪ ܝܡܐ	Пляж
ܐܢܛܐܠܝܐ (ܗܘܦܪܟܝܐ)	Анталья (ил)
ܦܪܟܣܝܣ ܕܫܠܝܚܐ	Деяния святых апостолов
ܥܪܘܒܬܐ ܕܚܫܐ	Великая пятница
ܚܒܘܫܝܐ	Тюрьма
ܐܕܢܐ (ܗܘܦܪܟܝܐ)	Адана (ил)
ܝܘܚܢܢ ܡܥܡܕܢܐ	Иоанн Креститель
ܨܠܝܒܐ	Крест
ܚܙܒܐܠܠܗ	Хезболла
ܒܝܬ ܓܒܝܢܐ	Лоб
ܡܙܡܘܪܐ	Псалтирь
ܐܬܘܪ	Ассирия
ܒܢܝܢܐ	Здание
ܚܠܒ (ܡܕܝܢܬܐ)	Алеппо
ܩܫܬܐ ܬܝܡܢܝܬܐ ܕܐܪܥܐ	Южное полушарие
ܚܠܐ (ܚܡܪܐ)	Уксус
ܒܝܬ ܕܝܢܐ	Суд
ܚܝܦܐ	Хайфа
ܪܡܕܐܢ	Рамадан
ܫܛܪܐ ܬܐܒܝܠܝܐ ܕܓܝܢܝܣ	Книга рекордов Гиннесса
ܟܘܕܢܝܐ	Мул
ܒܪܩܩܐ ܕܥܕܢ	Аденский залив
ܓܠܝܢܐ ܕܝܘܚܢܢ	Откровение Иоанна Богослова
ܐܫܬܐ (ܝܘܠܦܢ ܨܪܘܝܘܬܐ)	Ягодицы
ܨܠܘܬܐ ܡܪܝܡܝܬܐ	Аве Мария
ܝܩܕܐ	Топливо
ܝܨܝܠܐ	Локтевой сустав
ܟܗܢܐ	Священник
ܕܩܢܐ	Борода
ܢܒܝܐ	Пророк
ܐܘܪܟܝܣܛܪܐ	Оркестр
1000 (ܡܢܝܢܐ)	Тысяча
ܣܘܦܝܐ ܪܘܛܐܪܘ	Ротару, София Михайловна
ܬܫܢܝܬܐ	Страхование
ܣܦܪܓܠܐ	Айва
ܐܢܕܪܐܘܣ ܫܠܝܚܐ	Андрей Первозванный
ܬܪܥܣܪ ܫܠܝܚܐ	Апостолы
ܢܩܒܬܐ	Самка
ܕܪܥܐ (ܗܕܡܐ)	Плечо (часть тела)
ܡܬܝ ܡܟܣܐ	Левий Матфей
ܬܐܘܡܐ ܫܠܝܚܐ	Апостол Фома
ܦܝܠܝܦܘܣ ܫܠܝܚܐ	Апостол Филипп
ܒܘܪܨܐ (ܗܘܦܪܟܝܐ)	Бурса (ил)
ܐܝܘܐܢܢܝܣ ܦܘܡܐ ܕܕܗܒܐ	Иоанн Златоуст
ܒܢܝܡܝܢ ܢܬܢܝܗܘ	Нетаньяху, Биньямин
ܐܪܬܒܝܢ (ܗܘܦܪܟܝܐ)	Артвин (ил)
ܓܒܝܢܐ	Бровь
ܫܘܪܬܐ	Пуп
ܐܕܝܐܡܐܢ (ܗܘܦܪܟܝܐ)	Адыяман (ил)
ܝܗܘܕܐ ܫܠܝܚܐ	Апостол Фаддей
ܒܪܬܘܠܡܝ ܫܠܝܚܐ	Апостол Варфоломей
ܝܥܩܘܒ ܒܪ ܙܒܕܝ	Иаков Зеведеев
ܝܘܚܢܢ ܫܠܝܚܐ	Иоанн Богослов
ܡܬܝܐ ܫܠܝܚܐ	Апостол Матфий
ܝܥܩܘܒ ܒܪ ܚܠܦܝ	Иаков Алфеев
ܕܟܪܐ	Самец
ܐܝܓܢܐܛܝܘܣ ܢܘܪܢܐ	Игнатий Богоносец
ܪܕܝܘܗܕ	Radiohead
ܒܫܐܪ ܐܠܐܣܕ	Асад, Башар
ܪܚܝܐ	Мельница
ܨܘܡܐ	Пост (религия)
ܕܝܪܐ	Монастырь
ܠܡܐܢܐ	Порт
ܡܠܚܐ (ܢܘܛܐ)	Моряк
ܐܦܝܘܢ (ܗܘܦܪܟܝܐ)	Афьонкарахисар (ил)
ܡܝܟܐܝܠ (ܡܠܐܟܐ)	Архангел Михаил
ܒܝܠܓܝܟ (ܗܘܦܪܟܝܐ)	Биледжик (ил)
ܒܝܬ ܥܬܩܐ ܕܐܣܪܐܝܠ	Музей Израиля
ܒܐܠܝܟܣܝܪ (ܗܘܦܪܟܝܐ)	Балыкесир (ил)
ܒܝܬ ܝܠܕܐ	День рождения
ܬܘܠܥܐ	Черви
ܬܘܩܢ ܓܝܕܝܐ ܩܢܛܪܘܢܝܐ	Центральная нервная система
ܛܘܪܐ ܕܓܠܝܕܐ	Айсберг
ܡܫܠܡܢܐ	Мусульманин
ܢܢܥܐ	Мята
ܩܠܒܐ:Commonscat	Шаблон:Commonscat
ܒܨܪܐ (ܡܕܝܢܬܐ)	Басра
ܐܓܪܬܐ ܕܠܘܬ ܪܗܘܡܝܐ	Послание к Римлянам
ܬܡܪܐ ܕܥܝܢܐ	Веко
ܡܪܝ ܓܝܘܪܓܝܣ ܣܗܕܐ	Георгий Победоносец
ܐܣܘܬܐ ܕܠܐ ܬܚܘܡܐ	Врачи без границ
ܐܪܙܐ (ܡܫܝܚܝܘܬܐ)	Таинство
ܐܓܪܬܐ ܕܠܘܬ ܦܝܠܝܦܣܝܐ	Послание к Филиппийцам
ܡܫܝܚܐ	Мессия
ܚܫܡܝܬܐ ܐܚܪܝܬܐ	Тайная вечеря
ܩܢܘܢܐ ܕܗܝܡܢܘܬܐ	Апостольский Символ веры
ܒܢܝ ܐܝܣܪܐܝܠ	Колена Израилевы
ܡܓܘܫܐ ܬܠܬܐ	Три царя
ܝܘܚܢܢ ܕܪܡܣܘܩܝܐ	Иоанн Дамаскин
ܒܒܐ (ܬܪܥܐ)	Ворота
ܣܕܪܐ:ܡܠܟܐ	Категория:Короли
ܣܕܪܐ:ܪܘܟܒ ܫܘܠܛܢܘܬܐ	Категория:Формы государства
ܠܫܢܐ ܕܡܝܢ	Миньские языки
ܥܘܪܡܫܐ	Загрязнение
ܒܒܠ (ܗܘܦܪܟܝܐ)	Бабиль (мухафаза)
ܫܘܡܪܐ	Сажа
ܐܫܩܠܘܢ	Ашкелон
ܕܘܢܒܐ	Хвост
ܩܐܕܣܝܐ (ܗܘܦܪܟܝܐ)	Кадисия (мухафаза)
ܡܪܝܡ ܡܓܕܠܝܬܐ	Мария Магдалина
ܡܪܪܬܐ	Жёлчный пузырь
ܥܕܬܐ ܟܠܕܝܬܐ ܩܬܘܠܝܩܝܬܐ	Халдейская католическая церковь
ܥܕܬܐ ܡܪܘܢܝܬܐ	Маронитская католическая церковь
ܡܪܬܐ	Жёлчь человека
ܩܘܪܒܢܐ	Евхаристия
ܐܕܡ	Адам
ܐܘܘܫܐ	Ушная сера
ܕܡܥܬܐ	Слеза
ܥܡܬܐ (ܒܝܬܝܘܬܐ)	Тётка
ܥܡܐ (ܒܝܬܝܘܬܐ)	Дядя
ܟܘܬܝܢܐ	Рубашка
ܝܘܗܐܢ ܐܠܙܪ	Эльзер, Иоганн Георг
ܒܝܢܓܘܠ (ܗܘܦܪܟܝܐ)	Бингёль (ил)
ܥܡܐ ܐܪܡܢܝܐ	Армяне
ܐܝܕܝܢ (ܗܘܦܪܟܝܐ)	Айдын (ил)
ܩܛܠܥܡܐ ܐܪܡܢܝܐ	Геноцид армян
ܐܡܐܣܝܐ (ܗܘܦܪܟܝܐ)	Амасья (ил)
ܦܪܝܙܘܢ ܒܪܝܟ	Побег (телесериал, 2005)
ܐܓܪܝ (ܗܘܦܪܟܝܐ)	Агры (ил)
ܒܘܪܕܘܪ (ܗܘܦܪܟܝܐ)	Бурдур (ил)
ܐܓܪܬܐ ܩܕܡܝܬܐ ܕܠܘܬ ܩܘܪܢܬܝܐ	1-е послание к Коринфянам
ܝܗܘܕܐ ܣܟܪܝܘܛܐ	Иуда Искариот
ܐܒܪܐ	Перо
ܡܚܪܐ	Инженер
ܚܪܛܘܡܢܐ	Нут (растение)
ܐܬܪܘܬܐ ܕܫܐܡ	Левант
ܬܪܘܕܐ	Ложка
ܓܒܪܐܝܠ (ܡܠܐܟܐ)	Архангел Гавриил
ܓܪܡܦܝܠܐ	Слоновая кость
ܨܘܪ	Тир (город)
ܒܘܠܘ (ܗܘܦܪܟܝܐ)	Болу (ил)
ܙܢܩܐ	Подбородок
ܐܓܪܐ ܕܒܢܝܢܐ	Крыша
ܒܝܛܠܝܣ (ܗܘܦܪܟܝܐ)	Битлис (ил)
ܓܠܝܠܐ	Галилея
ܪܥܡܐ	Гром
ܡܘܨܠ	Мосул
ܟܪܬܐ	Большой палец
ܥܡܐ ܛܘܪܩܝܐ	Турки
ܦܐܦܐ ܫܢܘܕܐ ܬܠܝܬܝܐ	Шенуда III
ܒܝܬ ܓܘܣܐ	Бункер
ܒܝܥܬܐ	Яйцо (пищевой продукт)
ܒܣܕܝܐ	Подушка
ܙܓܐ (ܢܩܘܫܐ)	Колокол
ܫܒܬܐ (ܝܗܘܕܝܘܬܐ)	Шаббат
ܫܡܝܪܡ	Семирамида
ܫܝܓܪܐ	Дёсны
ܝܗ	Тетраграмматон
ܡܫܝܚܝܐ	Христианин
ܟܪܘܙܘܬܐ ܕܡܪܩܘܣ	Евангелие от Марка
ܟܟܪܝܬܐ ܕܕܒܫܐ	Пчелиные соты
ܐܓܪܬܐ ܕܠܘܬ ܩܘܪܢܬܝܐ ܕܬܪܬܝܢ	2-е послание к Коринфянам
ܫܥܘܬܐ (ܡܠܘܐܐ)	Воск
ܛܥܡܐ	Вкус
ܓܢܬ ܫܒܪܐ	Детский сад
ܝܡܬܐ ܕܓܠܝܠܐ	Тивериадское озеро
ܕܝܘܬܐ	Чернила
ܡܪܝ ܝܘܣܦ	Иосиф Обручник
ܠܘܩܐ ܐܘܢܓܠܣܛܐ	Лука (евангелист)
ܐܓܪܬܐ ܕܠܘܬ ܥܒܪܝܐ	Послание к Евреям
ܐܓܪܬܐ ܕܠܘܬ ܓܠܛܝܐ	Послание к Галатам
ܡܪܝ ܡܝܟܐܝܠ ܪܒܐ	Михаил Сириец
Ϝ	Дигамма
Ϙ	Коппа (буква)
ܥܛܡܐ	Бедро
ܬܢܢܐ	Дым
ܡܘܚܘܢܐ	Мозжечок
ܐܓܪܬܐ ܕܠܘܬ ܩܘܠܣܝܐ	Послание к Колоссянам
ܐܓܪܬܐ ܕܝܥܩܘܒ	Послание Иакова
ܐܓܪܬܐ ܩܕܡܝܬܐ ܕܝܘܚܢܢ	1-е послание Иоанна
ܐܓܪܬܐ ܕܠܘܬ ܦܝܠܡܘܢ	Послание к Филимону
ܐܓܪܬܐ ܕܠܘܬ ܬܣܠܘܢܝܩܝܐ ܕܬܪܬܝܢ	2-е послание к Фессалоникийцам
ܐܓܪܬܐ ܩܕܡܝܬܐ ܕܠܘܬ ܬܣܠܘܢܝܩܝܐ	1-е послание к Фессалоникийцам
ܐܓܪܬܐ ܩܕܡܝܬܐ ܕܦܛܪܘܣ	1-е послание Петра
ܐܓܪܬܐ ܕܬܪܬܝܢ ܕܦܛܪܘܣ	2-е послание Петра
ܐܓܪܬܐ ܩܕܡܝܬܐ ܕܠܘܬ ܛܝܡܬܐܘܣ	1-е послание к Тимофею
Ϛ	Стигма (буква)
ܡܪܕܝܢ (ܗܘܦܪܟܝܐ)	Мардин (ил)
ܚܡܨ (ܡܕܝܢܬܐ)	Хомс
Ͳ	Сампи
ܘܐܟܐܩܐ ܕܝ ܟܘܐܪܝܣ	Оахака-де-Хуарес
ܐܓܪܬܐ ܕܬܪܬܝܢ ܕܝܘܚܢܢ	2-е послание Иоанна
ܐܓܪܬܐ ܕܬܠܬ ܕܝܘܚܢܢ	3-е послание Иоанна
ܐܓܪܬܐ ܕܝܗܘܕܐ	Послание Иуды
ܐܓܪܬܐ ܕܠܘܬ ܛܝܡܬܐܘܣ ܕܬܪܬܝܢ	2-е послание к Тимофею
ܐܓܪܬܐ ܕܠܘܬ ܛܛܘܣ	Послание к Титу
ܫܝܪܢܐܟ (ܡܕܝܢܬܐ)	Ширнак
ܐܟܪܐ	Фермер
ܓܘܣܢܐ	Беженцы
Ϻ	Сан (буква)
ܩܠܝܕܐ (ܡܐܢܐ)	Замковый ключ
ܥܕܥܐܕܐ	Фестиваль
ܐܪܒܝܠ (ܡܕܝܢܬܐ)	Эрбиль
ܪܓܠܐ	Нога человека
ܚܨܐ	Спина
ܐܠܝܐ ܢܒܝܐ	Илия (пророк)
ܙܚܘܪܝܬܐ (ܬܘܠܥܬܐ)	Тутовый шелкопряд
ܚܘܦܝܐ	Затмение
ܡܚܛܐ	Игла
ܥܠܡܐ ܥܪܒܝܐ	Арабский мир
ܦܓܘܕܬܐ	Узда
ܩܛܡܐ	Зола
ܢܘܗܕܪܐ (ܡܕܝܢܬܐ)	Дахук (город)
ܨܒܥܐ ܕܪܓܠܐ	Палец ноги
ܢܓܪܘܬܐ	Плотник
ܠܘܚܐ (ܚܫܘܒܬܐ)	Планшетный компьютер
ܪܒܝܬܐ	Ростовщичество
ܡܟܝܪܘܬܐ	Обручение
ܫܘܪܡܐ	Прямая кишка человека
ܐܪܡܝܐ (ܢܒܝܐ)	Иеремия
ܬܐܡܐ	Близнецы
ܬܠܝܦܐ	Ресница
ܫܥܬܐ ܕܐܪܥܐ	Час Земли
ܦܪܡܝܬܐ	Пуговица
ܟܘܟܒܐ ܕܕܘܝܕ	Звезда Давида
ܡܪܝ ܐܣܛܦܢܘܣ	Стефан Первомученик
ܡܫܡܫܢܐ	Диакон
ܢܓܒ	Негев
ܟܢܥܢ	Ханаан
ܢܘܨܦܐ	Сумерки
ܒܝܢܐ	Гребенщик
ܬܓܪܝܬ	Тикрит
ܚܠܐ (ܥܦܪܐ)	Пыль
ܬܪܥܐ ܕܕܡܐ	Кровотечение
ܥܪܒܐ ܕܫܡܫܐ	Закат
ܐܡܝܫܐ	Болото
ܡܨܥܝܬܐ (ܨܒܥܐ)	Средний палец
ز	Зайн (буква арабского алфавита)
ܩܘܪܨܠܐ	Лодыжка
ܒܪ ܐܝܕܐ	Перчатки
ܢܫܒܐ ܕܥܝܢܐ	Сетчатка
ܬܘܩܢ ܓܝܕܝܐ ܡܚܕܘܪܝܐ	Периферическая нервная система
ܛܝܢܐ	Грязь
ܓܓܘܠܬܐ	Голгофа
ܗܢܝܢܐ (ܡܡܫܚܘܬܐ)	Процентный доход
ܐܫܘܪ ܒܢܐܦܠ	Ашшурбанапал
ܓܕܫܐ	Авария
ܦܛܪܝܪܟܐ	Патриарх (церковный сан)
ا	Алиф
ܚܟܐ	Нёбо
ت	Та (третья буква арабского алфавита)
ث	Са (буква арабского алфавита)
ج	Джим (буква арабского алфавита)
ح	Ха (шестая буква арабского алфавита)
خ	Ха (седьмая буква арабского алфавита)
د	Даль (буква арабского алфавита)
ذ	Заль (буква арабского алфавита)
ر	Ра (буква арабского алфавита)
ܪܓܫܐ	Ощущение
س	Син (буква арабского алфавита)
ܟܪܟ ܣܠܘܟ (ܡܕܝܢܬܐ)	Киркук
ܒܒܬܐ	Зрачок
ܩܒܪܐ	Могила
ܠܒܘܢܬܐ	Ладан
ܚܡܬ (ܡܕܝܢܬܐ)	Хама
ܝܫܛܐ	Пищевод человека
ܟܝܣܐ ܕܐܫܟܐ	Мошонка
ܕܒܪܐ	Сельская местность
ܚܪܘܫܬܐ	Трахея
ܓܪܡܐ ܕܥܛܡܐ	Бедренная кость
ܒܪܐ (ܒܝܬܝܘܬܐ)	Сын
ܫܚܘܪܐ	Древесный уголь
ܐܘܟܡܐ ܕܥܝܢܐ	Радужная оболочка
ܫܦܠܘܗܝ ܕܢܝܠܘܣ	Дельта Нила
ܐܘܪܡܝܐ	Урмия (город)
Ϸ	Шо (буква)
ܓܙܪܬܐ ܐܝܘܠܝܬܐ	Липарские острова
ܓܒܐ ܕܒܥܬ	Баас
ܦܩܪܐ	Позвонок
ܒܪ ܩܠܐ	Эхо
ܟܝܡܪܐ	Химера
ܠܘܓܡܐ	Верхняя челюсть
ܛܪܘܢܐ	Диктатор
ܬܝܒܘܬܐ	Исповедь в христианстве
ܡܛܘܚܬܐ	Указательный палец
ܩܒܠܘܬܐ	Повитуха
ܐܪܙܝܪܐ	Скворцовые
ܣܦܪܐ (ܩܢܘܢܝܐ)	Юрист
Ͱ	Хета (буква)
ܥܡܐ ܐܪܡܝܐ	Арамеи
ܟܢܘܢܬܐ (ܫܪܝܬܐ)	Лучезапястный сустав
ܐܒܐ (ܐܠܗܐ)	Бог Отец
ܐܢܒܐܪ (ܗܘܦܪܟܝܐ)	Анбар (мухафаза)
ܡܪܕܝܢ (ܡܕܝܢܬܐ)	Мардин
ܡܘܪܘܢ	Миропомазание
ܚܠܡܬܐ	Сосок
ܢܘܠܐ ܕܓܘܓܝ	Паутина
ܐܫܥܝܐ	Исаия
ܒܪܬ ܙܘܓܐ (ܒܝܬܝܘܬܐ)	Жена
ܒܝܬ ܟܬܒܐ ܐܬܪܝܐ ܕܐܣܪܐܝܠ	Национальная библиотека Израиля
ܥܪܫܐ	Моляры
ܢܝܢܘܐ (ܗܘܦܪܟܝܐ)	Найнава (мухафаза)
ܢܘܗܕܪܐ (ܗܘܦܪܟܝܐ)	Дахук (мухафаза)
ܘܐܣܛ (ܗܘܦܪܟܝܐ)	Васит (мухафаза)
ܨܠܐܚ ܐܠܕܝܢ (ܗܘܦܪܟܝܐ)	Салах-эд-Дин (мухафаза)
ܟܢܘܫܝܐ ܕܠܫܢܐ ܥܒܪܝܐ	Академия языка иврит
ܥܘܕ	Уд (музыкальный инструмент)
ܒܓܕܐܕ (ܗܘܦܪܟܝܐ)	Багдад (мухафаза)
ܣܪܓܐ	Седло
ܒܨܪܐ (ܨܒܥܐ)	Безымянный палец
ܩܛܝܣܦܘܢ	Ктесифон
ܟܒܘܫܐ	Кошмар
ܢܓܦ (ܗܘܦܪܟܝܐ)	Наджаф (мухафаза)
ܟܪܟ ܣܠܘܟ (ܗܘܦܪܟܝܐ)	Киркук (мухафаза)
ܕܢܚܐ ܕܫܡܫܐ	Восход
ܬܐܪܬܐ	Совесть
ܒܨܪܐ (ܗܘܦܪܟܝܐ)	Басра (мухафаза)
ܡܫܚܐ ܕܟܪܝܗܐ	Елеосвящение
ܦܠܫܬ	Филистимляне
ܐܠܥܐ (ܝܘܠܦܢ ܨܪܘܝܘܬܐ)	Ребро
ܥܕܬܐ ܐܝܓܘܦܛܝܬܐ	Коптская православная церковь
ܐܢܛܝܘܟܝܐ	Антиохия
ܐܦܪܝܡ ܣܘܪܝܝܐ	Ефрем Сирин
ܐܝܙܝܕܝܐ	Езиды
ܪܝܫܘܢ ܠܬܣܝܘܢ	Ришон-ле-Цион
ܟܢܪܐ	Лира (музыкальный инструмент)
ܥܕܬܐ ܕܡܕܢܚܐ ܕܐܬܘܪܝܐ	Ассирийская церковь Востока
ܬܠܐ ܕܚܕ ܐܝܠܢ	Холм одного дерева
ܡܘܪܐ	Мирра (смола)
ܦܕܪܠܝܐ	Федерализм
ܐܠܝܫܥ	Елисей
ܗܟܐܪܝ (ܡܕܝܢܬܐ)	Хаккяри (город)
ܣܢܚܪܝܒ	Синаххериб
ܩܘܪܝܐܠܝܣܘܢ	Кирие элейсон
ܟܢܘܫܝܐ ܕܐܣܪܐܝܠ ܕܝܘܠܦܢܐ ܘܐܢܫܝܬܐ	Израильская академия естественных и гуманитарных наук
ܣܘܟܢܐ	Судовой руль
ܥܕܬܐ ܣܘܪܝܝܬܐ ܐܪܬܘܕܟܣܝܬܐ	Сиро-яковитская православная церковь
ܟܣܬܐ	Корм
ܩܡܫܠܝ	Эль-Камышлы
ܡܘܬܢܐ (ܗܘܦܪܟܝܐ)	Мутанна (мухафаза)
ܒܪ ܙܘܓܐ (ܒܝܬܝܘܬܐ)	Муж
ܡܝܫܢ (ܗܘܦܪܟܝܐ)	Майсан
ܣܘܠܝܡܐܢܝܐ (ܗܘܦܪܟܝܐ)	Сулеймания (мухафаза)
ܐܪܒܝܠ (ܗܘܦܪܟܝܐ)	Эрбиль (мухафаза)
ܚܠܒ (ܗܘܦܪܟܝܐ)	Алеппо (мухафаза)
ܟܪܒܠܐܐ (ܗܘܦܪܟܝܐ)	Кербела (мухафаза)
ܦܪܨܘܦܐ	Личность
ܕܝ ܩܐܪ (ܗܘܦܪܟܝܐ)	Ди-Кар (мухафаза)
ܬܐܘܡܐ (ܫܡܐ)	Фома
ܐܢܕܪܢܝܩ ܡܐܪܓܐܪܝܐܢ	Маргарян, Андраник Наапетович
ܡܡܠܠܘܬ ܐܠܗܘܬܐ	Христианское богословие
ܓܘܙܐ	Ореховые
ܕܝܐܠܐ (ܗܘܦܪܟܝܐ)	Дияла (мухафаза)
ܟܒܒ	Хабаб
ش	Шин (буква арабского алфавита)
ܩܪܫܬܐ	Потолок
ص	Сад (буква арабского алфавита)
ض	Дад
ظ	За (буква арабского алфавита)
ع	Айн (буква арабского алфавита)
غ	Гайн
ف	Фа (буква арабского алфавита)
ق	Каф (буква арабского алфавита)
ܚܨܪܐ	Мизинец
ܐܡܬܐ (ܝܘܠܦܢ ܨܪܘܝܘܬܐ)	Предплечье
ܣܝܢܝ	Синай
ܬܐܘܡܐ	Thomas (значения)
ܐܝܒܪܝܐ	Иберия
ܚܡܬ (ܗܘܦܪܟܝܐ)	Хама (мухафаза)
ܟܢܘܢܬܐ ܕܐܝܕܐ	Запястье
ܐܝܣܪܐܝܠ (ܬܘܚܡܐ ܐܚܪܢܐ)	Израиль (значения)
ܡܠܐܟܐ	Ангел
ܡܣܘܪܩܐ ܕܐܝܕܐ	Пястные кости
ܡܠܟܘܬܐ ܕܒܝܬ ܥܣܪ ܥܝܢܐ	Осроена
ܕܪܥܐ (ܡܕܝܢܬܐ)	Деръа
ܨܕܥܐ	Висок
ܣܘܣܝܐ ܐܝܣܠܢܕܝܐ	Исландская лошадь
ܩܠܐ	Нота (музыка)
ܓܪܡܐ	Кость
ܒܪܝܐܢܝ	Бирьяни
ܠܒܠܒܬܐ	Язычок (биология)
ܙܓܐ ܕܣܦܝܢܬܐ	Рында (колокол)
ك	Кяф (буква арабского алфавита)
ل	Лям (буква арабского алфавита)
م	Мим (буква арабского алфавита)
ن	Нун (буква арабского алфавита)
ه	Ха (двадцать шестая буква арабского алфавита)
و	Вав (буква арабского алфавита)
ي	Йа (буква арабского алфавита)
ܓܝܕܐ ܕܓܢܫܝܐ	Седалищный нерв
ܒܪܬܐ (ܒܝܬܝܘܬܐ)	Дочь
ܗܪܗܪܐ	Мираж
ܚܣܟܗ (ܡܕܝܢܬܐ)	Хасеке
ܒܝܬ ܢܗܪܝܢ ܥܠܝܬܐ	Джезире
ܛܐܪܩ ܥܙܝܙ	Тарик Азиз
ܡܣܘܪܩܐ ܕܪܓܠܐ	Плюсна
ܥܪܩ	Арак (напиток)
ܫܠܦܐ	Клинок
ܛܘܪ ܠܒܢܢ	Ливан (хребет)
ܐܙܟ	Идиль
ܡܪܝ ܐܕܝ ܬܪܝܢܐ	Аддай II
ܪܗܘܡܐ	Рум
ܩܝܒܩ	Квебек (значения)
ܩܕܠܐ	Затылок
ܥܡܐ ܐܬܘܪܝܐ/ܣܘܪܝܝܐ	Ассирийцы
ܛܘܪܐ ܕܣܝܢܝ	Синай (гора)
ܬܐܘܡܐ ܐܘܕܘ	Аудо, Тома
ܦܘܪܬܥܢܐ	Блохи
ܫܡܣܕܝܢ	Шемдинли
ܟܪܘܙܘܬܐ ܕܡܬܝ	Евангелие от Матфея
ܡܕܝܢܬܐ ܡܝܬܬܐ	Древние деревни Северной Сирии
ܢܘܗܕܪܐ	Дахук
ܐܓܪܬܐ ܕܠܘܬ ܐܦܣܝܐ	Послание к Ефесянам
ܚܡܬ	Хама (значения)
10000 (ܡܢܝܢܐ)	10 000 (число)
ܒܢܦܫܐ	Фиолетовый цвет
ܢܨܪܬ	Назарет
ܥܕܬܐ ܥܬܝܩܬܐ ܕܡܕܢܚܐ	Древняя Ассирийская церковь Востока
ܟܬܒܐ ܕܡܘܪܡܘܢ	Книга Мормона
ܐܝܓܢܐܛܝܘܣ ܡܘܫܐ ܩܕܡܝܐ ܕܐܘܕ	Игнатий Мусса I
ܒܫܐܪܐ ܦܛܪܘܣ ܐܠܪܐܥܝ	Раи, Бешар Бутрос
ܥܡܢܘܐܝܠ ܬܠܝܬܝܐ ܕܠܝ	Делли, Эммануэль III
ܥܡܘܕܐ ܦܩܪܝܐ	Позвоночник
ܒܝܬ ܫܥܝܐ	Стадион
ܓܘܕ ܫܪܠܘܛ	Good Charlotte
ܒܪ ܨܘܪܐ	Воротник
ܚܣܚܘܣܐ	Хрящ
ܡܪܝ ܩܘܪܝܩܘܣ ܣܗܕܐ ܘܕܝܘܠܝܛܐ ܝܡܗ	Кирик и Иулитта
ܐܝܣܛܢܒܘܠ (ܗܘܦܪܟܝܐ)	Стамбул (ил)
ܝܘܢܝܐ	Греки
ܓܗܢܐ	Геенна
ܝܥܩܘܒ ܒܘܪܕܥܢܐ	Барадей, Иаков
ܐܓܢܛܝܘܣ ܝܘܣܦ ܬܠܝܬܝܐ ܝܘܢܢ	Игнатий Иосиф III
ܡܪܝ ܕܢܚܐ ܪܒܝܥܝܐ	Дынха IV
ܬܐܓܘܪܬܐ	Торговля
ܫܝܪܢܐܟ (ܗܘܦܪܟܝܐ)	Ширнак (ил)
ܥܘܩܣܐ	Жало
ܟܗܢܘܬܐ	Священство
ܚܒܘܪ	Хабур
ܗܕܡܐ ܓܘܝܐ	Орган (биология)
ܚܡܬܐ (ܒܝܬܝܘܬܐ)	Тёща
ܡܥܠܘܠܐ	Маалула
ܐܘܪܘܦܐ	Европа (значения)
ܡܕܝܕ	Мидьят
ܐܣܝܪܝܣܩܐ	Ассириска Фёренинген
ܥܕܬܐ ܣܘܪܝܝܬܐ ܩܬܘܠܝܩܝܬܐ	Сирийская католическая церковь
ܥܨܘܒܐ	Хирург
ܐܘܣܛܪܠܝܐ	Австралия (значения)
ܡܦܩܬܐ ܦܫܝܛܬܐ	Пешитта
ܐܪܚܘܬܐ	Гостеприимство
ܫܪܓܐ ܕܢܦܛܐ	Масляная лампа
ܚܘܐ	Ева
ܩܛܠܥܡܐ ܐܬܘܪܝܐ	Геноцид ассирийцев
ܚܬܢܐ (ܒܝܬܝܘܬܐ)	Жених
ܒܝܬ ܟܬܒܐ ܕܐܫܘܪ ܒܢܐܦܠ	Библиотека Ашшурбанипала
ܣܪܦܝܘܢ	Серапион Тмуитский
ܒܕܘܩܐ	Скаутское движение
ܥܘܕܪܢܐ:ܚܒܝܫܬ̈ܐ	Википедия:Справка
ܓܦܬܐ	Лоза
ܡܝܟܐܝܠ	Michael (значения)
ܙܒܐ	Малый Заб
ܐܝܓܢܐܛܝܘܣ ܙܟܝ ܩܕܡܝܐ ܥܝܘܐܨ	Игнатий Закка I Ивас
ܐܣܛܘܡܟܐ	Желудок человека
ܟܢܘܢܬܐ ܕܪܓܠܐ	Предплюсна
ܓܢܬܐ	Сад
ܕܪܓܘܫܬܐ	Колыбель
ܚܝܠܐ ܠܒܢܝܐ	Ливанские силы
ܐܠܩܘܫ	Алькаш
ܐܘܪܗܝ	Эдесса
ܢܩܘܫܐ	Било
ܘܝܩܝܦܕܝܐ:ܐܝܙܓܕܘܬܐ	Википедия:Посольство
ܫܠܝܬܐ	Плацента
ܒܝܬ ܛܘܣܐ	Аэропорт
ܒܝܬ ܫܡܪܝܐ	Самария
ܐܓܢܣ ܡܘ	Агнес Моника
ܪܘܦܐܝܠ ܩܕܡܝܐ ܒܝܬ ܕܘܝܕ	Рафаэль I Бидавид
ܣܕܪܐ:ܓܪܡܢ	Категория:Германия
ܣܕܪܐ:ܐܝܛܠܝܐ	Категория:Италия
ܣܕܪܐ:ܐܬܪܘܬܐ ܡܚܝܕܐ ܕܐܡܪܝܩܐ	Категория:США
ܣܕܪܐ:ܪܘܣܝܐ	Категория:Россия
ܣܕܪܐ:ܩܢܕܐ	Категория:Канада
ܣܕܪܐ:ܐܝܣܪܐܝܠ	Категория:Израиль
ܣܕܪܐ:ܛܘܪܩܝܐ	Категория:Турция
ܣܕܪܐ:ܡܨܪܝܢ	Категория:Египет
ܣܕܪܐ:ܐܝܪܐܢ	Категория:Иран
ܕܝܪܐ ܕܡܪܝ ܓܒܪܐܝܠ	Монастырь Мор-Габриэль
ܥܐܕܐ	Праздник
ܣܕܪܐ:ܥܝܪܐܩ	Категория:Ирак
ܣܕܪܐ:ܗܘܠܢܕܐ	Категория:Нидерланды
ܣܕܪܐ:ܦܘܠܢܕ	Категория:Польша
ܣܕܪܐ:ܛܝܪܐ	Категория:Птицы
ܣܕܪܐ:ܝܥܝܬܐ	Категория:Растения
ܣܕܪܐ:ܬܘܕܝܬܐ	Категория:Религия
ܣܕܪܐ:ܝܕܥܬܐ	Категория:Наука
ܩܘܠ ܬܘܪܗ	Коль Тора
ܦܪܡܬܐ ܕܣܡܠܐ	Резня в Сумайиле
ܓܪܫܘܢܝ	Гаршуни
ܨܘܒܐ	Нусайбин
ܕܪܥܐ (ܗܘܦܪܟܝܐ)	Деръа (мухафаза)
ܣܕܪܐ ܕܦܛܪܝܪܟܐ ܕܥܕܬܐ ܕܡܕܢܚܐ	Список патриархов Ассирийской церкви Востока
ܩܠܒܐ:Box-footer	Шаблон:Box-footer
ܢܩܘܕ	Огласовки в еврейском письме
ܡܪܝܡ (ܚܬܗ ܕܡܘܫܐ)	Мириам
ܡܪܝ ܬܐܘܡܐ ܕܪܡܘ	Фома Дармо
ܣܕܪܐ:ܬܘܚܡܐ ܐܚܪܢܐ	Категория:Многозначные термины
ܣܕܪܐ:ܡܫܝܚܝܘܬܐ	Категория:Христианство
ܣܕܪܐ:ܐܣܠܐܡ	Категория:Ислам
ܣܕܪܐ:ܝܗܘܕܝܘܬܐ	Категория:Иудаизм
ܠܩܐ ܕܣܦܝܢܬܐ	Весло
ܚܪܒܘܩܬܐ	Петля (одежда)
ܬܪܢܓܠܐ	Петух
ܙܚܘܪܝܬܐ (ܓܘܢܐ)	Алый цвет
ܐܢܩܪܐ (ܗܘܦܪܟܝܐ)	Анкара (ил)
ܙܘܥܐ (ܩܢܘܢܐ ܕܠܥܙܐ)	Огласовки в сирийском письме
ܐܢܕܪܐܘܣ	Андре
ܐܝܪܠܢܕ	Ирландия (значения)
ܟܬܒܬ ܐܝܕܐ	Почерк
ܬܠ ܟܐܦܐ	Телль-Кайф
ܝܘܢܢ	Иона (пророк)
ܫܡܐ ܕܝܠܝܕܘܬܐ	Имя при рождении
ܐܨܪܐ	Вкусовые добавки
ܕܝܪܝܟ	Дерик (Сирия)
ܒܪܛܠܐ	Барталла
ܫܘܫܡܬܐ	Кунжут индийский
ܣܕܪܐ:ܘܝܩܝܦܕܝܐ	Категория:Википедия:Категории, объединённые по внутренним признакам
ܣܕܪܐ:ܝܒܫܬܐ	Категория:Континенты
ܒܓܕܝܕܐ	Бахдида
ܝܙܦܬܐ	Долг
ܦܨܝܕܐ	Пруд
ܐܪܓܘܢܐ	Пурпурный цвет
ܢܘܪܢܝܐ	Пирамида (геометрия)
ܘܝܩܝܦܕܝܐ:HotCat	Википедия:Гаджеты/HotCat
ܒܛܐ	Утки
ܗܝܟܠܐ ܕܫܠܝܡܘܢ	Иерусалимский Храм
ܠܘܝܣ ܪܘܦܐܝܠ ܩܕܡܝܐ ܣܟܘ	Луис Рафаэль I Сако
ܩܠܒܐ:ܓܕܫܐ ܗܫܝܐ	Шаблон:Актуальные события
ܣܕܪܐ:ܡܟܬܒܢܘܬܐ ܕܐܬܪܘܬܐ	Категория:Страны
ܘܝܩܝܦܕܝܐ:ܡܕܒܪܢܐ	Википедия:Администраторы
ܣܕܪܐ:ܫܕܬܐ	Категория:Профессии
ܘܝܩܝܦܕܝܐ:ܒܘܬ̈ܐ	Википедия:Бот
ܣܕܪܐ:ܙܒܢܐ	Категория:Время
ܣܕܪܐ:ܙܘܙܐ	Категория:Деньги
ܣܕܪܐ:ܝܘܠܦܢ ܨܪܘܝܘܬܐ	Категория:Анатомия
ܣܕܪܐ:ܐܣܝܘܬܐ	Категория:Медицина
ܫܡܥܘܢ (ܫܡܐ)	Семён
ܦܪܝܕܘܢ ܐܬܘܪܝܐ	Атурая, Фрейдун
ܡܨܪܝܢ	Египет
ܩܠܒܐ:Bot	Шаблон:Bot
ܩܢܕܐ	Канада
ܣܕܪܐ:ܝܘܢ	Категория:Греция
ܣܕܪܐ:ܣܘܝܕ	Категория:Швеция
ܡܝܟܐܝܠ ܒܝܬ ܣܗܕܐ	Садо, Михаил Юханович
ܫܐܡ	Шам
ܩܠܒܐ:ܐܫܛܪܘܬܐ	Шаблон:Doc
ܣܕܪܐ:User languages	Категория:Википедия:Участники по языкам
ܦܘܠܚܢܐ	Предпринимательство
ܩܠܒܐ:Softredirect	Шаблон:Soft redirect
ܩܠܒܐ:Delete	Шаблон:К быстрому удалению
ܡܓܕܠܐ (ܩܪܝܬܐ)	Магдала (Израиль)
ܣܕܪܐ:ܛܟܢܘܠܘܓܝܐ	Категория:Технология
ܓܒܪܐܝܠ (ܫܡܐ)	Гавриил
ܣܕܪܐ:ܠܫܢܐ	Категория:Языки
ܣܕܪܐ:ܩܢܘܢܐ ܕܠܥܙܐ	Категория:Грамматика
ܘܝܩܝܦܕܝܐ:General disclaimer	Википедия:Отказ от ответственности
ܣܕܪܐ:Noindexed pages	Категория:Неиндексируемые страницы
ܘܝܩܝܦܕܝܐ:ܕܘܒܪܐ	Википедия:Оформление статей
ܩܠܒܐ:Navbox	Шаблон:Navbox
ܐܝܓܢܐܛܝܘܣ ܐܦܪܝܡ ܬܪܝܢܐ	Игнатий Ефрем II (Керим)
ܣܕܪܐ:ܩܠܒܐ ܐܬܘܬܐ ܕܐܝܣܘ	Категория:Шаблоны:Флаги
ܩܠܒܐ:ܡܦܐܬܐ ܩܠܒܐ	Шаблон:Tnavbar
ܩܠܒܐ:Clear	Шаблон:Clear
ܘܝܩܝܦܕܝܐ:ܡܟܬܒܘܬܐ ܕܡܓܠܐ ܠܟܠ ܘܝܩܝܦܕܝܐ	Википедия:Список статей, которые должны быть во всех языковых версиях
ܣܕܪܐ:ܐܠܝܩܛܪܘܢܝܘܬܐ	Категория:Электроника
ܣܕܪܐ:ܝܪܚܐ ܕܫܢܬܐ	Категория:Месяцы
ܩܠܒܐ:Babel	Шаблон:Babel
ܩܠܒܐ:Commons	Шаблон:Commons
ܩܠܒܐ:Reflist	Шаблон:Примечания
ܩܠܒܐ:User ar-1	Шаблон:User ar-1
ܩܠܒܐ:User az	Шаблон:User az
ܩܠܒܐ:See also	Шаблон:См. также
ܩܠܒܐ:User de	Шаблон:User de
ܩܠܒܐ:User es	Шаблон:User es
ܩܠܒܐ:User en-3	Шаблон:User en-3
ܩܠܒܐ:User en-1	Шаблон:User en-1
ܩܠܒܐ:User en-2	Шаблон:User en-2
ܩܠܒܐ:User en-4	Шаблон:User en-4
ܩܠܒܐ:User en-0	Шаблон:User en-0
ܩܠܒܐ:User en	Шаблон:User en
ܩܠܒܐ:User fa	Шаблон:User fa
ܩܠܒܐ:User fr-1	Шаблон:User fr-1
ܩܠܒܐ:User he-2	Шаблон:User he-2
ܩܠܒܐ:User he-1	Шаблон:User he-1
ܩܠܒܐ:User sk	Шаблон:User sk
ܩܠܒܐ:User tr	Шаблон:User tr
ܩܠܒܐ:User ja	Шаблон:User ja
ܩܠܒܐ:User fr	Шаблон:User fr
ܩܠܒܐ:User he	Шаблон:User he
ܣܕܪܐ:ܐܣܝܐ	Категория:Азия
ܣܕܪܐ:ܕܪܐ ܕܥܣܪܝܢ ܘܚܕ	Категория:XXI век
ܩܠܒܐ:Mod	Шаблон:Mod
ܩܠܒܐ:User sv	Шаблон:User sv
ܩܠܒܐ:User it	Шаблон:User it
ܣܕܪܐ:ܝܘܡܐ ܕܫܒܘܥܐ	Категория:Дни недели
ܣܕܪܐ:ܐܨܪܐ	Категория:Приправы
ܩܠܒܐ:ܝܗܘܝܬܐ Peru	Шаблон:Флагификация/Перу
ܩܠܒܐ:ܝܗܘܝܬܐ Paraguay	Шаблон:Флагификация/Парагвай
ܩܠܒܐ:ܝܗܘܝܬܐ French Guiana	Шаблон:Флагификация/Гайана
ܩܠܒܐ:ܝܗܘܝܬܐ Argentina	Шаблон:Флагификация/Аргентина
ܩܠܒܐ:Navbox suite	Шаблон:Навигационные шаблоны
ܩܠܒܐ:ܡܟܬܒܢܘܬܐ ܕܝܦܬܐ	Шаблон:Collapsible list
ܩܠܒܐ:Sidebar	Шаблон:Боковая навигационная таблица
ܩܠܒܐ:Ambox	Шаблон:Ambox
ܩܠܒܐ:ܐܬܪܐ	Шаблон:Государство
ܩܠܒܐ:/box-header	Шаблон:Box-header
ܣܕܪܐ:User en	Категория:User en
ܣܕܪܐ:User zh	Категория:User zh
ܩܠܒܐ:ܐܠܦܒܝܬ ܥܪܒܝܐ	Шаблон:Арабский алфавит
ܣܕܪܐ:User zh-N	Категория:User zh-N
ܩܠܒܐ:ܨܢܕܘܩ ܪܡܙܐ2	Шаблон:Карточка
ܩܠܒܐ:User zh	Шаблон:User zh
ܩܠܒܐ:Navbox/core	Шаблон:Navbox/core
ܩܠܒܐ:ܩܠܒܐ ܐܚܪܝܢܐ	Шаблон:Template other
ܩܠܒܐ:ܐܠܦܒܝܬ ܠܐܛܝܢܝܐ	Шаблон:Латиница
ܣܕܪܐ:ܦܐܦܐ	Категория:Папы римские
ܩܠܒܐ:Pp-template	MediaWiki:Protectedpagetext
ܩܠܒܐ:User nl-1	Шаблон:User nl-1
ܩܠܒܐ:User nl-2	Шаблон:User nl-2
ܣܕܪܐ:ܪܝܫܝ ܩܘܛܢܝܘܬܐ	Категория:Президенты государств
ܩܠܒܐ:User ru	Шаблон:User ru
ܩܠܒܐ:IPA	Шаблон:IPA1
ܣܕܪܐ:ܗܪܘܡܐ	Категория:Пряности
ܣܕܪܐ:ܦܠܫܬ	Категория:Палестина
ܣܕܪܐ:ܡܠܐܟܐ	Категория:Ангелы
ܣܕܪܐ:ܢܒܝܐ	Категория:Пророки
ܩܠܒܐ:Rellink	Шаблон:Rellink
ܩܠܒܐ:Category redirect	Шаблон:Переименованная категория
ܩܠܒܐ:ܝܗܘܝܬܐ Venezuela	Шаблон:Флагификация/Венесуэла
ܩܠܒܐ:ܨܢܕܘܩ ܡܕܒܪܢܐ	Шаблон:Государственный деятель
ܩܠܒܐ:Sortname	Шаблон:Sortname
ܩܠܒܐ:Border	Шаблон:Граница
ܩܠܒܐ:ܡܢܝܢܐ ܕܝܪܚܐ	Шаблон:MONTHNUMBER
ܩܠܒܐ:ܪܕ	Шаблон:Fmbox
ܩܠܒܐ:ܝܗܘܝܬܐ Chile	Шаблон:Флагификация/Чили
ܩܠܒܐ:GUA	Шаблон:GTM
ܩܠܒܐ:User nl	Шаблон:User nl
ܩܠܒܐ:Navbox years	Шаблон:NavboxYears
ܩܠܒܐ:ܡܣܦܩ ܩܐܫ	Шаблон:Очистить кэш
ܩܠܒܐ:ܨܢܕܘܩ ܐܡܢܐ	Шаблон:Художник
ܩܠܒܐ:ܡܦܠܚܢܐ	Шаблон:User
ܣܕܪܐ:ܬܘܢܣ	Категория:Тунис
ܩܠܒܐ:Cmbox	Шаблон:Cmbox
ܩܠܒܐ:Oppose	Шаблон:Против
ܩܠܒܐ:COL	Шаблон:COL
ܩܠܒܐ:PER	Шаблон:PER
ܩܠܒܐ:ܨܢܕܘܩ ܡܕܥܐ ܕܝܒܫܬܐ	Шаблон:Материк
ܩܠܒܐ:User ar-2	Шаблон:User ar-2
ܩܠܒܐ:User ar-3	Шаблон:User ar-3
ܩܠܒܐ:User ar	Шаблон:User ar
ܩܠܒܐ:ܝܘܡܐ ܕܫܒܘܥܐ	Шаблон:Неделя
ܣܕܪܐ:ܡܕܝܢܬܐ ܒܐܘܚܕܢܐ ܡܚܝܕܐ	Категория:Города США
ܩܠܒܐ:ܬ.ܐ.	Шаблон:Неоднозначность
ܩܠܒܐ:No	Шаблон:Не сделано
ܣܕܪܐ:ܩܠܒܐ ܨܢܕܘܩܐ	Категория:Шаблоны:Карточки
ܩܠܒܐ:Partial	Шаблон:Частично
ܩܠܒܐ:UsersSpeak	Шаблон:UsersSpeak
ܩܠܒܐ:ܩܘܕܝܟܘܣ ܕܣܕܪܐ	Шаблон:Индекс категории
ܩܠܒܐ:?	Шаблон:Неизвестно1
ܩܠܒܐ:ܝܗܘܝܬܐ Colombia	Шаблон:Флагификация/Колумбия
ܩܠܒܐ:ܐܠܦܒܝܬ ܥܒܪܝܐ	Шаблон:Еврейский алфавит
ܣܕܪܐ:User yue	Категория:User zh-yue
ܣܕܪܐ:User az	Категория:User az
ܣܕܪܐ:User sk	Категория:User sk
ܣܕܪܐ:User fr	Категория:User fr
ܣܕܪܐ:User ja	Категория:User ja
ܣܕܪܐ:User la	Категория:User la
ܣܕܪܐ:User pt	Категория:User pt
ܣܕܪܐ:User ro	Категория:User ro
ܣܕܪܐ:User sv	Категория:User sv
ܣܕܪܐ:User ko-N	Категория:User ko-N
ܩܠܒܐ:User yue	Шаблон:User zh-yue
ܣܕܪܐ:ܗܘܦܪܟܝܣ ܕܥܝܪܐܩ	Категория:Провинции Ирака
ܩܠܒܐ:Cat main	Шаблон:Основная статья по теме категории
ܣܕܪܐ:User ar	Категория:User ar
ܣܕܪܐ:User arc	Категория:User arc
ܣܕܪܐ:User da	Категория:User da
ܣܕܪܐ:User sk-N	Категория:User sk-N
ܣܕܪܐ:User de	Категория:User de
ܣܕܪܐ:User el	Категория:User el
ܣܕܪܐ:User en-N	Категория:User en-N
ܣܕܪܐ:User es	Категория:User es
ܣܕܪܐ:User fa	Категория:User fa
ܣܕܪܐ:User fi	Категория:User fi
ܣܕܪܐ:User he	Категория:User he
ܩܠܒܐ:N/a	Шаблон:N/a
ܣܕܪܐ:User hy	Категория:User hy
ܣܕܪܐ:ܠܫܢܐ ܥܒܪܝܐ	Категория:Иврит
ܣܕܪܐ:ܡܕܝܢܬܐ ܒܐܝܣܪܐܝܠ	Категория:Города Израиля
ܣܕܪܐ:User it	Категория:User it
ܣܕܪܐ:User ko	Категория:User ko
ܣܕܪܐ:ܒܬܫܪܝܢ ܐܚܪܝ	Категория:Ноябрь
ܣܕܪܐ:ܝܡܡܐ	Категория:Моря
ܩܠܒܐ:ܐܠܦܒܝܬ ܝܘܢܝܐ	Шаблон:Греческий алфавит
ܩܠܒܐ:No2	Шаблон:No2
ܣܕܪܐ:ܦܛܪܝܪܟܘ ܕܥܕܬܐ ܣܘܪܝܝܬܐ ܩܬܘܠܝܩܝܬܐ	Категория:Патриархи Сирийской католической церкви
ܩܠܒܐ:Rh	Шаблон:Rh
ܩܠܒܐ:ܡܢܝܢܐ ܕܡܡܪܐ ܦܪܝܫܐ	Шаблон:Счётчик ИС
ܩܠܒܐ:ܢܒܝܐ ܕܕܝܬܝܩܝ ܥܬܝܩܬܐ	Шаблон:Библейские пророки
ܣܕܪܐ:ܒܝܬܝܘܬܐ	Категория:Родственные отношения
ܩܠܒܐ:ܝܗܘܝܬܐ Brazil	Шаблон:Флагификация/Бразилия
ܩܠܒܐ:Yes2	Шаблон:Yes2
ܬܪܥܐ:ܬܘܕܝܬܐ	Портал:Религия
ܣܕܪܐ:ܪܝܫܝ ܩܘܛܢܝܘܬܐ ܥܠ ܐܬܪܐ	Категория:Президенты по странам
ܣܕܪܐ:User ru	Категория:User ru
ܣܕܪܐ:User ru-3	Категория:User ru-3
ܣܕܪܐ:User tr	Категория:User tr
ܣܕܪܐ:ܙܡܪܐ	Категория:Музыканты
ܩܠܒܐ:Lang	Шаблон:Lang
ܣܕܪܐ:ܪܫܘܡܐ	Категория:Художники
ܩܠܒܐ:ܫܠܝܚܐ ܕܡܫܝܚܐ	Шаблон:Апостолы
ܩܠܒܐ:ܟܬܒܐ ܩܕܝܫܐ	Шаблон:Библейская статья
ܣܕܪܐ:ܐܡܢܐ ܥܠ ܐܕܫܐ	Категория:Профессии по категориям
ܩܠܒܐ:ܚܡܫܐ ܐܘܩܝܢܘ	Шаблон:Океаны
ܩܠܒܐ:CHI	Шаблон:CHL
ܣܕܪܐ:ܡܕܝܢܬܐ ܒܐܢܓܠܢܕ	Категория:Города Англии
ܣܕܪܐ:ܢܝܓܪ	Категория:Нигер
ܣܕܪܐ:ܝܘܠܦܢ ܩܢܘܢܝܐ	Категория:Юриспруденция
ܩܠܒܐ:User ar-0	Шаблон:User ar-0
ܣܕܪܐ:ܣܥܪܐ	Категория:Причёски
ܩܠܒܐ:User ar-4	Шаблон:User ar-4
ܣܕܪܐ:ܢܗܪܘܬܐ	Категория:Реки
ܩܠܒܐ:User he-0	Шаблон:User he-0
ܩܠܒܐ:User he-3	Шаблон:User he-3
ܩܠܒܐ:User he-4	Шаблон:User he-4
ܩܠܒܐ:User ko	Шаблон:User ko
ܩܠܒܐ:User pt	Шаблон:User pt
ܣܕܪܐ:User nl	Категория:User nl
ܣܕܪܐ:User no	Категория:User no
ܣܕܪܐ:ܣܘܪܝܐ	Категория:Сирия
ܣܕܪܐ:ܕܪܐ ܩܕܡܝܐ	Категория:I век
ܣܕܪܐ:ܓܙܪܬܐ ܝܒܫܢܝܬܐ	Категория:Полуострова
ܣܕܪܐ:ܗܘܦܪܟܝܣ ܕܗܘܠܢܕܐ	Категория:Провинции Нидерландов
ܣܕܪܐ:ܡܢܝܢܐ	Категория:Целые числа
ܣܕܪܐ:ܡܕܝܢܬܐ ܕܥܝܪܐܩ	Категория:Города Ирака
ܣܕܪܐ:ܥܝܢܐ (ܨܪܘܝܘܬܐ)	Категория:Глаз
ܣܕܪܐ:ܓܘܪܓܝܐ	Категория:Грузия
ܣܕܪܐ:ܟܘܘܝܬ	Категория:Кувейт
ܣܕܪܐ:ܠܒܢܢ	Категория:Ливан
ܣܕܪܐ:ܪܝܫܝ ܩܘܛܢܝܘܬܐ ܕܐܬܪܘܬܐ ܡܚܝܕܐ ܕܐܡܪܝܩܐ	Категория:Президенты США
ܣܕܪܐ:ܝܘܪܕܢܢ	Категория:Иордания
ܣܕܪܐ:ܦܐܪܐ	Категория:Фрукты
ܣܕܪܐ:ܝܘܠܦܢ ܟܘܪܗܢܐ	Категория:Патология
ܣܕܪܐ:ܓܒܐ	Категория:Политические партии
ܣܕܪܐ:ܕܝܬܝܩܝ ܚܕܬܐ	Категория:Новый Завет
ܣܕܪܐ:ܕܝܬܝܩܝ ܥܬܝܩܬܐ	Категория:Ветхий Завет
ܣܕܪܐ:ܐܘܩܝܢܘ	Категория:Океаны
ܣܕܪܐ:ܓܪܡܐ	Категория:Костная система
ܣܕܪܐ:ܚܝܘܬܐ	Категория:Животные
ܣܕܪܐ:ܛܘܪܐ	Категория:Горные хребты
ܣܕܪܐ:ܣܘܥܪܢܐ	Категория:События
ܣܕܪܐ:ܟܘܪܗܢܐ	Категория:Заболевания
ܣܕܪܐ:User pl	Категория:User pl
ܣܕܪܐ:ܩܣܪ	Категория:Императоры
ܣܕܪܐ:ܡܕܒܪܐ	Категория:Пустыни
ܣܕܪܐ:ܝܡܡܬܐ	Категория:Озёра
ܩܠܒܐ:ܨܢܕܘܩ ܡܚܡܝܬܐ ܡܨܥܝܐ	Шаблон:Карточка носителя
ܩܠܒܐ:ܨܢܕܘܩ ܪܡܙܐ ܕܠܫܢܐ	Шаблон:Язык
ܣܕܪܐ:ܠܫܢܐ ܘܠܥܙܐ ܨܝܢܝܐ	Категория:Китайские языки и диалекты
ܛܪܘܝܐܢܝ	Трояны (Мазовецкое воеводство)
ܩܠܒܐ:User arc-2	Шаблон:User arc
ܩܠܒܐ:Sister	Шаблон:Sister
ܣܕܪܐ:ܢܒܝܐ ܕܕܝܬܝܩܝ ܥܬܝܩܬܐ	Категория:Библейские пророки
ܫܩܐ	Голень
ܣܕܪܐ:ܦܛܪܝܪܟܘ ܕܥܕܬܐ ܕܡܕܢܚܐ ܕܐܬܘܪܝܐ	Категория:Патриархи Ассирийской церкви Востока
ܣܕܪܐ:ܦܛܪܝܪܟܘ ܕܥܕܬܐ ܟܠܕܝܬܐ ܩܬܘܠܝܩܝܬܐ	Категория:Патриархи Халдейской католической церкви
ܩܠܒܐ:ܝܗܘܝܬܐ Falkland Islands	Шаблон:Флагификация/Фолклендские острова
ܣܕܪܐ:ܦܛܪܝܪܟܘ	Категория:Патриархи
ط	Та (шестнадцатая буква арабского алфавита)
ܣܕܪܐ:ܒܝܬ ܟܬܒܐ	Категория:Библиотеки
ܣܕܪܐ:ܐܪܙܐ	Категория:Христианские таинства
ܣܕܪܐ:ܓܘܢܐ	Категория:Цвет
ܩܠܒܐ:ܝܗܘܝܬܐ South Georgia and the South Sandwich Islands	Шаблон:Флагификация/Южная Георгия и Южные Сандвичевы острова
ܣܕܪܐ:ܦܣܩܐ ܕܝܘܡܐ	Категория:Сутки
ܣܕܪܐ:ܦܛܪܝܪܟܘ ܕܥܕܬܐ ܣܘܪܝܝܬܐ ܐܪܬܘܕܟܣܝܬܐ	Категория:Патриархи Сирийской православной церкви
ܕܒܘܪܐ (ܪܚܫܐ)	Осы
ܩܠܒܐ:ܣܘܪܓܕܐ ܚܘܫܒܢܐ	Шаблон:Год в других календарях
ܣܕܪܐ:ܩܕܝܫܐ	Категория:Святые
ܩܪܕܐ (ܪܚܫܐ)	Ixodida
ܩܠܒܐ:ܣܝܩܘܡ ܫܘܪܝܐ	Шаблон:Start date
ܩܠܒܐ:User nl-4	Шаблон:User nl-4
ܩܠܒܐ:User nl-3	Шаблон:User nl-3
ܩܠܒܐ:ܠܫܢܐ ܨܝܢܝܐ	Шаблон:Китайский язык
ܬܪܥܐ:ܐܘܩܝܢܘܣܝܐ	Портал:Океания
ܩܠܒܐ:User he-5	Шаблон:User he-5
ܩܠܒܐ:P1	Шаблон:P1
ܕܝܪܐ ܕܡܪܝ ܐܘܓܝܢ	Монастырь Мар Авген
ܢܘܓܗܐ	Рассвет
ܘܝܩܝܦܕܝܐ:NavFrame	Википедия:Сворачивающиеся блоки
ܚܡܣܐ	Имбирь (пряность)
ܕܝܠܢܝܐ:ܫܘܚܠܦ̈ܐ ܚܕ̈ܬܐ	Служебная:Свежие правки
