ᎬᎿᎦᏍᏛ	Африка
ᏣᏩᏂᏏ	Япония
ᏧᎦᎾᏮ ᎠᎹᏰᏟ	Южная Америка
ᎠᏂᏍᏆᏂᏱ	Испания
ᏌᏊᎢᏳᎾᎵᏍᏔᏅᏍᎦᏚᎩ ᎾᎿ ᎠᎺᏰᏟ	Соединённые Штаты Америки
ᏇᎵᏥᎥᎻ	Бельгия
ᎡᎶᎯ	Земля
ᏣᏥ ᏩᏒᏓᎾ	Вашингтон, Джордж
ᏫᏂᎦᏙᎯ	Финляндия
ᏍᏫᏕᏂ	Швеция
ᏗᏂᎹᎦ	Дания
ᏉᎳᏂ	Польша
ᎢᏔᎵ	Италия
ᏍᏫᏍ	Швейцария
ᎠᏍᏟᏯ	Австрия
ᎪᎢᎯ	Греция
ᎬᏃ	Турция
ᏉᏥᎦᎳ	Португалия
ᏳᎳᏛ	Европа
ᏓᎶᏂᎦᏍᏛ	Азия
ᏧᏴᏢ ᎠᎹᏰᏟ	Северная Америка
ᏧᏁᏍᏓᎸ	Антарктида
ᏫᎩᏇᏗᏯ	Википедия
ᎾᏍᎩ ᏁᏛᎳᏂ	Нидерланды
ᏩᏙᎵ	Пенис у животных
ᏄᏯᎩ BMX	Нью-Йорк
ᏆᎳᎩ ᎣᏆᎹ	Обама, Барак
ᎫᎴ ᏗᏍᎪᏂᎯᏱ	Лондон
ᏒᎦᏔ	Яблоко
ᎺᏏᎪ	Мексика
ᎤᏃᎸᏔᏅ	Январь
ᎧᎦᎵ	Февраль
ᎠᎾᏱᎵᏒ	Март
ᎹᏏ	Марс
ᎫᏬᏂ	Апрель
ᎠᎾᏍᎬᏘ	Май
ᏕᎭᎷᏱ	Июнь
ᎫᏰᏉᏂ	Июль
ᎦᎶᏂ	Август
ᏚᎵᏍᏗ	Сентябрь
ᏚᏂᏃᏗ	Октябрь
ᏅᏓᏕᏆ	Ноябрь
ᎥᏍᎩᏱ	Декабрь
ᏢᏓᏥ ᎤᏃᏕᎾ	Лев
ᎩᏟ	Собака
ᎩᎵᏏᏲ	Великобритания
ᏪᏌ	Кошка
ᏓᎶᏂᎨᏍᏛ	Китайская Народная Республика
ᎠᏣᏗ	Рыбы
ᏆᏏᎵ	Бразилия
ᏲᏂᎢ	Россия
Cetacea	Китообразные
ᎠᏛᏥ	Германия
ᏇᎳᎷᏍ	Белоруссия
ᎠᏂᏛᏥ ᎦᏬᏂᎯᏍᏗ	Немецкий язык
ᏧᏁᏍᏓᎸᎯ	Исландия
ᎡᏍᏙᏂᏯ	Эстония
ᏌᏓᏂ	Сатурн
ᏣᏥ ᎡᏙᎯ ᏊᏏ	Буш, Джордж Уокер
ᏳᎧᎴᏂ	Украина
ᏤᎩ ᏍᎦᏚᎩ	Чехия
ᎹᎵᏙᏫᎠ	Молдавия
ᎶᎹᏂᏯ	Румыния
ᎹᏏᏙᏂᎢᎠ	Республика Македония
ᎠᎵᏇᏂᏯ	Албания
ᎢᏤᎢᏳᏍᏗ ᎦᏙᎯ	Гренландия (административная единица)
ᏆᏍᏂᏯ ᎠᎴ ᎲᏤᎪᏫᎾ	Босния и Герцеговина
ᎠᏏᎵᏆᏌᏂ	Азербайджан
ᎠᏂᏙᎳ	Андорра
ᎧᏌᎩᏍᏔᏂ	Казахстан
ᎢᏂᏙᏂᏍᏯ	Индонезия
ᎠᏂᎬᎾ ᎧᏬᏂᎯᏍᏗ	Турецкий язык
ᎤᏍᏇᎩᏍᏖᏂ	Узбекистан
ᎠᎹ	Вода
ᎦᏃᏥ	Кожа (материал)
ᎠᏓ	Древесина
ᏥᎵ	Чили
ᎹᎫᎵ	Меркурий
ᎠᎾᏂᏍᏓᎾᎵ	Венера
ᎦᏬᏂᎯᏍᏗ	Язык
ᏧᏈᏓ	Юпитер
ᏳᏪᏅᏍ	Уран (планета)
ᏁᏩᏚᏂ	Нептун
ᏡᏙ	Плутон
ᎠᏂᎶᎻ ᎦᏬᏂᎯᏍᏗ	Латинский язык
ᎠᎵᎻᏂᎠ	Армения
ᏒᏈᏯ	Сербия
ᎡᎳᏗᏜ	Австралия
ᏘᏲᎭᎵ ᎡᏆ	Динозавры
ᏎᏗᏳᏍᏗ ᏒᎦᏔ	Груша
ᏅᏩᏙ ᎯᏯᏛ	Мир (отсутствие войны)
Star Wars	Звёздные войны
ᎴᎹᏂ	Лимон
ᏆᏁᎾ	Банан
ᎦᏚᎲᎢ	Город
Napoleon	Наполеон I
ᏃᏈᏏ	Звезда
ᏅᏓ	Солнце
ᎦᎷᎾᏗ	Небо
ᏅᏓ ᎠᎴ ᏚᏓᏕᏫᏍᏛ	Солнечная система
ᎦᏌᎧᎯᎨ ᎤᏃᎴ	Гелий
ᎵᏘᎥᎻ	Литий
ᏇᎵᎵᎥᎻ	Бериллий
ᎪᏪᎵ	Книга
ᏒᏃᏱ	Ночь
ᎤᎦᏔ ᏅᏓᏳᏓᎴᏅ ᏬᏗᎨ	Углерод
ᎾᎢᏠᏤᏂ	Азот
ᏗᎧᏃᎩᏛ	Музыка
ᏩᎶᏫᏂ	Фтор
ᏥᏩᏩ	Чиуауа
ᎦᏌᎧ ᏔᎷᎩᏍᎩ	Алюминий
ᎢᏂᏗᎢᎠ	Индия
ᏔᎷᎩᏍᎩ	Железо
ᏉᏔᏏᎥᎻ	Калий
ᎪᎳ ᏗᏝᏂᎪᎯᏍᏗᏍᎩ	Кальций
ᎦᏂ	Свинец
ᎹᏂᎪᎵᎠ	Монголия
ᏔᎢᏖᏂᎥᎻ	Титан (элемент)
ᏩᏁᏗᎥᎻ	Ванадий
ᏐᏈᎵ	Домашняя лошадь
ᎦᏂᏝᎢ	Животные
ᏉᎵᏫᎠ	Боливия
ᎥᏣᏱ	Медь
ᎩᎵᏣᎢᏍ	Киргизия
ᏩᎧ	Корова
ᏔᏥᎩᏍᏕᏂ	Таджикистан
ᏉᎨᎼᏂ	Покемон
ᏔᏯᎴᏂ	Таиланд
ᎠᎢᎵᏗᏴᎻ	Иридий
ᏝᏘᏅᎻ	Платина
ᏧᎦᎾᏮ ᎪᎵᎠ	Республика Корея
ᎠᏕᎸ ᏓᎶᏂᎨ	Золото
ᎠᏂᏉᎵᏍ	Поляки
Julius Caesar	Гай Юлий Цезарь
ᎤᏅᏉᎳᏛ	Радуга
ᎠᏑᏫᏍᏗ	Цвет
ᎠᏕᎸ ᎤᏁᎦ	Серебро
ᏔᎷᎩᏍᎩᏳᏍᏗ	Олово
ᏳᏪᏂᎥᎻ	Уран (элемент)
ᏡᏙᏂᎥᎻ	Плутоний
ᏁᏩᏚᏂᎥᎻ	Нептуний
ᏇᎵᎥᎻ	Барий
ᏍᏆᏂ ᎧᏬᏂᎯᏍᏗ	Испанский язык
Johann Sebastian Bach	Бах, Иоганн Себастьян
ᎧᎿᏁᏍᎩ	Пауки
ᎠᏓᎵᏍᎩᏱᏍᎩ	Обезьяны
ᎠᏕᎳ	Деньги
ᏄᏯᎩ	Нью-Йорк (штат)
ᏳᎳᏈᎥᎻ	Европий
Augustus	Октавиан Август
Trajan	Траян
ᏙᎩᏲ	Токио
ᏍᏆᏂᏤᏍᏛᎢ	Нью-Мексико
ᎣᎦᎳᎰᎹ	Оклахома
ᏗᎦᎳᏫᏍᏗ ᏥᏌᏯ	Церковь истинного Иисуса
ᎩᎵᏏ ᎦᏬᏂᎯᏍᏗ	Английский язык
ᎠᎺᎵᏏᏯᎻ	Америций
ᎠᏔᏩ, ᎨᎾᏓ	Оттава
ᎠᏤᏙ	Джакарта
Wikipedia:ᏃᏯᎭ ᎧᏁᏌᎢ	Википедия:Песочница
ᎤᏪᏴ	Река
ᎠᎧᏔᏘ	Телескоп
ᎫᎵᏘᎦ	Куритиба
ᏌᎶᎵ	Обыкновенная белка
ᎠᏙᎯ ᎢᎾᎨ	Лес
ᎪᏈᏂ ᏌᎪᏂᎨ	Блю, Корбин
ᏧᏈᏓ (ᎤᏁᎳᏅᎯ)	Юпитер (мифология)
ᏉᏧᎾ	Фортуна
ᏳᎳᏛ ᎠᏕᎳ	Евро
Category:ᎠᏂᎶᎻ ᎤᎾᏁᎳᏅᎯ	Категория:Боги в римской мифологии
ᎡᏆ ᎦᏙᎯ	Континент
ᎯᎸᏍᎩ ᏥᏍᏆ	Птицы
ᏏᏅᏙ	Месяц
ᎤᎵᎮᎵᏍᏗ	Заглавная страница
ᎤᎴᏍᏓᎸ	Влагалище женщины
ᎤᏬᎳᏨᎯ	Философия
Category:Candidates for speedy deletion	Категория:Википедия:К быстрому удалению
ᎤᏔᏅ ᏗᎧᏃᎩᏍᏗ	Фортепиано
ᏗᎧᏃᎩᏍᏗ	Гитара
ᎤᏬᏚ	Красота
ᏙᏒᏓᎵ	Муравьи
ᏩᏚᎵᏏ	Пчёлы
ᏕᎭᎷᎨ ᎠᏓᏛᏍᎩ	Баклажан
ᎧᏬᏄ	Утиные
ᎤᏂᏥ	Мать
ᎤᎾᏥ	Снег
ᎠᏲᎵ	Ребёнок
ᎠᎦᏍᎬ	Дождь
Nelson Mandela	Мандела, Нельсон
ᏅᏯ	Горная порода
ᎤᎶᎩᎸ	Облака
ᎠᎦᎷᎦ	Смерч
ᏗᏎᏍᏗ ᏓᏍᏓᏅᏅ	Геометрия
Category:ᏗᎧᏃᎩᏛ	Категория:Музыка
ᎬᏂᎨᏧᎵ	Обыкновенная лисица
ᎧᏫ	Кофе
ᎣᏓᎸᎢ	Гора
ᎤᎧᏲᏗ ᎡᎶᎯᏱ	Пустыня
ᏴᏩᏁᎬ Civil ᏓᏄᏩ	Гражданская война в США
ᏆᏍᎩ ᎦᏬᏂᎯᏍᏗ	Баскский язык
Unicode/Cherokee	Юникод
ᎠᏂᏍᏫᏗ ᎦᏬᏂᎯᏍᏗ	Шведский язык
ᎥᎦᏔᎲᎢ	Знание
ᎪᎵᎥ	Корейский язык
ᎦᎴᎪ ᎦᏬᏂᎯᏍᏗ	Галисийский язык
ᏁᎵᏒ	Мышление (психология)
ᎠᎺᏉᎯ	Океан
ᎠᏤᎷᎯᏍᏗ	Саксофон
ᏬᎾᎵᏗ ᏪᎦᏂ	Рейган, Рональд
ᎠᏣᏅᏙ	Плазма
ᎠᎴᏂ	Бекаси
ᏏᏆ	Кабаны
ᏚᎵᏍᏗ 11, 2001 ᏗᎦᏘᎸᏍᏗ	Террористические акты 11 сентября 2001 года
ᏡᎬ	Дерево
ᎤᏅᏗ ᎦᏚᏅ	Сыр
ᏖᎸᎳᏗ	Виноград (ягода)
ᏐᎯ	Орех
ᎠᎱᎵ	Барабан
ᏄᏓᎨᏒ (Gravitation)	Гравитация
ᏧᏙ	Дзюдо
ᎠᎾᎦᎵᏍᎩ ᎦᏂᏱᏍᎩ	Металлы
ᎠᏥᎸ ᏔᎷᎩᏍᎩ	Сталь
ᏗᎦᎶᎪᏗ	Сельское хозяйство
ᏎᎷ	Кукуруза сахарная
ᎠᏍᏓᏩᏛᏍᏙᏗ	Частота
ᎠᏰᎵ ᏚᎾᏙᏢᏩᏗᏒ ᏙᎪᏪᎸ	Алфавитный список стран и территорий
ᏲᎾ	Медвежьи
ᏧᏍᎦ	Дуб
ᎠᏂ	Земляника ананасная
ᎧᏄᎦᎸ	Ежевика
ᏆᏅ	Персик
ᎣᏂᏥ	Апельсин
ᎳᎢᎻ	Лайм (плод)
ᎠᎵᎮᎵᏍᏗ ᎢᎦ	День благодарения
ᎦᏓᏘ	Флаг
ᎦᏍᎩᎶ	Стул
ᏗᎦᎵᏍᏚᎩᏍᎩ	Жираф
ᎹᏱᏕ	Утконос
Queen	Queen
ᏗᎦᎭᎵ	Ящерицы
ᏫᎩᏇᏗᏯ:ᎾᎥ ᏄᎾᏓᎸ ᎾᎿᎢ	Википедия:Форум
ᎠᏍᏘᏂ	Остин (Техас)
ᎭᏫᎾᏗᏢ ᏗᏎᏍᏗ ᎤᎬᏩᎵ	Плоскость (геометрия)
ᎬᎾ ᎤᏔᎾ	Страус
ᎠᎺᎵᎨ ᎬᎾ ᎤᏔᎾ	Нанду
ᏓᏂᏍᏓᏲᎯᎲ	Рождество Христово
Indo-European languages	Индоевропейские языки
ᏢᏓᏥᏧᎶᎸᏗ	Тигр
ᎩᏳᎦ	Бурундуки
ᎠᏕᎵ	Адель (певица)
ᎠᏫ	Оленевые
ᎤᏁᏍᏓᎳ	Лёд
ᎣᎩᏙᏓ ᎦᎸᎳᏗ ᎮᎯ	Отче наш
ᎦᎦᎹ	Огурец обыкновенный
ᏔᎹᏟ	Томат
ᏎᎵᎾ	Селена (певица)
ᎵᎳ ᏙᏮᏍ	Даунс, Лила
ᏢᏓᏥ ᎠᎦᏣᏄᎳ	Гепард
Felidae	Кошачьи
ᏑᎵ	Обыкновенный канюк
Escherichia coli	Кишечная палочка
ᎠᏐᎠᏍᏙ	Настоящие тюлени
ᎠᏫᏳᏍᏘ	Антилопы
ᎨᏯᏔᎯ ᎬᎾ	Индейка
ᎤᏍᏗᏰᎬ	Волосы
ᎠᏍᏛᎭᏟ	Сэндвич
ᏥᏯ	Выдра
ᏩᏂᎨ ᎠᏣᏗ	Медуза
Pinnipedia	Ластоногие
ᎭᏰᎳᏍᏗ	Нож
ᏐᏈᎵ-ᏧᎶᎸᏗ	Зебры
ᏣᎳᎩ ᎧᏬᏂᎯᏍᏗ	Чероки (язык)
ᎠᎹᏍᎧᎦᎯ	Водопад
ᏣᏱ ᎤᏬᏗᎨ	Бронза
ᏩᎭᎧ	Оахака (штат)
ᎪᏢᏅ	Сливочное масло
ᏗᎧᏃᎩᏛ ᎬᏔᏂᏓᏍᏗ	Музыкальные инструменты
ᏌᏌ	Лебеди
ᏅᏃᎯ	Дорога
ᏝᏪᏆ	Обыкновенный бегемот
ᎾᏳ	Песок
ᎫᏔᏍᏲᏍᏗ	Шиповник
ᏢᏓᏥ ᎤᏅᏣᏗ	Леопард
ᎠᏂᎪᎢ ᎤᏂᏃᎮᎸᎯ	Древнегреческая мифология
ᎠᎺᎵᎨ ᎤᏂᎬᏫᏳᎯ	Список президентов США
ᏓᏎᏘ	Зеркало
ᏢᏓᏥ	Пума
ᎠᏩᎶᏓᎢᏘ	Афродита
ᎤᏍᏔᎦᎳᏱ	Пещера
ᎠᎺᎵᎨ ᏢᏓᏥ ᎤᏅᏣᏗ	Ягуар
ᎪᏩᎳ ᏲᎾ	Коала
ᎤᎶᎩᎸ ᏢᏓᏥ	Дымчатый леопард
ᎠᏍᎩᏘᏍᏗ	Сновидение
ᏥᏍᏕᏥ	Крысы
ᎠᏂᏃᎯᎵᏙᎲ	Охота
ᎠᏉᎳ	Аполлон
ᎬᎩᏍᏗ	Арбуз обыкновенный
ᎤᎬᏫᏳᎯ ᎡᏆ	Император
ᎪᎱᏍᏗ ᎬᏔᏂᏓᏍᏗ	Инструмент
ᏣᏱ	Латунь
ᎤᎨᏓᎵᏴ	Долина
ᎠᏓᏢᎢᎯ	Осьминоги
ᏗᏑᏫᏍᎩ ᎡᏆ	Морж
ᎭᎹᏏ	Гермес
ᏧᎾᏓᏱᎵᏓᏍᏗ	Суд
ᏚᏯ	Фасоль обыкновенная
ᎠᏂᏨᎹᏂ	Англичане
ᎠᎵᏍᏕᎸᏙᏗ ᎠᏕᎸ ᎬᏗ	Финансы
ᎪᎦ	Вороны
ᏩᎴᎳ	Колибри
ᎬᎾ	Индейки
ᎠᏂᏳᎧᏪᏂ	Украинцы
ᎤᎦᏔ	Лён обыкновенный
The Doors	The Doors
ᎠᏂᏣᏍᎩᎵ	Привидение
ᎠᏂᏔᎢᏖᏂ	Титаны
ᏑᏏ	Суши
ᏐᏃᎳ	Сонора
ᎤᏪᏴᎢ	Ручей
ᏙᏯ	Бобры
ᏫᎾᏏ	Венера (мифология)
ᎤᏯᏍᎦᎳ	Броненосцевые
Template:Commonscat	Шаблон:Commonscat
ᏧᎴᎯᏌᏅᎯ	Феникс
ᎠᏂᏲᎾ	Русские
ᎠᏂᎢᏔᎵ	Итальянцы
Dire Straits	Dire Straits
ᏓᎬᎾ ᏥᏳ ᏗᏔᎳᏗᏍᏗ ᏚᎦᏘᎸᏒᎢ	Нападение на Пёрл-Харбор
Template:Taxobox	Шаблон:Taxobox
ᏩᎶᏏ	Бесхвостые
ᏧᎵᏍᏓᎾᎵ	Сомообразные
ᏳᎧᏔᏂ	Юкатан (штат)
ᎭᏩᏱ ᏗᎧᏃᎩᏍᏗ	Укулеле
ᎬᎪᏩᏛᏗ ᏗᎧᏃᏗ	Видимое излучение
Morse ᎠᏍᏓᏩᏛᏍᏙᏗ	Азбука Морзе
ᏳᏪᏅᏍ (ᎤᏁᎳᏅᎯ)	Уран (мифология)
ᏩᏓᏚᎦ	Разнокрылые
ᎠᎳ ᏊᎦᏦᏩ	Пугачёва, Алла Борисовна
ᎦᏃᎸᏍᎩ ᎠᎦᏍᎩ	Буря
ᎦᏩᏒᎩ	Дыня
ᏍᎪᏯ ᎠᏁᏍᎩᎸᎥᏍᎩ	Гусеница
ᎠᏂᏍᏆᏂ (ᎧᏃᎮᎭ)	Мехико (штат)
ᏝᏍᎧᎳ	Тласкала (штат)
ᏓᏫᏍᎦᎳ	Кремень
ᏓᏬᎵ	Гриб
ᏐᏈᎵ-ᎠᏍᎦᏯ	Кентавры
ᏗᎳ	Скунсовые
ᎠᏂᎬᎾ	Турки
Carl Menger	Менгер, Карл
Template:Cite book	Шаблон:Cite book
ᎦᏯ	Гея
ᎡᎳᏗᏝ ᎬᎾ ᎤᏔᎾ	Эму
ᎠᎹᏳᎸᏗ	Побережье
ᎤᎭᎸᏂ	Колокол
ᏣᎳᎩ	Чероки
ᎠᏂᎾᏩᎰ	Навахо (народ)
Uriah Heep	Uriah Heep
ᎠᏂᎦᎸᏥ	Французы
ᏗᏂᏃᎨᏂ	Винтовка
ᎠᏂᏍᏫᏍ	Швейцарцы
ᏧᏃ (ᎤᏁᎳᏅᎯ)	Юнона
ᏌᏆᏯ	Сапфир
ᎠᏍᏆᏂᎪᏒᏗ ᏂᎦᎵᏍᏔᏂᏙᎲ	Фейерверк
Panthera	Пантеры
ᎠᏥᎾ	Кедр
ᏢᏕᎦ	Угреобразные
ᏋᏏᎥᏍ	Персей
ᏓᎾᎵᏍᏓᏴᎲᏍᎬ	Фестиваль
ᏓᏰᏂ	Диана (богиня)
ᎠᏂᎲᏂᎦᎵ	Венгры
ᎬᏙ ᎾᏍᏅᏏ	One Direction
ᏃᏥᏳᏍᏗ ᏒᎦᏔ	Ананас
ᎤᎬᏫᏳᎯ ᎡᏆ ᏇᏠ II	Педру II (император Бразилии)
ᎾᏍᎦᏅᎾ	Добродетель
Inachis io	Павлиний глаз
ᎠᏂᏍᏆᏂ	Испанцы
ᏤᏊᎳᏍᎧ	Чебурашка
ᎠᏂᏕᏂ	Датчане
ᎠᏂᏍᏫᏗ	Шведы
ᎢᏯ	Тыква (плод)
ᏭᏕᎵᎬ	Закат
ᏌᎪᏂᎨ ᏣᎴᎩ	Голубой хребет
ᎤᏁᎫᎯᏍᏗ	Майонез
ᏓᏆ	Усатые киты
ᎠᏂᏤᎩ	Чехи
ᎠᏂᏫᏂ	Финны
ᎠᏂᎠᏲᎵᏍ	Ирландцы
ᎠᏂᏍᎶᏩᎩ	Словаки
ᎢᎣᎷ	Эол
ᎤᏜᏩᏓ	Исполинские кенгуру
ᎾᎥ ᏄᎾᏓᎸ	Сообщество
ᎠᏂᏉᏧᎦᎵ	Португальцы
ᏪᏍᏔ (ᎤᏁᎳᏅᎯ)	Веста
ᎠᏂᏍᎧᏥ	Шотландцы
ᎠᎺᏉ ᎠᎨᏴ	Морская дева
ᎠᎢᎵᏏ	Ирида
Rita Levi-Montalcini	Леви-Монтальчини, Рита
ᏧᎳ	Лисицы
ᎠᏂᏪᎵᏏ	Валлийцы
ᎠᏂᏃᏫᏥᏂ	Норвежцы
ᎠᏂᎤᏁᏍᏓᎳ	Исландцы
ᎹᏔ ᏩᏒᏓᎾ	Вашингтон, Марта
ᎡᏆ ᎠᎺᎵᎨ ᎬᎾ ᎤᏔᎾ	Обыкновенный нанду
ᎠᏂᏛᏥ	Голландцы
Tigranes the Great	Тигран II
ᎭᏯᏏᏂ	Гиакинф (из Амикл)
ᏎᏗ	Грецкий орех (плод)
ᎶᏃᎶᏃ	Ронго-ронго
ᎤᏁᎳᏅᎢᎤᏪᏥ	О, благодать
ᎤᏯᏍᎦ	Раковина
ᎠᎺᏉᎯ ᎤᏁᏍᏓᎳ	Морской лёд
Ayyavazhi	Айявари
ᎠᏅᎬᏂ	Анггун
ᎤᎵᎾᏫ	Черепахи
ᏓᎦᎦ	Слепни
ᎢᏃᎵ	Американский барсук
ᎠᏂᏓᏪᎯ	Ангел
ᎠᏂᎡᏍᏙᏂᎠᏂ	Австрийцы
ᎪᎷᏩᏛᎲ ᎢᎬᏁᏗ	Патент
Neofelis	Дымчатые леопарды
ᏍᏏᏉᏯ	Секвойя (Джордж Гесс)
ᏗᎭᏄᎧᎯ	Санта-Клаус
Anthocharis cardamines	Зорька (бабочка)
Delias eucharis	Delias eucharis
ᎠᏓᏍᏕᎸᏗ	Любовь (христианская добродетель)
ᏴᏩᏁᎬ ᏥᏉᏉ	Странствующий дрозд
ᏔᏘᏯᎾ ᏊᎳᏃᏩ	Буланова, Татьяна Ивановна
ᎤᎾᎩᎾ	Каштан американский
ᎠᏂᏇᎳᎷᏍ	Белорусы
ᎠᏂᎶᎺᏂᎠᏂ	Румыны
ᏈᎵᎩ ᎩᎵᎪᎶᏫ	Киркоров, Филипп Бедросович
ᎠᏂᎪᎢ	Греки
ᏧᏴᏢ ᏗᎧᎸ ᏃᏈᏏ	Поляриссима
ᎬᎮ	Рыси
ᏕᎦᏃᏣᎸ	Телеграф
ᎨᏥᎧᎲᏓ ᎠᏁᎬᎢ	Дорога слёз
ᏎᎷ ᎤᏂᏥ ᎠᏯᏟᏗ	Иовлевы слёзы
Struthioniformes	Страусообразные
ᎬᎿᎨ ᏎᏗ	Орех чёрный
ᎠᏂᏆᏏᎵ	Бразильцы
ᎠᏂᎢᏤᎢᏳᏍᏗ	Гренландские эскимосы
ᎧᏁᏨᎢ	Избирательный бюллетень
ᏥᏍᏛᎾ	Astacidea
ᎢᏤ ᎢᏳᏍᏗᎤ ᏪᏴ	Грин-Ривер (приток Колорадо)
ᏩᎦᏧᎧᏅᏍᏕᎾ ᎤᏂᎾᏗᏅᏗ	Тренд
ᏣᎳᎩ ᏧᎴᎯᏌᏅᎯ	Cherokee Phoenix
ᎠᏫᏒᏅ	Сад
ᎠᏂᎺᏏᎪ	Мексиканцы
ᎡᎩᏁᏍ ᎹᏂᎧ	Агнес Моника
Category:ᎠᎹᏰᏟ	Категория:США
Category:ᎨᎾᏓ	Категория:Канада
Category:ᏥᏍᏆ	Категория:Птицы
Category:Plantae	Категория:Растения
Category:ᎧᏃᎮᏍᎩ	Категория:История
Category:ᎤᎾᏙᏢᎯ	Категория:Общество
Category:ᏗᏛᎪᏔᏅ	Категория:Связь
Category:ᎡᎶᎯ	Категория:Земля
ᏦᎢ ᎠᎾᏓᎸᎢ	Три сестры (сельское хозяйство)
ᎤᏐᎪᏍᏓᎩᎦᎨ ᎣᎭᎳ	Скарлетт О’Хара
Dryas iulia	Dryas iulia
ᏬᎭᎵ	Орлиные
ᎧᎹᎹ ᎤᏔᎾ	Слоновые
ᎠᎳᏍᏚᎶ	Тюрбан
ᏎᎼᏂ	Лососёвые (подсемейство)
ᏧᎾᎦ	Кумжа
Category:Stub	Категория:Незавершённые статьи
Category:ᎡᏆ ᎦᏙᎯ	Категория:Континенты
ᎩᏔᏯ	Вишня
ᏧᏂᎵᎦᎳ	Великан
ᎫᎴ	Жёлудь
Template:Wikipedialang	Шаблон:Wikipedialang
Category:ᎠᏰᎵ ᏚᎾᏙᏢᏩᏗᏒ	Категория:Страны
Category:ᎠᎾᎵᏏᎾᎯᏍᏗᏍᎩ	Категория:Экономика
Wikipedia:Administrators	Википедия:Администраторы
Category:ᎠᏂᏴᏫ	Категория:Люди
Category:ᎤᏁᎳᏅ ᎤᏬᏢᏅ	Категория:Природа
Category:ᎠᏕᎸ	Категория:Деньги
Template:Bot	Шаблон:Bot
Wikipedia:What Wikipedia is not	Википедия:Чем не является Википедия
ᎨᎾᏓ	Канада
Category:ᏳᎳᏛ	Категория:Европа
Current events	Портал:Текущие события
Template:Documentation	Шаблон:Doc
Wikipedia:NLT/ENGLISH	Википедия:Не угрожайте судебными исками
Wikipedia:Neutral point of view	Википедия:Нейтральная точка зрения
Wikipedia:Vandalism	Википедия:Вандализм
Sung Jae-gi	Сон Джэги
ᏗᎦᎸᏫᏍᏓᏁᏗ	Предпринимательство
Template:Softredirect	Шаблон:Soft redirect
Template:Delete	Шаблон:К быстрому удалению
ᏆᏟᎩ	Патрик
Category:ᎦᏬᏂᎯᏍᏗ	Категория:Языки
Category:ᏫᎩᏇᏗᏯ	Категория:Википедия
Wikipedia:TROLL	Википедия:Викитроллинг
Template:Navbox	Шаблон:Navbox
Template:Nutshell	Шаблон:Вкратце
Template:Clear	Шаблон:Clear
Template:Col-break	Шаблон:Столбец
Template:Col-begin	Шаблон:Столбцы
Template:Col-end	Шаблон:Столбцы/конец
Template:Bots	Шаблон:Bots
Template:Anchor	Шаблон:Якорь
Category:ᎬᎿᎦᏍᏛ	Категория:Африка
Category:ᏗᎪᏪᎵ	Категория:Книги
Template:Babel	Шаблон:Babel
Template:Commons	Шаблон:Commons
Template:Reflist	Шаблон:Примечания
Wikipedia:Searching	Википедия:Поиск
Template:Stub	Шаблон:Заготовка
Template:User af-1	Шаблон:User af-1
Template:User eo-1	Шаблон:User eo-1
Template:User da	Шаблон:User da
Template:User da-1	Шаблон:User da-1
Template:User eo-3	Шаблон:User eo-3
Template:User de	Шаблон:User de
Template:User de-1	Шаблон:User de-1
Template:User et-1	Шаблон:User et-1
Template:User el	Шаблон:User el
Template:User es	Шаблон:User es
Template:User en-3	Шаблон:User en-3
Template:User en-1	Шаблон:User en-1
Template:User en-2	Шаблон:User en-2
Template:User eo-2	Шаблон:User eo-2
Template:User en-4	Шаблон:User en-4
Template:User en	Шаблон:User en
Template:User de-2	Шаблон:User de-2
Template:User fr-1	Шаблон:User fr-1
Category:ᏗᏓᏅᏖᏗ	Категория:Концепции
Category:ᎥᎴᏂᏙᎲ	Категория:Жизнь
Template:User ia-2	Шаблон:User ia-2
Template:User io-3	Шаблон:User io-3
Template:User ja-4	Шаблон:User ja-4
Template:User sk	Шаблон:User sk
Template:User fr-2	Шаблон:User fr-2
Template:User ja	Шаблон:User ja
Template:User ja-1	Шаблон:User ja-1
Template:User fr	Шаблон:User fr
Category:ᏨᏍᎪᏱ	Категория:Насекомые
Category:ᏓᎶᏂᎦᏍᏛ	Категория:Азия
Category:ᏧᎦᎾᏮ ᎠᎹᏰᎵ	Категория:Южная Америка
Category:User uk-N	Категория:User uk-N
Template:Esoteric	Шаблон:Эзотерика
Template:Mod	Шаблон:Mod
Template:User sv	Шаблон:User sv
Template:User uk	Шаблон:User uk
Template:User es-2	Шаблон:User es-2
Template:Tsilugi	Шаблон:Приветствие
Template:Wikipediasister	Шаблон:Сообщество Википедии
Category:User fr-1	Категория:User fr-1
Template:Wikiquote	Шаблон:Викицитатник
Template:Image label	Шаблон:Метка изображения
Template:Cite journal	Шаблон:Cite journal
Category:User en-4	Категория:User en-4
Category:User en	Категория:User en
Template:Ombox	Шаблон:Ombox
Category:ᎠᎵᏍᏓᏴᏗ ᎠᎴ ᎠᏗᏔᏍᏗ	Категория:Еда и напитки
Template:Pp-template	MediaWiki:Protectedpagetext
Template:Wiktionary	Шаблон:Викисловарь
Template:Multi-listen start	Шаблон:Multi-listen start
Category:ᏗᎦᎶᎪᏗ	Категория:Сельское хозяйство
Template:Babel-4	Шаблон:Babel-4
Category:ᎠᏂᎪᎢ ᎤᎾᏁᎳᏅᎯ	Категория:Древнегреческие боги
Template:Ethnic group	Шаблон:Народ
Template:Namespace detect	Шаблон:Namespace detect
Template:User nl	Шаблон:User nl
Template:User no-2	Шаблон:User no-2
Template:Image label end	Шаблон:Image label end
Template:Documentation subpage	Шаблон:Docpage
Template:Userpage	Шаблон:Userpage
Template:Image label small	Шаблон:Image label small
Template:Infobox Continent	Шаблон:Материк
Category:User ja-N	Категория:User ja-N
Template:Verify source	Шаблон:Уточнить
Template:Hang on	Шаблон:Hangon
Category:User sk	Категория:User sk
Category:User eo	Категория:User eo
Category:User fr	Категория:User fr
Category:User gl	Категория:User gl
Category:User ja	Категория:User ja
Category:User sv	Категория:User sv
Category:User fr-N	Категория:User fr-N
Category:User gl-N	Категория:User gl-N
Category:User sk-N	Категория:User sk-N
Category:User de	Категория:User de
Category:User de-2	Категория:User de-2
Category:User en-3	Категория:User en-3
Category:User en-N	Категория:User en-N
Category:User es	Категория:User es
Category:User es-2	Категория:User es-2
Category:User es-N	Категория:User es-N
Template:Adminbox	Участник:Box/Администратор
Category:ᎠᎪᏩᏏᏗ	Категория:Зрение
Template:User gl	Шаблон:User gl
ᏫᎩᏇᏗᏯ:Babel	Википедия:Вавилон
Template:User sv-1	Шаблон:User sv-1
Category:ᎠᏂᎪᎢ ᎤᎾᏁᎳᏅᎯ ᎠᏂᎨᏴ	Категория:Древнегреческие богини
Category:ᎠᎹ	Категория:Вода
Template:User ko-3	Шаблон:User ko-3
Category:User sv-N	Категория:User sv-N
Category:User wa	Категория:User wa
Category:User wa-N	Категория:User wa-N
Category:ᏚᏓᏡᎬ	Категория:Статьи
Template:User tr-1	Шаблон:User tr-1
Template:User zh-2	Шаблон:User zh-2
Template:Multi-listen end	Шаблон:Multi-listen end
Category:ᎠᎾᎵᏖᎸᎲᏍᎬ ᎦᏁᏰᎩ	Категория:Насилие
Category:ᏧᏓᎴᏅᏓ ᎫᎵᏍᏔᏅ ᏑᏓᎴᎩ	Категория:Химические элементы
Template:User de-4	Шаблон:User de-4
Category:ᎠᏣᏗ	Категория:Рыбы
Category:ᎤᎾᏓᏔᏅ ᎠᎩᏍᏗ	Категория:Фрукты
Category:ᏙᏯᏗᎳ ᏄᏍᏗᏓᏅ	Категория:Климат
Category:Animalia	Категория:Животные
Category:ᎠᏂᎪᎢ ᎤᏂᏃᎮᎸᎯ	Категория:Древнегреческая мифология
Category:ᎠᏂᎩᏍᏙᏗ	Категория:Транспорт
Category:ᏧᏴᏢ ᎠᎹᏰᎵ	Категория:Северная Америка
Template:Uw-test2	Шаблон:Uw-test2
Template:User fo	Шаблон:User fo
Category:ᎠᏥᎳ	Категория:Огонь
Category:ᎠᎵᎮᎵᏍᏗ ᎢᎦ	Категория:День благодарения
Category:ᏗᎧᏃᏗ	Категория:Цвет
Template:Image label begin	Шаблон:Image label begin
Category:User en-1	Категория:User en-1
Category:User de-1	Категория:User de-1
Template:Wstress3d	Шаблон:Wstress3d
Wikipedia:VOTE	Википедия:Голосования — не замена обсуждениям
Wikipedia:STALK	Википедия:Не преследуйте участников
ᎧᎹᎹ (ᏨᏍᎪᏱ)	Булавоусые чешуекрылые
Special:RecentChanges	Служебная:Свежие правки
Module:HtmlBuilder	Модуль:HtmlBuilder
