非洲	Африка
日本	Япония
南美洲	Южная Америка
Nò-vî	Норвегия
Sû-kak-làn	Шотландия
Vî-ngì-sṳ̂	Уэльс
Pet Oi-ngì-làn	Северная Ирландия
Hiûng-ngà-li	Венгрия
Sî-pân-ngà	Испания
Mî-koet	Соединённые Штаты Америки
Pí-li-sṳ̀	Бельгия
Lù-sêm-pó	Люксембург
Yî-chhiu	Вселенная
Thi-khiù	Земля
Sâng-miang	Жизнь
Ngìn-lui	Человек разумный
George Washington	Вашингтон, Джордж
Fûn-làn	Финляндия
Shuì-tién	Швеция
Tan-ma̍k	Дания
Pô-làn	Польша
Li̍p-thâu-vón	Литва
Yi-thai-li	Италия
Shuì-sṳ	Швейцария
O-thi-li	Австрия
Hî-lia̍p	Греция
Thú-ngí-khì	Турция
Phù-thò-ngà	Португалия
歐洲	Европа
亞洲	Азия
北美洲	Северная Америка
南極洲	Антарктида
Vì-kî Pak-khô	Википедия
Hò-làn	Нидерланды
Néu-yok-sṳ	Нью-Йорк
Fà-sṳ̀n-tun Kô-lùn-pí-â Thi̍t-khî	Вашингтон (округ Колумбия)
Khiu-kîm-sân	Сан-Франциско
Pak-lìm	Берлин
Lo̍k-chhám-kî	Лос-Анджелес
Thien-nó	Компьютер
Mióng-chi-mióng-lu	Интернет
Barack Obama	Обама, Барак
Vû-lâ-kûi	Уругвай
Lùn-tûn	Лондон
Phìn-kó	Яблоко
Pâ-lì-sṳ	Париж
Â-pak-lâ-hón Lìm-khén	Линкольн, Авраам
Google	Google (компания)
Me̍t-sî-kô	Мексика
Thai-sî-yòng	Атлантический океан
Thai-phìn-yòng	Тихий океан
Kâ-li-fuk-nì-â	Калифорния
Pô-sṳ-tun	Бостон
Fó-sên	Марс
Âi-set-ngò-pí-â	Эфиопия
Sṳ̂-é	Лев
Fap-koet	Франция
Sṳ-kie-ngî	Эсперанто
Kiéu-è	Собака
Yîn-koet	Великобритания
Meu-é	Кошка
中華人民共和國	Китайская Народная Республика
Fap-ngî	Французский язык
Ǹg-è	Рыбы
Pâ-sî	Бразилия
François Hollande	Олланд, Франсуа
Ngò-lò-sṳ̂	Россия
Kîn-ǹg	Китообразные
Chang-fông-hìn	Квадрат
Mong-kó	Манго (фрукт)
Tô-lùn-tô	Торонто
Â-lâ-pâ-mâ	Алабама
Québec-sén	Квебек
Boeing 747	Boeing 747
Jimmy Wales	Уэйлс, Джимми
Tet-koet	Германия
Pha̍k-ngò-lò-sṳ̂	Белоруссия
Tet-ngî	Немецкий язык
Pên-tó	Исландия
Song-ti	Бог
Oi-sâ-nì-â	Эстония
David Cameron	Кэмерон, Дэвид
Thú-sên	Сатурн
Ku-thin-yi̍t Fî-kî	Самолёт
1	1 (число)
2	2 (число)
3	3 (число)
4	4 (число)
5	5 (число)
George W. Bush	Буш, Джордж Уокер
Lâ-thot-vì-â	Латвия
Vû-khiet-làn	Украина
Tshia̍p-khiet	Чехия
Sṳ̂-lo̍k-vì-nì-â	Словения
Lò-mâ-nì-â	Румыния
Pó-kâ-li-â	Болгария
Lò-mâ	Рим
Mâ-khì-tun	Республика Македония
Â-ngì-pâ-nì-â	Албания
Khiet-lò-âi-sî-â	Хорватия
Pô-sṳ-nì-â lâu Het-set-kô-vì-ná	Босния и Герцеговина
Â-set-pai-kiông	Азербайджан
Set-phû-lu-sṳ̂	Республика Кипр
Kak-lû-kit-â	Грузия
Hâ-sat-khiet-sṳ̂-thán	Казахстан
Mí-li-thai	Мальта
Mô-na̍p-kô	Монако
Mùng-thi̍t-nui-kô-lò	Черногория
Sṳn Mâ-li-nok	Сан-Марино
Kú-pâ	Куба
Eiffel Thiet-thap	Эйфелева башня
Yin-thu-nì-sî-â	Индонезия
Wolfgang Amadeus Mozart	Моцарт, Вольфганг Амадей
Pi-tô-fûn	Бетховен, Людвиг ван
Thú-ngí-khì-ngî	Турецкий язык
Nàm-fî	Южно-Африканская Республика
Vû-tsṳ̂-phe̍t-khiet-sṳ̂-thán	Узбекистан
Pô-tsṳ-nàm	Познань
Fà-sâ	Варшава
Súi	Вода
Thien-sṳ	Телевидение
Chṳ-li	Чили
Yâ-sû	Иисус Христос
Súi-sên	Меркурий
Li̍t-sṳ́	История
Phìn-kó Kûng-sṳ̂	Apple
Kîm-sên	Венера
Ngî-ngièn	Язык
Muk-sên	Юпитер
Thiên-vòng-sên	Уран (планета)
Pu-lie̍t-thap-nì	Бретань (историческая область)
Hói-vòng-sên	Нептун
Thiên-vùn-ho̍k	Астрономия
Sîn-kâ-po	Сингапур
Khô-ho̍k	Наука
Montréal	Монреаль
Lie̍t-kî-tûn-sṳ-tên	Лихтенштейн
Kiam-khiâu	Кембридж
Thi-ngi-chhṳ Sṳ-kie Thai-chan	Вторая мировая война
Cologne	Кёльн
Kak-tên-nì-â	Гдыня
Sṳ̍p-chhiet-chhiâng	Щецин
Sṳ-ho̍k	Математика
Lâ-tên-ngî	Латинский язык
Pâ-lìm	Бахрейн
Â-mî-nì-â	Армения
Set-ngì-vì-â	Сербия
Ngie̍t-khiù	Луна
Àu-thai-li-â	Австралия
Vu̍t-lî-ho̍k	Физика
Â-kîn-thìn	Аргентина
Pi-lû	Перу
Sâng-vu̍t-ho̍k	Биология
Tsêu-siên Mìn-tsú Tsú-ngi Ngìn-mìn Khiung-fò-koet	Корейская Народно-Демократическая Республика
Kán-pu-chhài	Камбоджа
Khiúng-liùng	Динозавры
Yî-sṳ̂-làn-kau	Ислам
Lech Wałęsa	Валенса, Лех
Lin-é	Колесо
Lyon	Лион
Êu-chû Lièn-mèn	Европейский союз
Rhône-Alpes	Рона — Альпы
Chhiòn-khiù Chṳ̂-sín Mióng	Всемирная паутина
Ńg-ngìn	Женщина
Khiûng-tsiâu	Банан
Fâ	Цветок
Mâ-lî-â-na̍p-hói	Марианский жёлоб
Chû-mu̍k-lòng-mâ-fûng	Джомолунгма
Sàng-sṳ	Город
Nâ-pho-lùn yit-sṳ	Наполеон I
Ngit-tèu	Солнце
Pâ-sṳ-tet	Пастер, Луи
大洋洲	Океания
Thai-yòng Hì	Солнечная система
Pô-lò-tit-hói	Балтийское море
Ngâ-chhṳ	Зуб (биология)
Khîn	Водород
Hoi (氦)	Гелий
Angela Merkel	Меркель, Ангела
Lî	Литий
Phì	Бериллий
Si	Книга
Ngit	Сутки
Ngièn	Год
Sṳ-ki	Век
Lò-tsṳ (Pô-làn)	Лодзь
Khà-thok-vì-chṳ	Катовице
Ngie̍t-sû-fû	Жешув
Phìn	Бор (элемент)
Thàn	Углерод
Tham	Азот
Yòng	Кислород
Hàng-sên	Планета
Yîm-ngo̍k	Музыка
Rennes	Ренн
Mo̍k-sṳ̂-khô	Москва
Fuk	Фтор
Yi-thai-li-ngî	Итальянский язык
Nái	Неон
Sṳn Pí-tet-páu	Санкт-Петербург
Na̍p	Натрий
北	Север
Mî	Магний
Lî (鋁)	Алюминий
Néu Sî-làn	Новая Зеландия
南	Юг
Yin-thu	Индия
Si̍t	Кремний
Fap	Франций
Lìn	Фосфор
Thiet	Железо
Tûng-kâ	Тонга
西	Запад
Liù-vòng	Сера
東	Восток
Liu̍k	Хлор
Pâ-pu-â Néu-kí-nui-â	Папуа — Новая Гвинея
Vî-lièn Sâ-sṳ-pí-â	Шекспир, Уильям
Â (氬)	Аргон
Kap	Калий
Koi	Кальций
Yèn	Свинец
Mùng-kú-koet	Монголия
Khong (鈧)	Скандий
Thai	Титан (элемент)
Genghis Khan	Чингисхан
Fàm	Ванадий
Mien-yîn	Мэн (штат)
Kok	Хром
Mâ	Домашняя лошадь
Thûng-vu̍t	Животные
Sû-li-nàm	Суринам
Màng	Марганец
Pâ-lâ-kûi	Парагвай
Koi-â-nâ	Гайана
Ngi-su̍t	Искусство
Lòi	Рений
Kô-lùn-pí-â	Колумбия
Kû	Кобальт
Vû	Вольфрам
Ngiap (鎳)	Никель
Fu̍t-kau	Буддизм
Pô-li-vì-â	Боливия
Tshṳ̀-nì-tha̍t lâu Tô-pâ-kô	Тринидад и Тобаго
Chhṳ̍t-vu̍t	Растения
Sîn	Цинк
Néu Hàn-pu-ha	Нью-Гэмпшир
Pí-â-vùi-sṳ̂-thok-khiet	Белосток
Ngà-mâi-kâ	Ямайка
Mà-sat-chû-set	Массачусетс
Drenthe-sén	Дренте
Overijssel-sén	Оверэйссел
Kûa-thi-mâ-là	Гватемала
Gelderland-sén	Гелдерланд
Pâ-hâ-mâ	Багамские Острова
Không-nái-tí-khiet-chû	Коннектикут
Kiê-é	Курица
Ha-vî-yî	Гавайи
Fùng-tû-lâ-sṳ̂	Гондурас
Tô-mí-nì-kâ	Доминика
Tô-mí-nì-kâ Khiung-fò-koet	Доминиканская Республика
Kâ-chû (Thung-vu̍t)	Домашняя свинья
Hói-thi	Республика Гаити
Sat-ngì-ngá-tô	Сальвадор
Yî-lóng	Иран
Yî-là-khiet	Ирак
Â-lâ-sṳ̂-kâ	Аляска
Kô-sṳ̂-tha̍t Lì-kâ	Коста-Рика
Yî-set-lie̍t	Израиль
Pâ-nâ-mâ	Панама
Ya̍p-mùn	Йемен
Phiang-thu̍k	Вирусы
Pô-làn-ngî	Польский язык
Yok-tan	Иордания
Nì-kâ-lâ-kûa	Никарагуа
Fu-lò-lî-tha̍t	Флорида
Kit-ngí-kit-sṳ̂-thán	Киргизия
Â-li-sông-ná	Аризона
Khô-vî-thi̍t	Кувейт
Liàu-koet	Лаос
Lì-pâ-nun	Ливан
O-le̍t-kông	Орегон
Mâ-ngì-thoi-fû	Мальдивы
Yù-thâ	Юта
Mâ-lòi-sî-â	Малайзия
Mién-thien	Мьянма
Nì-pok	Непал
Â-man	Оман
Pâ-kî-sṳ̂-thán	Пакистан
Khà-tha̍t	Катар
Mióng-khiù	Теннис
Sâ-vû-thi Â-lâ-pak	Саудовская Аравия
Sṳ̂-lî-làn-khà	Шри-Ланка
Si-li-â	Сирия
Kâ	Галлий
Thap-kit-khiet-sṳ̂-thán	Таджикистан
中華民國	Китайская Республика
YouTube	YouTube
Châ	Германий
Thai-koet	Таиланд
Sṳ̂n	Мышьяк
Thú-khû-man-sṳ̂-thán	Туркмения
Abakan	Абакан
Sî	Селен
Yî	Иридий
Â-lâ-pak Lièn-ha̍p Thai-kûng-koet	Объединённые Арабские Эмираты
Tshiù (溴)	Бром
Pha̍k (鉑)	Платина
Ye̍t-nàm	Вьетнам
Thai-hòn Mìn-koet	Республика Корея
Khiet	Криптон
Â-fu-hon	Афганистан
J. R. R. Tolkien	Толкин, Джон Рональд Руэл
Lù	Рубидий
Kîm	Золото
Men-kâ-lâ-koet	Бангладеш
Ufa	Уфа
Ôn-kô-lâ	Ангола
Vùn-lòi	Бруней
Kúng	Ртуть
Fî-li̍t-pîn	Филиппины
Thò	Таллий
Ngie-sat-khiet Ngiù-tun	Ньютон, Исаак
Albert Einstein	Эйнштейн, Альберт
Sṳ̂	Стронций
Yet	Иттрий
Pit	Висмут
Vòng-set	Жёлтый цвет
Tsan-pí-â	Замбия
Sîn-pâ-pu-vî	Зимбабве
北京	Пекин
Tuva Khiung-fò-koet	Тыва
Pok-tshṳ-ngá-na̍p	Ботсвана
Pho (釙)	Полоний
Bayern	Бавария
Baden-Württemberg	Баден-Вюртемберг
Ngo (砈)	Астат
Lòi-sò-thok	Лесото
Mâ-tha̍t-kâ-sṳ̂-kâ	Мадагаскар
Mâ-là-vî	Малави
Stuttgart	Штутгарт
Màu-li-thap-nì-â	Мавритания
Pô-làn-ngìn	Поляки
Mo̍k-sông-pí-khiet	Мозамбик
Na̍p-mí-pí-â	Намибия
Nai-khi̍p-li-â	Нигерия
Ko	Цирконий
Nì	Ниобий
Yû-li-vû-sṳ̂ Khái-sat	Гай Юлий Цезарь
Sṳ̂-vî-sṳ-làn	Свазиленд
Muk	Молибден
Thap	Технеций
Hamburg	Гамбург
Thoi-chhia	Обмен веществ
Miên-yi̍t Hì-thúng	Иммунная система
Lièn-ha̍p-koet	Организация Объединённых Наций
Sîm-chhong	Сердце
Thèu-nó	Головной мозг
Phì-fû	Кожа
Ló	Родий
Làm-set	Синий цвет
Pâ	Палладий
Ngiùn	Серебро
Kak	Кадмий
Yîn	Индий
Siak	Олово
Yu	Уран (элемент)
Thi (銻)	Сурьма
Ti	Теллур
Pu	Плутоний
Tièn	Иод
Nai	Нептуний
Set	Цезий
Phù	Протактиний
Pi	Барий
Thú	Торий
Kap (鉿)	Гафний
Than (鉭)	Тантал (элемент)
Luì	Радий
Tûng	Радон
Alsace	Эльзас
Auvergne	Овернь
Ôn-tet-là-pâng	Андхра-Прадеш
Me̍t-hiet-kîn	Мичиган
Burgundy	Бургундия
Aquitaine	Аквитания (регион)
Schleswig-Holstein	Шлезвиг-Гольштейн
Hâ Saxony	Нижняя Саксония
Pet Rhine-Westphalia	Северный Рейн-Вестфалия
Saxony	Саксония (земля)
Yî-li-nò	Иллинойс
Thuringia	Тюрингия
Saxony-Anhalt	Саксония-Анхальт
Pet Tha̍t-khô-thâ	Северная Дакота
Brandenburg	Бранденбург
Bremen-chû	Бремен (земля)
Nàm Tha̍t-khô-thâ	Южная Дакота
Mùng-thai-nâ	Монтана
Fài-ngò-mìn	Вайоминг
Yâ-lu-sat-lâng	Иерусалим
Oi-tha̍t-hòt	Айдахо
Fà-sṳn-tun	Вашингтон (штат)
Lù (鑪)	Резерфордий
Nui-fà-tha̍t	Невада
Hàn (𨧀)	Дубний
Hí (𨭎)	Сиборгий
Yin-thu-yòng	Индийский океан
Khô-sò-vok	Республика Косово
Kâ-le̍t-pí-hói	Карибское море
Pô (𨨏)	Борий
Het (𨭆)	Хассий
Phan Kî-vùn	Пан Ги Мун
Ma̍k (䥑)	Мейтнерий
Khô-lò-là-tô	Колорадо
Tha̍t	Дармштадтий
Siau-pâng	Шопен, Фредерик
Lùn	Рентгений
Kô (鎶)	Коперниций
分類:Chú-yeu fûn-lui	Категория:Всё
Chi-kâ-kô	Чикаго
Arnhem	Арнем
Tûng-kui	Зима
Sî-pân-ngà-ngî	Испанский язык
Fî-là-thiet-fî	Филадельфия
Tî-tû	Пауки
Hèu-è	Обезьяны
Kîm-tshièn	Деньги
Vì-kit-nì-â	Виргиния
Sî Vì-kit-nì-â	Западная Виргиния
Tshiâng-tséu	Перец овощной
Néu-yok-chû	Нью-Йорк (штат)
Sṳ (鈰)	Церий
Phú	Празеодим
Lò-tet-tó	Род-Айленд
Ńg	Неодим
Khûn-chhùng	Насекомые
Mâ-lî-làn	Мэриленд
Thi̍t-lâ-ngá	Делавэр
Yû (銪)	Европий
Ngò-hài-ngò	Огайо
Vì-kit-ngì	Вергилий
Machiavelli	Макиавелли, Никколо
Pîn-sé-fap-nì-â	Пенсильвания
Uetersen	Итерзен
O-kú-sṳ̂-tû	Октавиан Август
Néu Chhe̍t-sî-chû	Нью-Джерси
Fûn-làn-ngî	Финский язык
Yin-thi-ôn-na̍p	Индиана
Vì-sṳ̂-pha-siên	Веспасиан
Thù-là-chṳ̂n	Траян
Hâ-tet-liòng	Адриан
Khièu-tshṳ-â	Джорджия
Mâ-khù-sṳ̂ O-lie̍t-lî-vû-sṳ̂	Марк Аврелий
Zagreb	Загреб
Tet-khiet-sat-sṳ̂	Техас
Thai-mí-ngì-na̍p-tet-pâng	Тамилнад
Pet Khà-lò-lòi-na̍p	Северная Каролина
Nàm Khà-lò-lòi-na̍p	Южная Каролина
Loire-sén	Луара
Pâ-set-lò-nâ	Барселона
Vòng-lî	Ананас крупнохохолковый
Me̍t-sî-sî-pí	Миссисипи (штат)
Thièn-na̍p-sî	Теннесси
Néu Me̍t-sî-kô	Нью-Мексико
Mìn-nì-sû-tha̍t	Миннесота
Vî-sṳ̂-không-sîn	Висконсин
Oi-hò-fà	Айова
Nui-pu-lâ-sṳ̂-kâ	Небраска
Khâm-sat-sṳ̂	Канзас
Yin-thi-ngî	Хинди
Me̍t-sû-lî	Миссури (штат)
Lu-yi-sṳ̂-ôn-ná	Луизиана
Khén-thap-kî	Кентукки
Â-khén-set	Арканзас
Neil Armstrong	Армстронг, Нил
O-khiet-lâ-hò-mâ	Оклахома
Pet-hói	Северное море
Mo̍k-sṳ̂-khô-chû	Московская область
Kiel	Киль (город)
Schwerin	Шверин
Potsdam	Потсдам
Hanover	Ганновер
Düsseldorf	Дюссельдорф
Mainz	Майнц
Wiesbaden	Висбаден
Saarbrücken	Саарбрюккен
Mu-nì-het	Мюнхен
Erfurt	Эрфурт
Dresden	Дрезден
Kaliningrad-chû	Калининградская область
Murmansk-chû	Мурманская область
Kak-than-sṳ̂-khiet	Гданьск
Fap-làn-khiet-fuk	Франкфурт-на-Майне
Fut-lò-tshṳ-ngá-fû	Вроцлав
Làn	Лантан
Ki (鉕)	Прометий
Sân	Самарий
Â-chhè Thi̍t-phe̍t Hàng-chṳn-khî	Ачех (провинция)
Nga̍t (釓)	Гадолиний
Thi̍t (鋱)	Тербий
Tit (鏑)	Диспрозий
Sṳn-kîn	Библия
Fó	Гольмий
Ngí (鉺)	Эрбий
Tiû	Тулий
Yi	Иттербий
Liu	Лютеций
Hò-nui-sṳ	Ханой
Chṳ̂n Yâ-sû Kau-fi	Церковь истинного Иисуса
Yîn-ngî	Английский язык
Màn-kuk	Бангкок
Kit-lùng-po	Куала-Лумпур
Pâng-kâ Vú-lî-thung-sén	Банка-Белитунг
Thòi-pet-sṳ	Тайбэй
Mî (鋂)	Америций
Arkhangelsk-chû	Архангельская область
Khiu̍k	Кюрий
Thùng-hói-sṳ	Донгхой
Concepción	Консепсьон (город, Чили)
Pet (鉳)	Берклий
Khà (鉲)	Калифорний
Mìn-kú-lû-sén	Бенкулу (провинция)
Oi	Эйнштейний
Fi	Фермий
Mùn	Менделевий
Na	Нобелий
Ontario-sén	Онтарио
Lò	Лоуренсий
Karelia Khiung-fò-koet	Республика Карелия
Końskowola	Коньсковоля
2002-ngièn	2002 год
2008-ngièn	2008 год
Charles de Gaulle	Де Голль, Шарль
Cham-pî-sén	Джамби (провинция)
Komi Khiung-fò-koet	Республика Коми
Nâm-póng-sén	Лампунг
Pet Sû-mùn-tap-lia̍p-sén	Северная Суматра
Syktyvkar	Сыктывкар
Québec-sṳ	Квебек (город)
Nenets Chhṳ-chhṳ-khî	Ненецкий автономный округ
Liàu-nui-sén	Риау
Leningrad-chû	Ленинградская область
Pskov-chû	Псковская область
Liàu-nui Khiùn-tó-sén	Острова Риау
Nizhny Novgorod-chû	Нижегородская область
Nàm Sû-mùn-tap-lia̍p-sén	Южная Суматра
Lò-mâ Ti-koet	Римская империя
Mì-ngiôn Kûng-sṳ̂	Microsoft
Tver-chû	Тверская область
Khù-lû-fû	Курув
Fa-ho̍k	Химия
Smolensk-chû	Смоленская область
Yaroslavl-chû	Ярославская область
Kostroma-chû	Костромская область
Ivanovo-chû	Ивановская область
Arnold Schwarzenegger	Шварценеггер, Арнольд
Chiuk-khiù	Футбол
Ryazan-chû	Рязанская область
IPhone	IPhone
Sî Sû-mùn-tap-lia̍p-sén	Западная Суматра
Tula-chû	Тульская область
IPad	IPad
Mâ-tet-lî	Мадрид
Bryansk-chû	Брянская область
Michael Jackson	Джексон, Майкл
Kaluga-chû	Калужская область
Loire-Atlantique-sén	Атлантическая Луара
Ain-sén	Эн (департамент)
Allier-sén	Алье
Khâm-phì-là	Канберра
Sông Alpes-sén	Верхние Альпы
Oryol-chû	Орловская область
Sit-nì	Сидней
Alpes-de-Haute-Provence-sén	Альпы Верхнего Прованса
Liu̍k-set	Зелёный цвет
Alpes-Maritimes-sén	Приморские Альпы (департамент)
Hâ-tet-sùn-hò	Гудзон (река)
Me̍t-ngì-pún	Мельбурн
Fùng-set	Красный цвет
Ardèche-sén	Ардеш
Jena	Йена (город)
Kursk-chû	Курская область
Ariège-sén	Арьеж
Aude-sén	Од (департамент)
Aveyron-sén	Аверон
Sîn Nàm Vî-ngì-sṳ̂-chû	Новый Южный Уэльс
Bouches-du-Rhône-sén	Буш-дю-Рон
Àu-thai-li-â Sú-tû Liâng-thi	Австралийская столичная территория
Cantal-sén	Канталь
Belgorod-chû	Белгородская область
Côte-d'Or-sén	Кот-д’Ор
Côtes-d'Armor-sén	Кот-д’Армор
Drôme-sén	Дром (департамент)
Finistère-sén	Финистер
Voronezh-chû	Воронежская область
Sû-mùn-tap-lia̍p	Суматра
Lipetsk-chû	Липецкая область
Van-tan-sén	Бантен
Chûng Cháu-ôa-sén	Центральная Ява
Fùi-sên	Комета
Rostov-chû	Ростовская область
Tûng Cháu-ôa-sén	Восточная Ява
Ngâ-kâ-tha̍t Sú-tû Thi̍t-khî	Джакарта
Sî Cháu-ôa-sén	Западная Ява
Adygea Khiung-fò-koet	Адыгея
Ngit-ngiâ Thi-fông Thi̍t-khî	Джокьякарта (особый округ)
Gera	Гера (Тюрингия)
Maykop	Майкоп
Cháu-ôa-tó	Ява
Kâ-lî-man-tân-chû	Индонезийский Калимантан
Séu Sùn-thâ Khiùn-tó	Малые Зондские острова
Sû-lâ-vî-sî-tó	Сулавеси
Mô-lu̍k-kâ Khiùn-tó	Молуккские острова
Chûng Kâ-lî-man-tân-sén	Центральный Калимантан
Tûng Kâ-lî-man-tân-sén	Восточный Калимантан
Nàm Kâ-lî-man-tân-sén	Южный Калимантан
Kâ-li-sî-â	Галисия
Sî Kâ-lî-man-tân-sén	Западный Калимантан
Thai-ho̍k	Университет
Pretoria	Претория
Chok-khiù	Настольный теннис
Â-sṳ̂-thù-lî-â-sṳ̂	Астурия
Wikipedia:Sandbox	Википедия:Песочница
Astrakhan-chû	Астраханская область
Kham-thap-pu-lî-â	Кантабрия
Kalmykia Khiung-fò-koet	Калмыкия
Weimar	Веймар
Osasco	Озаску
Â-là-kung	Арагон
Kak-là-sṳ̂-kô	Глазго
Thùng-hói Kî-chhòng	Донгхой (аэропорт)
Vú-lîn-ngièn Fûng-kín Miàng-sṳn-khî	Улинъюань
分類:Thòi-vân li̍t-sṳ́	Категория:История Тайваня
Curitiba	Куритиба
Chloë Grace Moretz	Морец, Хлоя
Khûng-chṳ́	Конфуций
Corbin Bleu	Блю, Корбин
分類:Sṳ-ho̍k	Категория:Математика
分類:Ngìn-kûng ngî-ngièn	Категория:Искусственные языки
Pâ-lî-sén	Бали
Mî-kîm	Доллар США
Thi-chûng-hói	Средиземное море
Hông-chû-sṳ	Ханчжоу
Kî-tuk-kau	Христианство
Tûng Nú-sâ Tên-kâ-là-sén	Восточные Малые Зондские острова
Sî Nú-sâ Tên-kâ-là-sén	Западные Малые Зондские острова
Chûng Sû-lâ-vî-sî-sén	Центральный Сулавеси
Kô-lùn-tá-lo̍k-sén	Горонтало
Pet Sû-lâ-vî-sî-sén	Северный Сулавеси
Tûng-nàm Sû-lâ-vî-sî-sén	Юго-Восточный Сулавеси
Nàm Sû-lâ-vî-sî-sén	Южный Сулавеси
Sî Sû-lâ-vî-sî-sén	Западный Сулавеси
Vò-é	Рис (продукт питания)
Mâ-lû-kú-sén	Малуку
Pet Mâ-lû-kú-sén	Северное Малуку
Pâ-pu-â-sén	Папуа (провинция Индонезии)
Sî Pâ-pu-â-sén	Западное Папуа
Dagestan Khiung-fò-koet	Дагестан
Sú-tû	Столица
Monzón	Монсон
Phù-thò-ngà-ngî	Португальский язык
Ngie̍t	Месяц
Mustafa Kemal Atatürk	Ататюрк, Мустафа Кемаль
Makhachkala	Махачкала
Chechnya Khiung-fò-koet	Чечня
Grozny	Грозный
Almazán	Альмасан
Vòng Hien-fàm	Хуан Сяньфань
Ingushetia Khiung-fò-koet	Ингушетия
Magas	Магас
Pet Ossetia–Alania Khiung-fò-koet	Северная Осетия
Kabardino-Balkaria Khiung-fò-koet	Кабардино-Балкария
Tson-sa̍k	Алмаз
Bill Gates	Гейтс, Билл
Ngi̍t-ngî	Японский язык
Pak-khô-chhiòn-sû	Энциклопедия
頭頁	Заглавная страница
Karachay-Cherkessia Khiung-fò-koet	Карачаево-Черкесия
Saratov	Саратов
Saratov-chû	Саратовская область
Orenburg-chû	Оренбургская область
Mordovia Khiung-fò-koet	Мордовия
Saransk	Саранск
Yâ-khiù	Бейсбол
Làm-khiù	Баскетбол
Kirov-chû	Кировская область
Udmurtia Khiung-fò-koet	Удмуртия
Sî-pak-li-â	Сибирь
Mari El Khiung-fò-koet	Марий Эл
Yoshkar-Ola	Йошкар-Ола
Stellenbosch	Стелленбос
Sverdlovsk-chû	Свердловская область
Cape Town	Кейптаун
Chuvash Khiung-fò-koet	Чувашия
Durban	Дурбан
Cheboksary	Чебоксары
Tat-tat-sṳ̂-thán Khiung-fò-koet	Татарстан
Penza-chû	Пензенская область
Là-fî-ngì	Рафаэль Санти
Pí-tet Lû-pún-sṳ̂	Рубенс, Питер Пауль
Ulyanovsk-chû	Ульяновская область
Gung-gung-hi-tsaa	Автобус
Kâ-thai-lò-nì-â	Каталония
Bashkortostan Khiung-fò-koet	Башкортостан
Chelyabinsk-chû	Челябинская область
Pâ-lùn-sî-â Chhṳ-chhṳ-khî	Валенсия (автономное сообщество)
Khà-sṳ̂-tì-li-â lâu Lòi-ngong	Кастилия-Леон
Kurgan-chû	Курганская область
Mô Chhe̍t-tûng	Мао Цзэдун
Tyumen-chû	Тюменская область
Omsk-chû	Омская область
Thai-mí-ngì-ngî	Тамильский язык
Chet-ho̍k	Философия
分類:Candidates for speedy deletion	Категория:Википедия:К быстрому удалению
Altai Khiung-fò-koet	Республика Алтай
Kòng-khìm	Фортепиано
Gorno-Altaysk	Горно-Алтайск
Kemerovo-chû	Кемеровская область
Hebe Camargo	Камарго, Эбе
Chṳ̂-pún chú-ngi	Капитализм
Koet-kâ	Страна
Mìn-chhu̍k	Нация
Khanty-Mansi Chhṳ-chhṳ-khî	Ханты-Мансийский автономный округ — Югра
Yamalo-Nenets Chhṳ-chhṳ-khî	Ямало-Ненецкий автономный округ
Montpellier	Монпелье
分類:Thiên-vùn-ho̍k	Категория:Астрономия
Khakassia Khiung-fò-koet	Хакасия
Irkutsk-chû	Иркутская область
Sakha Khiung-fò-koet	Якутия
Khiet-lò-âi-sî-â-ngî	Хорватский язык
Hon-pó	Гамбургер
Buryatia Khiung-fò-koet	Бурятия
Vû-làn Vû-tet	Улан-Удэ
Amur-chû	Амурская область
Ngi-sṳ̍p Sṳ-ki	XX век
Gotha	Гота
Dijon	Дижон
Kâ-thai-lò-nì-â-ngî	Каталанский язык
Nordhausen	Нордхаузен
Kit-lò-na̍p-sén	Жирона
Eisenach	Айзенах
Se-pâu Sâng-vu̍t-ho̍k	Цитология
Sṳ-kie Ngiùn-hòng Si̍p-thòn	Всемирный банк
A-la-pak Liên-mên	Лига арабских государств
Mìn-tsú Tsú-ngi	Демократия
Chhîn-chhèu (秦朝)	Цинь (династия)
Pet Thai-sî-yòng Kûng-yok Chû-chṳt	Организация Североатлантического договора
Chhìn Sṳ Fòng	Цинь Шихуанди
Hon-chhèu	Хань (династия)
Hon Vú-ti Liù Chha̍t	У-ди
Sâng-vu̍t	Организм
Kiûn-chú-chṳ	Монархия
Khiung-fò-koet	Республика
Yí-mô-khiù	Бадминтон
Ngièn-chhèu	Юань (династия)
Nazi Tet-koet	Третий рейх
Yù-thai-ngìn	Евреи
Chang Fò	Чжэн Хэ
Chìn-chhèu	Цзинь (265—420)
Ngí	Ухо
Phi	Нос
Ngién	Глаз
Mûn-é	Комары
Mièn-yòng	Овца
Lo̍k-thò	Верблюды
Phú-nen thung-vu̍t	Млекопитающие
Siong	Слон
Ngie-kûng	Муравьи
Phûng-é	Пчёлы
Hò-làn-ngî	Нидерландский язык
Fà-thi̍t Thit-sṳ-nì Kûng-sṳ̂	The Walt Disney Company
Thot-yong Fu̍t-thông Fu̍t-son	Дезоксирибонуклеиновая кислота
Khiô	Баклажан
Siet	Снег
Â-pâ	Отец
Fûn	Минута
Yù-thai Chhṳ-chhṳ-chû	Еврейская автономная область
Ngò-lò-sṳ̂-ngî	Русский язык
Tûng-nàm-â Koet-kâ Lièn-mèn	Ассоциация государств Юго-Восточной Азии
Sakhalin-chû	Сахалинская область
Mien-pâu	Хлеб
Sṳ-kie Mo-yi Chû-chṳt	Всемирная торговая организация
漢語	Китайский язык
Se-pâu	Клетка
Hiet-yi̍t	Кровь
Hi	Лёгкие
Lò-mâ-nì-â-ngî	Румынский язык
Pó-kâ-li-â-ngî	Болгарский язык
Magadan-chû	Магаданская область
Chhṳ-yèn Khô-ho̍k	Естествознание
Het-chhe̍t Mìn	Куросава, Акира
Franklin D. Roosevelt	Рузвельт, Франклин
Thi-khiù Khô-ho̍k	Науки о Земле
Sa̍k-thèu	Горная порода
Yùn	Облака
Kí-hò-ho̍k	Геометрия
Tet-lu-kú-ngî	Телугу
Thai-hì-chhèn	Атмосфера
Kak-lû-kit-â-ngî	Грузинский язык
Kîn-chi-ho̍k	Экономика (наука)
Pîn-kóng	Панкалпинанг
漢字	Китайское письмо
Sî-lî-ngì Sṳ-mû	Кириллица
Lâ-tên sṳ-mû	Латинский алфавит
Vùn-ho̍k	Литература
分類:Fap-koet	Категория:Франция
分類:Yîm-ngo̍k	Категория:Музыка
分類:Vùn-ho̍k	Категория:Литература
Fù-lì	Лисица
La̍p-pá	Труба (музыкальный инструмент)
Â-li̍t-sân-thai sâm-sṳ	Александр Македонский
Kiûn-sṳ-thán-tên Yit-sṳ	Константин I Великий
Set-lû-sṳ thai-ti	Кир II Великий
Vùn-mìn	Цивилизация
Kau-yuk	Образование
Kâ-thìn	Семья
Nàm-ngìn	Мужчина
Fûn-yîn	Брачный союз
Kiûn-sṳ	Военное дело
Kâ-pî	Кофе
Ngiù-nen	Молоко
Sûn Chûng-sân	Сунь Ятсен
Â-yuk-vòng	Ашока
香港	Гонконг
Thai-yîn Ti-koet	Британская империя
Sú-ngì	Сеул
Kâm-nái-thit Koet-chi Kî-chhòng	Международный аэропорт имени Джона Кеннеди
上海	Шанхай
Lùn-tûn Hî-sṳ̂-lu Kî-chhòng	Хитроу
Lùn-tûn Kak-vet Kî-chhòng	Гатвик
Set-vì-li-â	Севилья
Chhîn-chhèu	Империя Цин
Â-ngì-pâ-nì-â-ngî	Албанский язык
Pâ-sṳ̂-khiet-ngî	Баскский язык
Â-lâ-kung-ngî	Арагонский язык
Yîn-koet Hòng-khûng	British Airways
Â-mî-nì-â-ngî	Армянский язык
Vû-khiet-làn-ngî	Украинский язык
Pâ-lùn-sî-â	Валенсия
Shuì-tién-ngî	Шведский язык
Tan-ma̍k-ngî	Датский язык
Nò-vî-ngî	Норвежский язык
Kô-thi̍t-fu̍t-lòi-tet Vî-liâm Lòi-pu-nì-tsṳ	Лейбниц, Готфрид Вильгельм
Tshia̍p-khiet-ngî	Чешский язык
Sṳ̂-lo̍k-phat-khiet-ngî	Словацкий язык
Sṳ̂-lo̍k-vì-nì-â-ngî	Словенский язык
Hiûng-ngà-li-ngî	Венгерский язык
Oi-sâ-nì-â-ngî	Эстонский язык
Là-thot-vì-â-ngî	Латышский язык
Li̍p-thâu-vón-ngî	Литовский язык
Pha̍k-ngò-lò-sṳ̂-ngî	Белорусский язык
Kui-mí-thi̍t-lî Mùn-tet-lie̍t-fû	Менделеев, Дмитрий Иванович
Ngièn-chṳ́	Атом
Lâ-set-fuk	Резерфорд, Эрнест
Hî-lia̍p-ngî	Греческий язык
Oi-ngì-làn-ngî	Ирландский язык
Pô-sṳ̂-ngî	Персидский язык
Chûng-kau	Религия
Chêu-sién-ngî	Корейский язык
Chhóng-sṳ-ki	Книга Бытия
Kóng-tûng-fa	Кантонский диалект
Chhut-âi-khi̍p-ki	Книга Исход
Ye̍t-nàm-ngî	Вьетнамский язык
Pó-lò	Апостол Павел
Kô-mièn-ngî	Кхмерский язык
Thai-ngî	Тайский язык
Mâ-lòi-ngî	Малайский язык
Yin-nì-ngî	Индонезийский язык
Mùng-kú-ngî	Монгольский язык
Hâ-sat-khiet-ngî	Казахский язык
Vû-tsṳ̂-phe̍t-khiet-ngî	Узбекский язык
Thú-khù-màn-ngî	Туркменский язык
Yù-thai-kau	Иудаизм
Hî-pak-lói-ngî	Иврит
Â-set-pai-kiông-ngî	Азербайджанский язык
Mâ-khì-tun-ngî	Македонский язык
Set-ngì-vì-â-ngî	Сербский язык
Set-ngì-vì-â Khiet-lò-thi-â-ngî	Сербохорватский язык
Pô-sṳ-nì-â-ngî	Боснийский язык
Kâ-lî-sî-â-ngî	Галисийский язык
Vî-ngì-sṳ̂-ngî	Валлийский язык
Sû-kak-làn Koi-ngì-ngî	Шотландский язык (кельтский)
Siak-khiet-kau	Сикхизм
John Maynard Keynes	Кейнс, Джон Мейнард
Lufthansa Hòng-khûng	Lufthansa
Ló-chṳ́	Лао-цзы
Kôn-chhóng	Печень
Shìn	Почка (анатомия)
Thu-é	Кролики
Sṳ̀n-kîn Ne-thúng	Нервная система
Sîm-lî-ho̍k	Психология
Sṳt-kâ-mèu-nì	Будда Шакьямуни
Mâ-tên Lu-tet	Лютер, Мартин
Yî-kâ	Конфуцианство
Thiên-chú-kau	Римско-католическая церковь
Tho-kau	Даосизм
Chit-siói	Спинной мозг
Sa̍t	Язык (анатомия)
Yî-tshóng	Поджелудочная железа
Hèu-thèu	Гортань
Fuk-khiet-làn khiùn-tó	Фолклендские острова
Vàng-kak-mo̍k	Диафрагма (анатомия)
Lân-mî	Аппендикс человека
Elizabeth Ngi-sṳ	Елизавета II
Thòng-chhèu	Тан (династия)
John F. Kennedy	Кеннеди, Джон Фицджеральд
Mìn-chhèu	Империя Мин
Dwight D. Eisenhower	Эйзенхауэр, Дуайт Дэвид
Ronald Reagan	Рейган, Рональд
Sat-là-kô-sat	Сарагоса
Kîm Tsang-ngit	Ким Чен Ир
Ngièn-su Chû-khì-péu	Периодическая система химических элементов
Chû-su̍k	Кабаны
Mariano Rajoy	Рахой, Мариано
Se-khiûn	Бактерии
Phù-thò	Виноград (ягода)
Phûng-thòng	Мёд
Thông	Сахар
Vòng-theu	Соя
Kûng-chhàng-ho̍k	Инженерное дело
Vùn-fa	Культура
Fan-vun	Санскрит
Sùn-fàn Hì-thúng	Кровообращение
Sôn	Кислота
Yî-ho̍k	Медицина
Néu-Yok Sṳ-kie Mo-yi Chûng-sîm	Всемирный торговый центр
Hâ Màn-hâ-tun	Нижний Манхэттен
Yàm	Поваренная соль
分類:Pâ-sî	Категория:Бразилия
Màn-hâ-tun	Манхэттен
Ngièn-su	Химический элемент
Kâ-suk-thu	Ускорение
Li̍t	Сила
Kú	Барабан
Tsṳt-liông	Масса
Thien-yáng	Фильм
Kîm-su̍k	Металлы
Nùng-ngia̍p	Сельское хозяйство
Sâng-yîm	Звук
Sṳ̀-kiên	Время
Mien-chit	Площадь
Kûng-kîn	Килограмм
Kûng-tshak	Метр
Miéu	Секунда
Pâu-siuk	Кукуруза сахарная
Kûng-sṳ̂n	Литр
Fà-ngì-kiê	Уолл-стрит
Tûng-nàm-â	Юго-Восточная Азия
Tshùng-khin	Чунцин
Thiên-tsîn	Тяньцзинь
Vú-hon-sṳ	Ухань
Kú Hî-lia̍p	Древняя Греция
Thomas Jefferson	Джефферсон, Томас
Vùi-sṳ̂-khà	Уэска
Tychy	Тыхы
El Masnou	Эль-Масноу
Pu-lie̍t-thap-nì-ngî	Бретонский язык
Brittany	Бретань
Lóng	Нарушение слуха
Chhi̍t-phiang	Болезнь
Khien-không	Здоровье
Sok-lî-â	Сория
Màn-tó-ngî	Мэнский язык
Chhiâng-môi-su	Бензилпенициллин
Nantes	Нант
Pot-thâm-fó	Туберкулёз
Mà-chiông	Маджонг
模板:Location map Taiwan	Шаблон:ПозКарта Китайская Республика
Detroit	Детройт
Van-lî Tshòng-sàng	Великая Китайская стена
Gard-sén	Гар (департамент)
Gers-sén	Жер (департамент)
Sông Garonne-sén	Верхняя Гаронна
Sṳ̀n-sṳn Lò-mâ Ti-koet	Священная Римская империя
Ille-et-Vilaine-sén	Иль и Вилен
Isère-sén	Изер (департамент)
Chûng-kau Kói-kiet	Реформация
Sông Loire-sén	Верхняя Луара
Lot-sén	Ло (департамент)
Lozère-sén	Лозер
Maine-et-Loire-sén	Мен и Луара
Nì-pu-kap-nì-sat ngi-sṳ	Навуходоносор II
Mayenne-sén	Майен (департамент)
Morbihan-sén	Морбиан
Nièvre-sén	Ньевр
Nord-sén	Нор (департамент)
Calais Hói-hia̍p-sén	Па-де-Кале (департамент)
Puy-de-Dôme-sén	Пюи-де-Дом
Sông Pyrénées-sén	Верхние Пиренеи
Pyrénées-Orientales-sén	Восточные Пиренеи
Hâ Rhin-sén	Нижний Рейн
Sông Rhin-sén	Верхний Рейн
Saône-et-Loire-sén	Сона и Луара
Sarthe-sén	Сарта (департамент)
Sông Savoie-sén	Верхняя Савойя
Tarn-sén	Тарн
Tarn-et-Garonne-sén	Тарн и Гаронна
Var-sén	Вар (департамент)
Vaucluse-sén	Воклюз
Vendée-sén	Вандея
Yonne-sén	Йонна
Yî-pí-li-â Pan-tó	Пиренейский полуостров
Lai-kî	Личи
Yâ-è	Кокосовая пальма
Sa̍k-liù	Гранат обыкновенный
Chong-fa	Чжуанский язык
Sông-sok-pu-ngî	Верхнелужицкий язык
Na̍p-ngá-thi̍t-ngî	Астекские языки
Mí-nàm-kâ-pó-ngî	Минангкабау (язык)
Mirandés-ngî	Мирандский язык
Harvard Thai-ho̍k	Гарвардский университет
Néu-yok Chṳn-khèn Kâu-yi-só	Нью-Йоркская фондовая биржа
Lie̍t-yî-tha̍t-sén	Льейда (провинция)
Â-lâ-pak-ngî	Арабский язык
Kiú-chiu	Кюсю
Si-koet	Сикоку
O-khiet-ngî	Окситанский язык
Nàm-fî Hò-làn-ngî	Африкаанс
Lí Mìn-pok	Ли Мён Бак
Lû Vú-hién	Но Му Хён
Kâ Mà-chiok	Домовый воробей
Kô-thiet	Гонконгский метрополитен
澳門	Макао
Suhl	Зуль
Mühlhausen	Мюльхаузен (Тюрингия)
Sâ-thièn-khî	Сатхинь
Fù Kím-Thàu	Ху Цзиньтао
Si̍p Khiûn-phìn	Си Цзиньпин
Chhòng-kiáng-lu̍k	Жираф
Phì-âi-mùng-thi̍t-ngî	Пьемонтский язык
Thap-là-kô-na̍p	Таррагона
Provence-Alpes-Côte d'Azur	Прованс — Альпы — Лазурный Берег
Chhṳ̂m-chun-sṳ	Шэньчжэнь
Kóng-tûng	Гуандун
Kóng-sî Chong-chhu̍k Chhṳ-chhṳ-khî	Гуанси-Чжуанский автономный район
Mô-kài	Властелин колец
Borredà	Борреда
Hiông-kóng Thai-ho̍k	Гонконгский университет
Badajoz	Бадахос
Lu̍k-yì-tó-yen	Кагосима (префектура)
Kiok	Стопа
Sit-thit	Ящерицы
Altenburg	Альтенбург
Kiên	Плечевой сустав
Midi-Pyrénées	Юг — Пиренеи
Wikipedia:Chhâm-siòng	Википедия:Форум
Fu-mùng-thi̍t	Вермонт
Hiû-sṳ̂-tûn	Хьюстон
Kóng-chiu-sṳ	Гуанчжоу
Chiông Kie-sa̍k	Чан Кайши
Vûn Kâ-pó	Вэнь Цзябао
Nàm-kîn-sṳ	Нанкин
Phiang-yèn	Больница
Kông-sû	Цзянсу
Chet-kông-sén	Чжэцзян
Thèn Séu-phìn	Дэн Сяопин
Pet-phu Calais Hói-hia̍p	Нор — Па-де-Кале
Pays de la Loire	Земли Луары
Languedoc-Roussillon	Лангедок — Руссильон
Thiap-sat-lò-nì-kâ	Салоники
西藏自治區	Тибетский автономный район
Hàng-thung Thien-fa	Сотовый телефон
Thò-niâu	Страус
Manchester	Манчестер
Pu-lû-khiet-lìm	Бруклин
Fòng-heu-khî	Куинс
Liùng-yìn-sṳ	Йонъин
Lòng	Волк
Mâ-lòi Pan-tó	Малакка (полуостров)
Sîn-yok Sṳn-kîn	Новый Завет
Fan-lóng-thap-cham-sṳ	Фанранг-Тхаптям
9	9 (число)
Zung-gok Thaai-liuk	Континентальный Китай
Het-liùng-kông	Хэйлунцзян
Mâ Yîn-kiú	Ма Инцзю
Piên-fò-sṳ	Бьенхоа
Hiông-kóng-tó	Гонконг (остров)
Ngà-tsông-sṳ	Нячанг
Podolsk	Подольск
Pô-tô Lì-kok Thu̍k-li̍p-tóng	Партия независимости Пуэрто-Рико
Lì-è	Домашний осёл
Si-chhôn-sén	Сычуань
Khiu-yok Sṳn-kîn	Ветхий Завет
Sṳn-tan-chiet	Рождество Христово
Lò-màn Ngî-chhu̍k	Романские языки
Sâm-kok-hìn	Треугольник
Steve Jobs	Джобс, Стив
Yin-Êu Ngî-ne	Индоевропейские языки
Breinigerberg	Брайнигерберг
Lo-fú	Тигр
Fù-ôn Khà-lo̍k-sṳ̂ Yit-sṳ	Хуан Карлос I
Súi-ngièn-sṳ	Сувон
Sâm-sên Si̍p-thòn	Samsung
Louis Couturat	Кутюра, Луи
Thai-thièn Kóng-vet-sṳ	Тэджон
Kîn-ki-tho	Кёнгидо
Sṳ̂-khâm-tit-nâ-vì-â	Скандинавия
Fu̍k-fa̍t-chiet	Пасха
Thien-nó Khô-ho̍k	Информатика
Koet-chi Yîm-phiêu	Международный фонетический алфавит
Hò-pet	Хэбэй
Phú-lìm-sṳ̂-tun Thai-ho̍k	Принстонский университет
Fôn-hìn-muk	Аистообразные
Chhṳ̀n Súi-pién	Чэнь Шуйбянь
台灣	Тайвань
Chṳ-fi-hîn Sú-kî	Смартфон
Sa̍k-yù	Нефть
Hài-è	Лёгкая обувь
Ngiùn-hòng	Банк
Ngièn-lun Chhṳ-yù	Свобода слова
Oi-ngì-làn	Ирландия (остров)
Cheshire	Чешир
Cumbria	Камбрия
Lancashire	Ланкашир
Northumberland	Нортамберленд
Tyne and Wear	Тайн-энд-Уир
County Durham	Дарем (графство)
Pet Yorkshire	Северный Йоркшир
Lincolnshire	Линкольншир
Nottinghamshire	Ноттингемшир
Derbyshire	Дербишир
Merseyside	Мерсисайд
Leicestershire	Лестершир
Rutland	Ратленд (графство)
Lû-sùn	Лу Синь
Northamptonshire	Нортгемптоншир
Devon	Девон (графство)
Oxfordshire	Оксфордшир
Wiltshire	Уилтшир
Hampshire	Хэмпшир
Buckinghamshire	Бакингемшир
Surrey	Суррей
West Sussex	Западный Суссекс
East Sussex	Восточный Суссекс
Kent	Кент
Thai Lùn-tûn	Большой Лондон
7	7 (число)
8	8 (число)
Lu̍k-é	Оленевые
Pên	Лёд
Chú ke Khì-tó-vùn	Отче наш
Ngìn-lui-ho̍k	Антропология
Fùng-hói	Красное море
Oi-tên-páu	Эдинбург
Pha̍k-set	Белый цвет
Marseille	Марсель
Thai-chhûng-thèu	Лук репчатый
6	6 (число)
Kôn-fông ngî-ngièn	Официальный язык
Kháu-kú-ho̍k	Археология
George H. W. Bush	Буш, Джордж Герберт Уокер
Pâ-ngì-kòn pan-tó	Балканский полуостров
Dmitry Medvedev	Медведев, Дмитрий Анатольевич
Entrena	Энтрена
Sîn-kau	Протестантизм
Selena	Селена (певица)
Mî-koet Thai-khûng Chúng-shu	НАСА
Thai Put-lie̍t-tiên-tó	Великобритания (остров)
Pâ-le̍t-sṳ̂-thán	Палестина
10	10 (число)
Lila Downs	Даунс, Лила
Lia̍p-pau	Гепард
Liverpool	Ливерпуль
Bremen	Бремен
Sîn Nò-vî-ngî	Новонорвежский язык
Meu-thèu-tiâu	Совообразные
Sṳ̀	Час
Fap-lò-ngî	Фарерский язык
Kîm-eu-sṳ	Камау
Meu-khô	Кошачьи
Koet-chi Thai-khûng Chhàm	Международная космическая станция
Tà-la-sṳ	Далат
Tat-tat-ngî	Татарский язык
Tshûng-liông	Вес
Tsûng-su	Финик пальчатый
Fan-tshiet-sṳ	Фантхьет
Sî Fut-lî-sî-ngî	Фризские языки
Séu Vòng-chṳ́	Маленький принц
Phiàng-fông kûng-tshak	Квадратный метр
Fó-yam-chhùng	Светляки
Li̍p-fông kûng-tshak	Кубический метр
Fàn-chiet-thûng-vu̍t-mùn	Кольчатые черви
Chhú-khô	Мышиные
Lû-sêm-nì-â-ngî	Русинский язык
Ede (Hò-làn)	Эде (Гелдерланд)
Fú-kîn	Косатка (млекопитающее)
Sâ-thi̍t-fut-lî-sî-ngî	Восточнофризский язык
Liû-khiù-koet	Рюкю (государство)
Pet-fut-lî-sî-â-ngî	Севернофризский язык
Â-mê-ha̍p-lâ-ngî	Амхарский язык
蝠婆	Рукокрылые
Tarnobrzeg	Тарнобжег
Vòng Ti	Хуан-ди
Tiau-ǹg-thòi Lie̍t-yí	Сенкаку
Khiung-fò-tóng (Mî-koet)	Республиканская партия (США)
Â-sṳ̂-thù-lî-â-sṳ̂-ngî	Астурийский язык
中國	Китайская цивилизация
O-thi-li Pâ-vî-li-â-ngî	Баварский диалект
Mìn-chú-tóng (Mî-koet)	Демократическая партия (США)
Tsuk-pet-sṳ	Чжубэй
Sàng-tû-sṳ	Чэнду
Âi-sṳ̂-thi̍t-lùi-mâ-thu-lâ-ngî	Эстремадурский язык
Sàng-fà-khî	Чэнхуа
Séu-su mìn-chhu̍k	Группы меньшинств
Pô-lòi-kú	Плейку (город)
Â-ha̍p-sṳ̂-vòng	Ахаз
Chûng-chû-sṳ	Чхунджу
Yî-liàu Ví-sâng	Здравоохранение
Khiet-là-khô-fû	Краков
臺灣省	Тайвань (провинция Китайской Республики)
Pet-kîn Sú-tû Koet-chi Kî-chhòng	Шоуду
Sîn-kâ-po Hòng-khûng Kûng-sṳ̂	Singapore Airlines
Thien-nó Thôn-chhèn Só-mèu	Компьютерная томография
Vî-nî-sṳ̂-ngî	Современный венетский язык
Vì-phú-sêm-ngî	Вепсский язык
Fu̍t-lò-ngî	Выруский диалект
Pân-mâ	Зебры
Valery Leontiev	Леонтьев, Валерий Яковлевич
Khô-sî-kâ-ngî	Корсиканский язык
Buryat-ngî	Бурятский язык
Sùn-tho-chûng	Методизм
Suk-vú-ngî	Себуанский язык
Chavacano-ngî	Чабакано
Chûng-pí-khô-ngì-ngî	Центральный бикольский язык
Tha̍t-lò-phî-thû Ngî-hì	Дравидийские языки
Ló-kiê-sṳ	Лаокай
客家語	Хакка (язык)
Pet-nèn-sṳ	Бакнинь (город)
Liòng-sân-sṳ	Лангшон
Hiuk-tsin-sṳ	Шокчанг
Liùng-chhôn-sṳ	Лонгсюен
Mî-tshiu-sṳ	Митхо
Fut-liù-li-ngî	Фриульский язык
Pâng-mî-tsuk	Буонметхуот
Kàm-ngî	Гань
Pok-vu̍t-kón	Музей
Yin-thu Yî-lóng Ngî-chhu̍k	Индоиранские языки
Thai-yùng-meu	Большая панда
Kalmyk-ngî	Калмыцкий язык
Mân-ngî	Маньчжурский язык
Kû-li̍p ngî-ngièn	Изолированные языки
Kit-là-kî-ngî	Гилянский язык
Khà-sû-pí-ngî	Кашубский язык
Karachay-Balkar-ngî	Карачаево-балкарский язык
Maguindanao-ngî	Магинданао (язык)
Lùn-pâ-tí-ngî	Ломбардский язык
Sú	Кисть (анатомия)
Thu fú	Ду Фу
Maranao-ngî	Маранао (язык)
O-lî-â-ngî	Ория (язык)
Ngìn-khiéu	Население
Nò-man-thi-ngî	Нормандский язык
Pâng-â-sî-nâm-ngî	Пангасинанский язык
Nèn-phìn-sṳ	Ниньбинь (город)
Pet-sat-mí-ngî	Северносаамский язык
O-set-thôi-ngî	Осетинский язык
Sî-sî-lî-ngî	Сицилийский язык
Sat-tên-nî-â-ngî	Сардинский язык
Nì-ngá-ngì-ngî	Неварский язык
Valparaíso	Вальпараисо
Kóng-ngi-sṳ	Куангнгай
Hò-tshin-sṳ	Хатинь
Yên-yèn	Актёр
Thap-kâ-lo̍k-ngî	Тагальский язык
Thùng	Бронза
Vlaams-ngî	Фламандские диалекты
Fà-liùng-ngî	Валлонский язык
Sú-ngî	Жестовые языки
Yî-ngî	Носу
Międzyrzec Podlaski	Мендзыжец-Подляский
Phiêu-chún Chhông-ngî	Тибетский язык
Ngá-shuì-ngá-shuì-ngî	Варайский язык
Yì-ku-tshu̍k	Жёлтые уйгуры
N̂g-ngî	У (язык)
Woodrow Wilson	Вильсон, Вудро
Fu̍t-sân-sṳ	Фошань
Ngiù-chîn Thai-ho̍k	Оксфордский университет
Sú-tsṳ́	Палец
Sṳ̍p-thiàu Kie-min	Десять заповедей
Yok-hon-nì-sṳ̂-páu	Йоханнесбург
Kî-tuk Kau-fi	Христианская церковь
Pau-é	Леопард
Sîn-kiông	Синьцзян-Уйгурский автономный район
Muk-kôa	Папайя
Pu-lî-sṳ̂-pân	Брисбен
Â-mî-ngî	Амисский язык
Vî-liâm Lùn-khìm	Рентген, Вильгельм Конрад
Chû-chhèu	Чжоу (династия)
Ido-ngî	Идо
Brad Pitt	Питт, Брэд
Pa̍k-kiûng	Белый дом
Tha̍t-mâ-thai-ngî	Далматинский язык
Tat-tat-chhu̍k	Татары
Kô-liáng-sṳ	Каолань
Thai-fán-sṳ	Осака
Sên-khiù-ngî	Лингва де планета
Kiam-khiâu Thai-ho̍k	Кембриджский университет
Kûng-khín	Гектар
Sé-lî	Крещение
Pông-hâ	Бронхиальная астма
Chuk	Bambuseae
Hiligaynon-ngî	Хилигайнон (язык)
Fù Tsṳ-mìn	Хо Ши Мин
Thièn-piên-fú	Дьенбьенфу (город)
Khûn-sṳ-làn-chû	Квинсленд
Ha-liùng-sṳ	Халонг (город)
Kûi-yìn-sṳ	Куинён
Mìn-nì-â-pô-li-sṳ̂	Миннеаполис
Li̍t-ka-sṳ	Ратьзя
Li-kú-lî-â-ngî	Лигурский язык (современный)
Phô-lò-chû	Калимантан
Khà-phién-phién-kâm-ngî	Капампанганский язык
Vù-fâ-kó	Инжир
Sun-fa-sṳ	Хюэ
Tshòng-thu	Длина
Sṳ̂-chhù-chṳ̂-lu	Великий шёлковый путь
Hói-yòng-sṳ	Хайзыонг
Mô-li-ngî	Маори (язык)
Mên-tûng-ngî	Восточноминьский язык (диалект)
Tô-se-pâu sâng-vu̍t	Многоклеточный организм
Hîn-ôn-sṳ	Хынгйен
Mên-nàm-ngî	Южноминьский язык (диалект)
Tshiên-ngièn	Тысячелетие
Ho̍k-miàng	Биноминальная номенклатура
Vì-tô-li-â-chû	Виктория (Австралия)
Chong-chhu̍k	Чжуаны
Sông-hói-fa	Шанхайский диалект
Pet-kông	Бакзянг (город)
Aung San Suu Kyi翁山蘇姬	Аун Сан Су Чжи
Tshèu-chû-fa	Чаошаньское наречие
Yok-hon-fuk-yîm	Евангелие от Иоанна
William Vòng-chṳ́	Уильям, герцог Кембриджский
Chhṳ̀n Kóng-sâng	Чан, Джеки
12	12 (число)
Vok-là-phú-khiet-ngî	Волапюк
Toshiro Mifune	Мифунэ, Тосиро
Kám-lám-su	Олива европейская
Só-lò-mùn-vòng	Соломон
O-khiet-làn	Окленд (Новая Зеландия)
Chhṳ̍t-sien	Прямая
11	11 (число)
13	13 (число)
Sûn-chṳ́	Сунь-цзы
Sṳn-lìn	Святой Дух
Lû-pu-lìm	Люблин
Thì-thèu	Арахис культурный
100	100 (число)
Tshit-thèu	Коленный сустав
Tô-piên-hìn	Многоугольник
Nàm Chûng-koet Hói	Южно-Китайское море
Campora San Giovanni	Кампора-Сан-Джованни
Pien-set-liùng	Хамелеоны
Bloemfontein	Блумфонтейн
Ngiam-set-thí	Хромосома
O-khiet-làn Vùn-fap Ho̍k-káu	Оклендская гимназия
Ngióng-kông	Янгон
Ma̍k-tông-lò Kûng-sṳ̂	McDonald’s
1000000	Миллион
Meu-miàng-sṳ	Маомин
Liú-chiu-sṳ	Лючжоу
Pet-pan-khiù	Северное полушарие
Ló-chhú	Домовые мыши
Thí-tsit	Объём
Het-tsṳ̂	Герц (единица измерения)
Pak-pân-khiet	Бербанк (Калифорния)
Sien-lia̍p-thí	Митохондрия
Yî-sên	Врач
Ki-sa̍k-chhṳn	Стоунхендж
Chúng-thí Kîn-chi-ho̍k	Макроэкономика
Ágreda	Агреда
Lu-kâ-fuk-yîm	Евангелие от Луки
Sîn Kí-nui-â	Новая Гвинея
Sṳ́-thù-hàng-chhon	Деяния святых апостолов
Mô-hái	Крабы
PH	Водородный показатель
Khì-tó	Молитва
Ôn-fui-sén	Аньхой
Chûng-chhîn Pet-tho	Чхунчхон-Пукто
Chûng-chhîn Nàm-tho	Чхунчхон-Намдо
Kông-ngièn-tho (Hôn-koet)	Канвондо (Южная Корея)
Nui Mùng-kú	Внутренняя Монголия
Kîm Ngit-sṳ̀n	Ким Ир Сен
Pí-tet-kô-sṳ̍p	Быдгощ
Nottingham	Ноттингем
Thai-ví-vòng	Давид
Li-vi-ki	Книга Левит
Sṳ̂-thán-fuk Thai-ho̍k	Стэнфордский университет
Fuk-kian	Фуцзянь
Kûng-khiet	Грамм
Mùng-kú-tshu̍k	Монголы
Khí-sṳ-liu̍k	Откровение Иоанна Богослова
Kong-lîn-sṳ	Каннын
Kiê-liùng-sṳ	Керён
Kô-yòng-sṳ	Коян
Kûng-chû-sṳ	Конджу
Kó-chhôn-sṳ	Квачхон
Kông-mìn-sṳ	Кванмён
Kóng-chû-sṳ (Hôn-koet)	Кванджу (Кёнгидо)
Kiú-lî-sṳ	Кури (город)
Kiûn-phú-sṳ	Кунпхо
Kîm-phú-sṳ	Кимпхо
Nàm-yòng-chû-sṳ	Намъянджу
Lun-sân-sṳ	Нонсан
Thông-chîn-sṳ (Hôn-koet)	Танджин
Tûng-theu-chhôn-sṳ	Тондучхон
Tûng-hói-sṳ (Hôn-koet)	Тонхэ
Pó-nèn-sṳ	Порён
Fu-chhôn-sṳ	Пучхон
Sâm-chit-sṳ	Самчхок
Shuì-sân-sṳ	Сосан
Sàng-nàm-sṳ	Соннам
Suk-chhó-sṳ	Сокчхо
Sṳ́-hîn-sṳ	Сихын
Ngà-sân-sṳ	Асан (город)
Ôn-sân-sṳ	Ансан
Ôn-sàng-sṳ (Hôn-koet)	Ансон
Ôn-yông-sṳ	Анян
Yòng-chû-sṳ	Янджу
Vû-sân-sṳ	Осан
Ngièn-chû-sṳ	Вонджу
Ngi-vòng-sṳ	Ыйван
Ngi-chṳn-fú-sṳ	Ыйджонбу
Li-chhôn-sṳ (Hôn-koet)	Ичхон
Thî-chhôn-sṳ	Чечхон
Thiên-ôn-sṳ	Чхонан
Chhîn-chû-sṳ	Чхонджу
Chhûn-chhôn-sṳ	Чхунчхон (город)
Thai-pha̍k-sṳ	Тхэбэк (город)
Po-chû-sṳ	Пхаджу
Phìn-tshe̍t-sṳ	Пхёнтхэк
Phàu-chhôn-sṳ	Пхочхон
Hò-nàm-sṳ	Ханам (город)
Fà-sàng-sṳ	Хвасон (город)
Buckingham Kiûng	Букингемский дворец
Hói-nàm	Хайнань
Yén-tûng	Дальний Восток
Ngiên-kiu	Исследование
Kâm-suk	Ганьсу
Pha̍k Se-pâu	Лейкоциты
York	Йорк
Tsiú	Локтевой сустав
Sṳ̂n-min-ki	Второзаконие
Sû-chû-sṳ	Сучжоу (Цзянсу)
Vûn-chû-sṳ	Вэньчжоу
Windsor Sàng-páu	Виндзорский замок
Hòn-chhu̍k	Хань (народ)
Nèn-pô-sṳ	Нинбо
Tet-koet-ngìn	Немцы
Ko-men	Аллергия
Fù-khì	Пиявки
Kîm-yùng	Финансы
1000	Тысяча
Mìn-su-ki	Книга Чисел
Liu̍k Khiet-vùn	Радд, Кевин
Ngo̍k-ǹg	Настоящие крокодилы
Yùn-nàm	Юньнань
Vû-â	Вороны
Plymouth	Плимут (Англия)
Sân-tûng	Шаньдун
Pí	Плечо (часть тела)
Derby-sṳ	Дерби (Англия)
Thàn-khîn Fa-ha̍p-vu̍t	Углеводороды
Hò-nàm	Хэнань
Montehermoso	Монтеермосо
Liâu-nèn	Ляонин
El Cid	Сид Кампеадор
Jim Morrison	Моррисон, Джим
Kóng-khiéu	Порт
Thòi-vân Thò-yèn Koet-chi Kî-chhòng	Тайвань-Таоюань (аэропорт)
Kit-lìm	Гирин
Fù-nàm	Хунань
Chhiâng-hói	Цинхай
Vì-ngâ-ngì-tshu̍k	Уйгуры
Rhône-sén	Рона (департамент)
Koet-kâ Kûng-yèn	Национальный парк
Pâ-lì Charles-de-Gaulle Koet-chi Kî-chhòng	Париж — Шарль-де-Голль
Chṳ̂-sán	Актив (бухгалтерия)
O-le̍t-liòng	Аврелиан
Fù-pet	Хубэй
Sân-sî	Шаньси
Hòng-khûng Kûng-sṳ̂	Авиакомпания
Hò-khiéu-vân	Эстуарий
Chûng-set	Коричневый цвет
Kui-chû	Гуйчжоу
Berkelland	Беркелланд
Chûng-khi Sṳ̀n-kîn Ne-thúng	Центральная нервная система
Yî-fut-só	Эфес (город)
Ôn-tha̍t-màn Hói	Андаманское море
Yok-sû-â-ki	Книга Иисуса Навина
Sî-pet Yîn-kak-làn	Северо-Западная Англия
Shám-sî-sén	Шэньси
Tûng-pet Yîn-kak-làn	Северо-Восточная Англия
Tûng Midlands	Восточный Мидленд
Tûng Yîn-kak-làn	Восточная Англия
Tûng-nàm Yîn-kak-làn	Юго-Восточная Англия
Sî-nàm Yîn-kak-làn	Юго-Западная Англия
模板:Commonscat	Шаблон:Commonscat
Sî Midlands	Западный Мидленд
Yorkshire lâu Humber	Йоркшир и Хамбер
Kòn Se-pâu	Стволовые клетки
Lò-mâ-sû	Послание к Римлянам
Mâ-liuk-kap Hói-hia̍p	Малаккский пролив
Yù-thai Vòng-koet	Иудейское царство
Mî-koet Pha̍k-ngìn	Белые американцы
Fî-yí Mî-koet Het-ngìn	Афроамериканцы
Mà-sat-chû-set Lî-kûng Ho̍k-yen	Массачусетский технологический институт
Pô-sṳ-tun Thai-ho̍k	Бостонский университет
Yâ-lû Thai-ho̍k	Йельский университет
Nàm-pet-chêu	Южные и Северные Династии
Liû-Sùng	Лю Сун
Fûn-lî	Свадьба
Pan Chúng-thúng-chṳ	Смешанная республика
Kâ-phìn-khiùn	Капхён
Kô-sàng-khiùn (Hôn-koet)	Косон (Канвондо)
Fâi-sân-khiùn	Квесан
Kím-sân-khiùn	Кымсан
Tan-yòng-khiùn (Hôn-koet)	Танян
Po-ên-khiùn	Поын
Fù-yì-khiùn	Пуё (уезд)
Sû-chhôn-khiùn	Сочхон
Yòng-khiéu-khiùn	Янгу (Корея)
Siong-yòng-khiùn	Янъян
Yòng-phìn-khiùn	Янпхён
Lî-chû-sṳ	Йоджу
Liên-chhôn-khiùn	Йончхон (уезд)
Yún-thùng-khiùn	Йондон
Nèn-ye̍t-khiùn	Йонволь
Lî-sân-khiùn	Есан
Vok-chhôn-khiùn	Окчхон
Yîm-sàng-khiùn	Ымсон
Lîn-thài-khiùn	Индже
Tsin-san-khiùn	Чонсон
Chên-phiàng-khiùn	Чынпхён
Chṳ́n-chhôn-khiùn	Чинчхон
Thiet-ngièn-khiùn	Чхорвон
Chhiâng-yòng-khiùn	Чхонъян
Thai-ôn-khiùn	Тхэан
Fùng-sàng-khiùn	Хонсон (Чхунчхон-Намдо)
Fùng-chhôn-khiùn	Хончхон
Fà-chhôn-khiùn	Хвачхон
Vàng-sàng-khiùn	Хвенсон
Fî-li̍p-pí-sû	Послание к Филиппийцам
Thiên-koet Pat-fuk	Заповеди блаженства
Mî-koet Lièn-pâng Chún-phi Ne-thúng	Федеральная резервная система
Kúai-é	Бесхвостые
Hâ Sî-lî-sî-â-sén	Нижнесилезское воеводство
Khù-â-vì - Pô-mî-là-nì-â-sén	Куявско-Поморское воеводство
Lû-pu-lìm-sén	Люблинское воеводство
Lû-pu-sṳ̂-khà-sén	Любуское воеводство
Lò-tsṳ-sén	Лодзинское воеводство
Séu Pô-làn-sén	Малопольское воеводство
Mâ-tsó-fû-sá-sén	Мазовецкое воеводство
O-pô-lòi-sén	Опольское воеводство
Khak-ngì-pâ-yèn-sân-sén	Подкарпатское воеводство
Pô-tet-là-chhia-sén	Подляское воеводство
Pô-mî-là-nì-â-sén	Поморское воеводство
Sî-lî-sî-â-sén	Силезское воеводство
Sṳn-sṳ̍p-sṳ-sén	Свентокшиское воеводство
Sî Pô-mî-là-nì-â-sén	Западно-Поморское воеводство
Pâ-lùn-sî-â-sén	Валенсия (провинция)
Sat-là-kô-sat-sén	Сарагоса (провинция)
Vùi-sṳ̂-khà-sén	Уэска (провинция)
Baak-gaa-seng	Сто фамилий
Sok-lî-â-sén	Сория (провинция)
Hien-thoi Khì-chhâ	Hyundai Motor
Kîm Tsang-ên	Ким Чен Ын
Pu-nùng-ngî	Бунун (язык)
Kông-sî	Цзянси
Wernher von Braun	Браун, Вернер фон
Nèn-ha	Нинся-Хуэйский автономный район
Lí Hién-liùng	Ли Сяньлун
Kîm-fà-sṳ	Цзиньхуа
Thòi-chû-sṳ	Тайчжоу (Чжэцзян)
Phòng-châ-phú-ngî	Панджаби
Phú-sṳ̍p-thok-ngî	Пушту
Yâ-chû	Кабан
Chû-hói-sṳ	Чжухай
Sân-thèu-sṳ	Шаньтоу
Shâu-kûan-sṳ	Шаогуань
Kông-mùn-sṳ	Цзянмынь
Chhám-kông-sṳ	Чжаньцзян
Shàu-khin-sṳ	Чжаоцин
Fi-chiu-sṳ	Хойчжоу
Mòi-chiu-sṳ	Мэйчжоу
San-mî-sṳ	Шаньвэй
Hò-ngièn-sṳ	Хэюань
Yòng-kông-sṳ	Янцзян
Chhîn-yén-sṳ	Цинъюань
Tûng-kôn-sṳ	Дунгуань
Chûng-sân-sṳ	Чжуншань (город)
Chhèu-chiu-sṳ	Чаочжоу
Mâ-liuk-kap-sṳ	Малакка (город)
Khiâu-chhṳ-sṳ	Джорджтаун (Пенанг)
IPhone 5	IPhone 5
Nàm-Chhî	Южная Ци
Mèu-li̍t-yen	Мяоли (уезд)
Sṳn-chhôn-lî	Евхаристия
Fuk-chiu-sṳ	Фучжоу
Nàm-phìn-sṳ	Наньпин
Phû-thièn-sṳ	Путянь
Sâm-mìn-sṳ	Саньмин
Tshièn-chiu-sṳ	Цюаньчжоу
Hà-mûn-sṳ	Сямынь
Chông-chiu-sṳ	Чжанчжоу
Liùng-ngâm-sṳ	Лунъянь
Nèn-tet-sṳ	Ниндэ
Sî-pak-li-â Fú	Амурский тигр
Buren	Бюрен (община)
Pat-tet-sṳ	Бадэ
Sîn-chuk-yen	Синьчжу (уезд)
Nó	Мозг
Thông Ngiâ-mong	Шалль фон Белль, Адам
Yáng-chhiong Chín-thôn-ho̍k	Радиология
Rumia	Румя
Kluczbork	Ключборк
La̍p-tsuk	Свеча
Hiet-chiong	Плазма крови
Southampton	Саутгемптон
Lu-tet-ki	Книга Руфь
Hâ-sat-khiet-chhu̍k	Казахи
Yòng-mî	Разнокрылые
Chit-fûn-ho̍k	Интеграл
Kô-lìm-tô-chhièn-sû	1-е послание к Коринфянам
Sî-pân-ngà Ti-koet	Испанская империя
Sṳ-sṳ̂-ki	Книга Судей Израилевых
Po-lîn-chhòi	Шпинат огородный
Pâ-set-lò-nâ-sén	Барселона (провинция)
Nàm-thèu-yen	Наньтоу (уезд)
Liuk-piên-hìn	Шестиугольник
Thòi-pet 101	Тайбэй 101
Lùn-tûn Thap-khiâu	Тауэрский мост
Luì-kûng	Гром
Siù-li Yún-kòn-sien-chhùng	Caenorhabditis elegans
O-pô-lòi	Ополе
Sopot	Сопот (Польша)
Â-sṳ̂-thù-lî-â-sṳ̂-sén Chhṳ̍t-hot-sṳ	Муниципалитеты Астурии
Kám-lám-yù	Оливковое масло
Chim-sin-fi	Баптизм
Lie̍t-yî-tha̍t-sén Chhṳ̍t-hot-sṳ	Муниципалитеты Льейды
Set-vì-li-â-sén	Севилья (провинция)
Thap-là-kô-na̍p-sén	Таррагона (провинция)
Provence-sén	Прованс
Kî-hài Kûng-chhàng	Машиностроение
Apeldoorn	Апелдорн
Lìm-pó-ngî	Лимбургский язык
Khái-ngì-chhái	Кельце
Bytom	Бытом
Ôn-sit-ngit	Шаббат
Khìm-sṳ̂-thok-khok-ngá	Ченстохова
Zabrze	Забже
Ôn-sit-ngit-fi	Церковь адвентистов седьмого дня
Jean Michel Jarre	Жарр, Жан-Мишель
Thai Pô-làn Thi-khî Kô-yî-fû	Гожув-Велькопольский
Là-tô-mê	Радом
Lo̍k-chham-ki-yen	Лос-Анджелес (округ)
Słupsk	Слупск
Sosnowiec	Сосновец
Gliwice	Гливице
Yo̍k-sṳ̂	Аптекарь
Hi-kôn Yì-chhṳ̍t	Трансплантация
Pâ-lùn-sî-â-sén Chhṳ̍t-hot-sṳ	Муниципалитеты Валенсии
Bielsko-Biała	Бельско-Бяла
Rybnik	Рыбник
Tân-fu̍t Se-pâu	Моноцит
Mâ-khó-fuk-yîm	Евангелие от Марка
Ruda Śląska	Руда-Слёнская
Yok-thán-vòng	Иоафам
Thò-yèn-yen	Таоюань (Тайвань)
10000000	10 000 000 (число)
Nò-mí	Клейкий рис
Kîn-tû-fú	Киото (префектура)
Kau-su	Профессор
Thai-fán-fú	Осака (префектура)
Fuk-kông-yen	Фукуока (префектура)
Oi-yèn-yen	Эхимэ
Kô-lìm-tô-heu-sû	2-е послание к Коринфянам
Khien-mî	Культуризм
Chhùng-hièn	Земляные черви
Port Elizabeth	Порт-Элизабет (ЮАР)
Kimberley (Nàm-fî)	Кимберли (ЮАР)
Yok-sâ-fap-vòng	Иосафат
Thòi-vân Hói-hia̍p	Тайваньский пролив
Sî Khôi-phú-sén	Западно-Капская провинция
Yamaguchi-yen	Ямагути (префектура)
Khiâu-chhṳ Sâm-sṳ	Георг III (король Великобритании)
Chûng-koet Thi-fông	Тюгоку
Mî-koet Thu̍k-li̍p Siên-ngièn	Декларация независимости США
Sâm-tshûng-yen	Миэ
Yù-mu̍k mìn-chhu̍k	Кочевники
Hiông-pak-su	Кедр
Hî-pak-lòi-sû	Послание к Евреям
Kâ-lâ-thai-sû	Послание к Галатам
Màn-é	Угреобразные
Sông-chhèu	Шан (династия)
Thai-thúi	Бедро
Pîn-khù-yen	Хёго
Kiûng-khì-yen	Миядзаки (префектура)
Yùng-pún-yen	Кумамото (префектура)
Fò-phìn-sṳ	Хоабинь
Stamford Raffles	Раффлз, Стэмфорд
Sha̍m-é	Певчие цикады
Tûng Khôi-phú-sén	Восточно-Капская провинция
Fap-koet Hòng-khûng	Air France
Lie̍t-vòng-ki-song	Третья книга Царств
Kô-lò-sî-sû	Послание к Колоссянам
Ngâ-kok-sû	Послание Иакова
Yok-hon-yit-sû	1-е послание Иоанна
Fî-li-mùn-sû	Послание к Филимону
Thiap-sat-lò-nì-kâ-heu-sû	2-е послание к Фессалоникийцам
Thiap-sat-lò-nì-kâ-chhièn-sû	1-е послание к Фессалоникийцам
Pí-tet-chhièn-sû	1-е послание Петра
Thì-mô-thai-chhièn-sû	1-е послание к Тимофею
Lí Kông-yeu	Ли Куан Ю
Chṳ̂-kâ-kô Thai-ho̍k	Чикагский университет
Tsṳ̂-fo-yen	Сига
Mu-nì-het Kî-chhòng	Мюнхен (аэропорт)
Yok-hon-ngi-sû	2-е послание Иоанна
Thì-mô-thai-heu-sû	2-е послание к Тимофею
Thì-tô-sû	Послание к Титу
Yî-sṳ̂-lâ-ki	Книга Ездры
Nì-hî-mí-ki	Книга Неемии
Pietersburg	Полокване
Séu Pha̍k-Lù	Малая белая цапля
Chhòn-ngiam-phiang	Инфекционные заболевания
Kôn-yàm	Гепатит
Chhûn-chiet	Китайский Новый год
Shinzō Abe	Абэ, Синдзо
Mpumalanga-sén	Мпумаланга
Pet Khôi-phú-sén	Северо-Капская провинция
Tó-kîn-yen	Симанэ
Kông-sân-yen	Окаяма (префектура)
Gauteng-sén	Гаутенг
Thung-fûng	Подагра
Chông-fa-yen	Чжанхуа (уезд)
Thai-fûn-yen	Оита (префектура)
Tiâu-tshí-yen	Тоттори (префектура)
Nùng-la̍k	Китайский календарь
Kô-tî-yen	Коти (префектура)
Pha̍k-hèu	Дифтерия
Exeter	Эксетер
Saint Lawrence-hò	Река Святого Лаврентия
Limpopo-sén	Лимпопо (провинция)
Kô-tén Kau-yuk	Высшее образование
Sân-tá-kîn	Сандакан
Â-pí	Кота-Кинабалу
Hak-kâ-tóng	Партия Хакка
Ngi̍t-pún thúng-tshṳ sṳ̀-thoi (Thòi-vân)	Тайвань под властью Японии
Phok Kiún-fi	Пак Кын Хе
Lévis	Леви (Квебек)
Thòi-fûng	Тайфун
Thòi-nàm-sṳ	Тайнань
Laval (Québec)	Лаваль (Квебек)
Mâ-lòi Pô-lî-nì-sî-â Ngî-chhu̍k	Малайско-полинезийские языки
Fên-yòng-sṳ	Хэнъян
Mân-chiu-tshu̍k	Маньчжуры
Zambrów	Замбрув
Doetinchem	Дутинхем
Zamość	Замосць
Malbork	Мальборк
Groesbeek	Грусбек
Mì-chit-fûn-ho̍k	Математический анализ
Mì-fûn	Дифференциальное исчисление
Ngo̍k-yòng-sṳ	Юэян
BP	BP
Sú-thiàu	Картофель фри
Yùn-lìm-yen	Юньлинь (уезд)
Kiok-tsṳ́	Палец ноги
Vî-liâm Â-li̍t-sân-thai (Hò-làn)	Виллем-Александр
Krasnystaw	Красныстав
Vì-tô-li-â Kóng	Виктория (бухта)
Sî-kung-khî	Сайкун
Mâ-nâ-sî-vòng	Манассия (царь Иудеи)
Kî-kîm-fi	Фонд
A-hîn Kôn-yàm	Гепатит А
Yù-tsiâm-vong-khî	Яучимвон
Fûng-sái	Хурма восточная
Tshṳ̍t-tshòng	Прямая кишка человека
Chhṳ-yù Pâng-sén	Фри-Стейт
Tsó-fo-yen	Сага (префектура)
Tet-tó-yen	Токусима (префектура)
Sî-pân-ngà-ngìn	Испанцы
Fu̍t-chhṳ̂ Khiung-chṳn Sṳ̀n-siong	Магнитно-резонансная томография
Hiông-tshon-yen	Кагава (префектура)
Reading, Berkshire	Рединг (Англия)
Kâ-chû Lî-kûng Ho̍k-yen	Калифорнийский технологический институт
Vì-ngì-tshṳ-páu Thai-ho̍k	Вюрцбургский университет
Êu-kí-lî-tet Kí-hò	Евклидова геометрия
Si̍t-kuk	Силиконовая долина
Barneveld	Барневелд (община)
Khiu Tha̍t-sîn	Чиннават, Таксин
Kîm-kôa	Тыква (плод)
Thai Sùn-thâ Khiùn-tó	Большие Зондские острова
Doesburg	Дусбург (город)
Sî-pet-sén	Северо-Западная провинция (ЮАР)
Sien-thon	Отрезок
Kâ-ngi-yen	Цзяи (уезд)
Vûn-tai	Умеренный климат
Thai-khi̍t-khièn	Тайцзицюань
Kiok-khwá	Лодыжка
Hò-làn Tâi-thi Sat-khiet-sùn-ngî	Нижнесаксонские диалекты
Pân-kiêu-é	Обыкновенная горлица
Tshòng-khì-yen	Нагасаки (префектура)
Hà-chhèu	Ся (династия)
Chû-vì Sṳ̀n-kîn Ne-thúng	Периферическая нервная система
Lùn-tûn Thai-ho̍k	Лондонский университет
Kip-sú	Числовой ряд
Nelspruit	Мбомбела
Sâ-là-ye̍t-chû	Саравак
Â-chû Thai-phìn-yòng Kîn-tsi Ha̍p-tsok Fi-ngi	Азиатско-Тихоокеанское экономическое сотрудничество
Kôan-chiet-yàm	Артрит
Geldermalsen	Гелдермалсен (община)
Ngò-piên Yì-chhu̍k Chhṳ-chhṳ-yen	Эбянь-Иский автономный уезд
Chûng-la̍k-sṳ	Чжунли
Montauban	Монтобан
Chhòng-sâ-sṳ	Чанша
Thai Put-lie̍t-tiên lâu Oi-ngì-làn Lièn-ha̍p Vòng-koet	Соединённое королевство Великобритании и Ирландии
Kiok-kiên	Пятка
Kûng-fûn	Сантиметр
Lièn-ha̍p Hòng-khûng	United Airlines
Yen-thèu	Глотка
Hò-mí	Миллиметр
Mì-mí	Микрометр
Khi̍t-han (Sú-ho̍k)	Предел (математика)
Theu-fú	Тофу
Phù-sat	Бодхисаттва
Chóng-ló Kau-fi	Пресвитерианство
Hien-thoi Veloster	Hyundai Veloster
Nai-mí	Нанометр
Berlanga de Duero	Берланга-де-Дуэро
Pâ-chûng-sṳ	Бачжун
Sâ-pâ-chû	Сабах
Nàm-nèn-sṳ	Наньнин
Ngâ-li-ôn-ngìn	Арии
Yù-sṳn-mî-thi Koet-kâ Kûng-yèn	Йосемити (национальный парк)
Chhiâng-set	Сине-зелёный цвет
Ho̍k-yen	Факультет
Kô-hiùng-sṳ	Гаосюн
Pet-mî Chhṳ-yù Mo-yi Hia̍p-ngi	Североамериканская зона свободной торговли
Sû-kak-làn-ngìn	Шотландцы
Rustenburg	Рюстенбург
Yen-tsong-fui	Концерт
Yù-fu̍t-chû	Джохор
Ngò-lò-sṳ̂ Lièn-pâng Chhṳ̍t-hot-sṳ	Город федерального значения
Fì-tshu̍k	Хуэй (народ)
Sha̍k-sṳ	Магистр
Preston, Lancashire	Престон
Sî-tí-kâ-vòng	Седекия
Sâm-koet	Эпоха Троецарствия
Chhûn-chhiû Sṳ̀-khì	Период Чуньцю
Chan-koet Sṳ̀-khì	Период Сражающихся царств
Mâ-liuk-kap-chû	Малакка (штат)
Pietermaritzburg	Питермарицбург
Sú-vón	Лучезапястный сустав
Kit-làn-tan-chû	Келантан
Tshông-tshu̍k	Тибетцы
Pîn-sàng-chû	Пинанг
Blackburn	Блэкберн
Chûng-sin Pha̍k-hiet-khiû	Нейтрофильные гранулоциты
Pâng-kâ-tó	Банка (остров)
Phìn-chhông-khiùn	Пхёнчхан
Thai-koet Koet-chi Hòng-khûng Kûng-sṳ̂	Thai Airways International
Thai Ngi̍t-pún Ti-koet	Японская империя
Hiûng-nù	Хунну
Phit-li̍t-chû	Перак
Lùn-tûn Ti-koet Ho̍k-yen	Имперский колледж Лондона
Kui-lìm-sṳ	Гуйлинь
Siet-làn-ngô-chû	Селангор
Tui-kok-sien	Диагональ
Fi-li-phi Liuk-sṳ	Филипп VI (король Испании)
Kûng-tún	Тонна
Phàng-hên-chû	Паханг
中國象棋	Сянци
Pit-sṳn-hak	Пицца Хат
Yim-suk Siáu-tsṳ́	Ёж Соник
Ngo̍k-vûn-khiet-tshu̍k	Эвенки
Nàm-kîn Thai-thù-sat	Нанкинская резня
Yún Chṳ-Hau	Юн Чхи Хо
Phì-mí	Пикометр
Chûng-koet 2010-ngièn Sông-hói Sṳ-kie Pok-lám-fi	Всемирная выставка (2010)
Ngiù-ngiuk	Говядина
Carlisle, Cumbria	Карлайл (Англия)
Sandomierz	Сандомир
Ngit-tèu-kông	Солнечная радиация
Khwon-kûan-tsiet	Тазобедренный сустав
Fûn-kî-hon-khiûn	Микобактерии
Chàu-yòng-sṳ	Шаоян
Phìn-tûng-yen	Пиндун (уезд)
Chông-fa-sṳ	Чжанхуа
Hién-mì-kiang	Микроскоп
Chông-kâ-kie-sṳ	Чжанцзяцзе
Chṳ Sṳ̀n-kûng	Чжэн Чэнгун
Chûng-kông-yen	Чжунцзян
Chon-hiuk	Чжуань-сюй
Chu-chû-sṳ	Чжучжоу
Phàng-fù-yen	Пэнху (уезд)
Kûng-tshun	Дециметр
McGill Thai-ho̍k	Университет Макгилла
Sâm-fòng Ńg-ti	Три властителя и пять императоров
Sanok	Санок
Chhṳ-liù-chiáng-khî	Цзылюцзин
Mâ-tshâ	Колесница
Milton Keynes	Милтон-Кинс
Â-mî-tshu̍k	Ами (народ)
Ên-tién	Благодать
Hî-lìn-tên-khî	Хиллингдон (боро Лондона)
Chṳ̂-yòng-sṳ	Цзыян
Sṳ̀n-chhùng	Имаго
Chang Thien-chṳ́ Fat-sa Kie-son-kî Thôn-chhèn Só-mèu	Позитронно-эмиссионная томография
Przemyśl	Пшемысль
Chhiòn-khiû Sàng-sṳ	Глобальный город
Pî-mí	Ферми (единица измерения)
Burnley	Бернли
Tûng Lùn-tûn, Tûng Khôi-phú-sén	Ист-Лондон
Sat-mû-ngí-ki-ha	Вторая книга Царств
Lie̍t-vòng-ki-ha	Четвёртая книга Царств
Biała Podlaska	Бяла-Подляска
Mèu-tshu̍k	Мяо
Pet-hói-sṳ	Бэйхай
Mafikeng	Мафикенг
Mí-sâ-yên Khiùn-tó	Висайские острова
Yông-muì-sṳ	Янмэй
Lò-pô-ôn-vòng	Ровоам
Slough	Слау
Thì-mô-thai	Тимофей Эфесский
Chho̍k-sṳ̂-lia̍p	Центромера
Tûng-hò, Néu-yok-sṳ	Ист-Ривер
Chhêu-fông-hìn	Гиперкуб
Sêm-mî-làn-chû	Негри-Сембилан
Brzeg	Бжег
Fidel Valdez Ramos	Рамос, Фидель Вальдес
Łomża	Ломжа
Siong-thâm-sṳ	Сянтань
Thûng-tshu̍k	Дун (народ)
Pak-fo Kûng-sṳ̂	Универсальный магазин
Thòi-vân Ngièn-tshu-mìn	Аборигены Тайваня
騷靈現象	Полтергейст
Tha̍t-vat-ngì-tshu̍k	Дауры
Na̍p-sî-tshu̍k	Наси (народ)
Kô-hiùng-yen	Гаосюн (уезд)
Outaouais	Оттава (Квебек)
Kuî-é	Черепахи
Pak-sâ-sat	Валтасар
Tshièn-pí	Предплечье
Yî-set-lie̍t Vòng-koet	Северно-Израильское царство
Tshòn-fì Yâ-lu-sat-lâng Yun-thung	Назад в Иерусалим!
Sîn-sân-sṳ	Джохор-Бару
Khiu-kîm-sân Vân	Сан-Франциско (залив)
Li Mâ-teu	Риччи, Маттео
Tshài Yîn-vùn	Цай Инвэнь
Chełm	Хелм
Pha̍k-ngìn	Белые люди
Â-ha̍p-vòng	Ахав
Suwałki	Сувалки
Ngì-làn-yen	Илань (Тайвань)
Sî-làn-ngî	Зеландский диалект
Maidenhead	Мейденхед
Chû Khiet-lùn	Чоу, Джей
Winburg	Винбург
Kiú-liùng	Коулун
Nâ-pô-nì-tha̍t	Набонид
Kiap-kông-yen	Цзяцзян
Ngie-mí-li-ôn Lò-mâ-nok-ngî	Эмилиано-романьольское наречие
Sîn-pet-sṳ	Синьбэй
Hî-sî-kâ-vòng	Езекия
Thòi-chûng-sṳ	Тайчжун
IPhone 4S	IPhone 4s
Jędrzejów	Енджеюв
Fâ-lièn-yen	Хуалянь (уезд)
Kîm-mùn-yen	Цзиньмэнь
Thòi-tûng-yen	Тайдун (уезд)
Sîn-chuk-sṳ	Синьчжу
Kâ-ngi-sṳ	Цзяи
Kî-lùng-sṳ	Цзилун
Pet-thèu-khî (Thòi-pet-sṳ)	Бэйтоу
Thai-ôn-khî (Thòi-pet-sṳ)	Даань (Тайбэй)
Sṳ-lìm-khî (Thòi-pet-sṳ)	Шилинь
Busko-Zdrój	Буско-Здруй
Àu-thai-li-â Ngièn	Австралийский доллар
Mò Chhiang-li ke Thung-vu̍t	Нечистые животные
Kroonstad	Крунстад
Hon-ho̍k	Синология
Thai-thùng-khî (Thòi-pet-sṳ)	Датун (Тайбэй)
Nui-fù-khî (Thòi-pet-sṳ)	Нэйху
Yî-pó-sṳ	Ипох
Ná-pô-pha-lâ-sâ-ngì	Набопаласар
Â-pí-ngâ-vòng	Авия
Sûn N̂g	У (Троецарствие)
Pha̍k-chhu̍k	Бай (народ)
Pińczów	Пиньчув
Aalten	Алтен
Xuxa	Шуша (певица)
Hajnówka	Хайнувка
Lubartów	Любартув
Lucélia Santos	Сантус, Луселия
Montréal-tó	Монреаль (остров)
IPhone 3GS	IPhone 3GS
IPhone 4	IPhone 4
IPhone 3G	IPhone 3G
Tûng-Chû	Восточная Чжоу (династия)
Mâ-lòi-sî-â Hòng-khûng	Malaysia Airlines
Lì-tshu̍k	Ли (народ)
Chûng-sî-khî (Hiông-kóng)	Центральный и Западный округ Гонконга
Mí-nâ-hien-vòng	Менахем
Â-ha̍p-chhia-vòng (Yî-set-lie̍t)	Охозия (царь Израиля)
Â-ha̍p-chhia-vòng (Yù-thai)	Охозия (царь Иудеи)
Yok-làn-vòng (Yù-thai)	Иорам (царь Иудеи)
Â-sat-li-ngâ	Озия
Peter Nalitch	Налич, Пётр Андреевич
Yâ-lò-pô-ôn yit-sṳ	Иеровоам I
Am-li-vòng	Омри
Nâ-tap-vòng	Надав
Pâ-sâ-vòng	Бааша
Yâ-fu-vòng	Иегу
Yok-sî-â-vòng	Иосия
Yok-â-sṳ̂-vòng (Yù-thai)	Иоас (царь Иудеи)
Sîm-li-vòng	Зимри
Yâ-lò-pô-ôn ngi-sṳ	Иеровоам II
Yî-vi-mí-lò-tha̍t	Амель-Мардук
Â-mâ-chhia-vòng	Амасия (царь Иудеи)
Yî-sṳ̂-pô-sat-vòng	Иевосфей
N̂g Chok-tùng	Го Чок Тонг
Â-sat-vòng	Аса
Â-mùn-vòng	Амон (царь Иудеи)
Chong Koet-yùng（Chong Fat-chûng）	Чун, Лесли
Lí Tên-Fî	Ли Дэнхуэй
Yî-lâ-vòng	Эла
Yok-ngâ-kin-vòng	Иоаким (царь Иудеи)
Hò-se-â-vòng	Осия (царь Израиля)
Yok-ngâ-kîn-vòng	Иехония
Biłgoraj	Билгорай
Chhî Chai-Phit	Со Джэпхиль
Puławy	Пулавы
Chuk Hon	Шу (царство)
Chhâu Ngùi	Вэй (Троецарствие)
Abitibi-Témiscamingue	Абитиби — Темискаминг
Staszów	Сташув
Iwakuni-sṳ	Ивакуни
Kâu-thûng kûng-khí	Виды транспорта
Phok Hièn-yún	Пак Хон Ён
Sat-kâ-li-ngâ-vòng	Захария (царь Израиля)
Yok-ha̍p-sṳ̂-vòng	Иоахаз (царь Израиля)
Fùng Siù-chhiòn	Хун Сюцюань
Yok-â-sṳ̂-vòng (Yî-set-lie̍t)	Иоас (царь Израиля)
Yok-làn-vòng (Yî-set-lie̍t)	Иорам (царь Израиля)
Pí-kâ-vòng	Факей
Sâ-liùng-vòng	Шалум
Pí-kâ-hot-vòng	Факия (царь Израиля)
Khiu Sṳ̀n-thûng	Яу Шинтан
Fùng Puk-kím Kiê	Золотой фазан
Grajewo	Граево
Sat-lâ-tshu̍k	Салары
Yok-ha̍p-sṳ-vòng	Иоахаз (царь Иудеи)
Łapy	Лапы
Sin-ngióng	Невеста
Chhiâng-pa̍k-kông-khî	Цинбайцзян
瑤族	Яо (народ)
Hagi-sṳ	Хаги
Wong Hi-zi	Ван Сичжи
Chûng-chhiû-chiet	Праздник середины осени
Nài-lî-kak-li-sâ-ngì	Нергал-шар-уцур
Fùng-theu	Адзуки
Łuków	Лукув
Łęczna	Ленчна
Świdnik	Свидник (Польша)
Pô-sṳ̂ Ti-koet	Держава Ахеменидов
Nagato-sṳ	Нагато (город)
Mâ-thai-fuk-yîm	Евангелие от Матфея
Sṳ̍p-sṳ-ka	Крест в христианстве
Â-chû Hòng-khûng X	AirAsia X
Â-chû Hòng-khûng	AirAsia
Yî-fut-só-sû	Послание к Ефесянам
Sòng-tet-sṳ	Чандэ
Yit-yòng-sṳ	Иян
Chhim-chû-sṳ	Чэньчжоу
Tshî Kông-khí	Сюй Гуанци
Sàng-khî (San-mî-sṳ)	Чэнцюй
Súi-nèn-sṳ	Суйнин (городской округ)
Nui-kông-sṳ	Нэйцзян
Tha̍t-chû-sṳ	Дачжоу
Ngá-ôn-sṳ	Яань
10000	10 000 (число)
Fú-kûa	Момордика харанция
Fún-fùng-set	Розовый цвет
Nâ-sat-le̍t	Назарет
Thòi-vân kâu-thûng	Транспорт в Китайской Республике
Yî-tshu̍k	И (народ)
Â-thâ-li-ngâ	Гофолия
Augustów	Августов
Windsor, Berkshire	Виндзор
Kô Khô-kî	Высокие технологии
Tai Tet-sâng	Тейлор, Хадсон Джеймс
Hòn Hòn	Хань Хань
Tczew	Тчев
Hâ-nì-tshu̍k	Хани (народ)
Fù-chṳ-mìn-sṳ Kî-chhòng	Таншоннят
Hien-thoi Accent	Hyundai Accent
Hien-thoi Sonata	Hyundai Sonata
Hien-thoi Elantra	Hyundai Elantra
Hien-thoi Equus	Hyundai Equus
Vû-tsṳ-phe̍t-khiet-chhu̍k	Узбеки
Hien-thoi Genesis Coupé	Hyundai Genesis Coupe
Thap-kit-khiet-tshu̍k	Таджики
Wal-Mart Kûng-sṳ̂	Wal-Mart Stores
緋彈个婭里婭	Aria the Scarlet Ammo
Yùn-tôn yun-son	Облачные вычисления
Ńg-sùn-chiet Yun-thung	Пятидесятники
Liu̍k-theu	Маш
Chêu-siên-chhu̍k	Корейцы
Khúa-ngì-khiet-tsṳ-tshu̍k	Киргизы
Burgo de Osma-Ciudad de Osma	Бурго-де-Осма-Сьюдад-де-Осма
Sông-hói Ha̍p-tsok Tsû-tsṳt	Шанхайская организация сотрудничества
Reus	Реус
San Esteban de Gormaz	Сан-Эстебан-де-Гормас
Hien-thoi Santa Fe	Hyundai Santa Fe
Het-mien Phî-lù	Малая колпица
Sṳ̀n-chheu-fi	Ассамблеи Бога
Phok Chhùng-yòng	Пак Чжон-ян
Sâ-â-nàm	Шах-Алам
Kit-lùng-po Koet-chi Kî-chhòng	Куала-Лумпур (аэропорт)
Ngiu̍k-Sân	Юйшань
Hōfu-sṳ	Хофу
Thai-yí-sân	Лантау
Starogard Gdański	Старогард-Гданьский
Het-tsat-tshu̍k	Нанайцы
Sîn-chhèu	Синь (династия)
Mauricie	Мориси
Strzelce Opolskie	Стшельце-Опольске
Hò-làn Tâi-thi Sat-khiet-sêm-ngî	Нижнесаксонские диалекты Нидерландов
Kâu-thûng	Безрельсовый транспорт
Vû-yìn	Настоящие мухи
Tha̍t-mâ-thai	Далмация
Witwatersrand Thai-ho̍k	Витватерсрандский университет
Hà (Sṳ̍p-liuk-koet)	Ся (государство)
Sîn-chîn-yen	Синьцзинь
Mâ-lî-sûn	Моррисон, Роберт
Fû-lùn-pi-ngì-sṳ	Хулун-Буир
Ngo̍k-vûn-khiet-tshu̍k Tshṳ-tshṳ-khî	Эвенкийский автономный хошун
Ǹg-chiu-sṳ	Учжоу
Fòng-sàng-kóng-sṳ	Фанчэнган
Khîm-chiu-sṳ	Циньчжоу
Kui-kóng-sṳ	Гуйган
Ngiu̍k-lìm-sṳ	Юйлинь (Гуанси)
Pak-set-sṳ	Байсэ
Fo-chiu-sṳ	Хэчжоу
Hò-chhṳ̀-sṳ	Хэчи
Lòi-pîn-sṳ	Лайбинь
Chhùng-chó-sṳ	Чунцзо
Thú-kâ-tshu̍k	Туцзя (народ)
Sîn-kie	Новые Территории (Гонконг)
Tsit-sa̍k-sân Pó-ôn-tshu̍k Tûng-hiông-tshu̍k Sat-lâ-tshu̍k Tshṳ-tshṳ-yen	Цзишишань-Баоань-Дунсян-Саларский автономный уезд
Mo-yi	Торговля
Kędzierzyn-Koźle	Кендзежин-Козле
Kóng-hon-sṳ	Гуанхань
Meu-yen	Маосянь
Ôn-hâi-yen	Аньси
Duiven	Дёйвен (община)
Yo̍k-ho̍k	Фармация
Chhiâng-yòng-khî	Цинъян (Чэнду)
Kóng-tó-yen	Хиросима (префектура)
Thu̍k-liùng-tshu̍k	Дулуны
Tseu-tshu̍k	Цзоу
IPhone (Thi-yit thoi)	IPhone (первого поколения)
Ye̍t-nàm-ngî sṳ-mû	Куокнгы
Ólvega	Ольвега
Sîn Pâ-pí-lùn Vòng-koet	Нововавилонское царство
Fuk-tín-sṳ	Фудин
Thú-ngí-khì-ngî sṳ-mû	Турецкая письменность
Shūnan-sṳ	Сюнан
Skarżysko-Kamienna	Скаржиско-Каменна
Longás	Лонгас
Kô-tá-ha̍p-lû-sṳ	Кота-Бару
Kông-phú	Спектр
Chhṳ̂m-súi-phu-khî	Самсёйпоу
Mielec	Мелец
客家	Хакка (народ)
Vù-kau-piáng	Лепёшка
Téu-liuk-sṳ	Доулю
Wejherowo	Вейхерово
Pu-yî-chhu̍k	Буи (народ)
Mí-yi-yen	Мии (Паньчжихуа)
Ngì-làn-sṳ	Илань (Илань)
Ńg-fù Sṳ̍p-liuk-koet	Шестнадцать варварских государств
Néu-yok Tû-fi-khî	Нью-Йоркская агломерация
歷峯雧團	Richemont
Lanaudière	Ланодьер
Thap-lùn-ti-nò-ngî	Тарантинский язык
Chhṳ̀n Kâ-fà	Чэнь, Элла
Mâ-kûng-sṳ	Магун
Tshu-theu-fú	Вонючий тофу
Thai-pó-sṳ	Тайбао
Sû-o-tsṳ́n	Суао
Làn-yí	Лань (остров)
Mèu-li̍t-sṳ	Мяоли
Thai-ngâ-tshu̍k	Атаял
Joy	Joy (группа)
Lu̍k-kóng-tsṳ́n	Луган
Pu-nùng-tshu̍k	Бунун
Ǹg-yèn	Рыбные шарики
Chhṳ̀-hâi-sṳ	Цыси (город)
Pî-nàm-tshu̍k	Пуюма
Tha̍t-ngu-tshu̍k	Ями (народ)
Ngit-chhut-khòng-sàng	LOHAS Park
Mà-theu-tsṳ́n	Мадоу
Theui-waan Thin-get Lin-mang	Тайваньский Союз солидарности
Thai-lû-kok Koet-kâ Kûng-yèn	Тароко (национальный парк)
Â-lî-sân Koet-kâ Sêm-lìm Yù-lo̍k-khî	Алишань
Khén-tên Koet-kâ Kûng-yèn	Кэньдин (национальный парк)
Siet-pa Koet-kâ Kûng-yèn	Шэйпа (национальный парк)
Yòng-mìn-sân Koet-kâ Kûng-yèn	Янминшань (национальный парк)
Phìn-fông Kûng-lî	Квадратный километр
Lu̍k-kuk-hiông	Лугусян
Fâ-lièn-sṳ	Хуалянь
Phìn-tsṳ́n-sṳ	Пинчжэнь
Phìn-tûng-sṳ	Пиндун
Thòi-tûng-sṳ	Тайдун
Chùng-chṳ́	Цзунцзы
Thòi-fûng Mo̍k-Là-Khiet (2009-ngièn)	Моракот (тайфун)
Thòi-pet Tshia̍p-yun	Тайбэйский метрополитен
Kôn-yîm	Гуаньинь
Nàm-thèu-sṳ	Наньтоу
Phài-vân-tshu̍k	Пайвань
Thòi-vân nàm-tó ngî-ngièn	Тайваньские языки
Lìm-pâ Se-pâu	Лимфоциты
Thai-ngâ-ngî	Атаяльский язык
Thò-yèn-sṳ	Таоюань
Lû-khái-tshu̍k	Рукаи
Tseu-ngî	Цзоу (язык)
Pî-nàm-ngî	Пуюма (язык)
Hak-kâ thú-lèu	Тулоу
Khòng-sàng-chhàm (Hiông-kóng)	ЛОХАС-Парк (станция метро)
100000	100 000 (число)
Kô-sîn-shì	Ку (император)
Jarosław	Ярослав (город)
Tûng-khî (Hiông-kóng)	Восточный округ Гонконга
Â-chû Thien-sṳ Yû-han Kûng-sṳ̂ (Hiông-kóng)	Asia Television Limited
Gaspésie–Îles-de-la-Madeleine	Гаспези — Острова Мадлен
Ostrowiec Świętokrzyski	Островец-Свентокшиский
Tshiâ-tshu̍k	Шэ (народ)
Sîn-kâ-po Koet-li̍p Thai-ho̍k	Национальный университет Сингапура
Chojnice	Хойнице
Bronckhorst	Бронкхорст (община)
Thi-kip-sṳ	Городской округ (КНР)
Mine-sṳ	Мине
Mì-fûn-ho̍k	Дифференциал (математика)
Tûng-hiông-tshu̍k	Дунсян
Lâ-fú-tshu̍k	Лаху (народ)
Włodawa	Влодава
Starachowice	Стараховице
Stalowa Wola	Сталёва-Воля
Chat-ho̍k Pok-sṳ	Доктор философии
Lì-tó-khî	Айлендс (Гонконг)
Ermelo	Эрмело
Thông-phûng	Пчёлы настоящие
Tshûng-shîn-yen	Окинава (префектура)
Tshòng-lo̍k-sṳ	Чанлэ (Фучжоу)
Nàm-thin-sṳ	Намдинь
Końskie	Коньске
Luceni	Лусени
Fà-khièu	Хуацяо
Madrid Chhṳ-chhṳ Thai-ho̍k	Мадридский автономный университет
Tshṳ-tshṳ-chû	Автономный округ (КНР)
Medway	Медуэй (унитарная единица)
Nysa, Pô-làn	Ныса (город)
Belver de Cinca	Бельвер-де-Синка
Pó-ôn-chhu̍k	Баоань (народ)
Culemborg	Кулемборг
Kôan-tan-sṳ	Куантан
Sokółka	Сокулка
Thâu-thông-shì	Яо (император)
Hikari-sṳ	Хикари
Krosno	Кросно
Kûng-lî	Километр
Almarza	Альмарса
Aldealices	Альдеалисес
Aldealafuente	Альдеалафуэнте
Alentisque	Алентиске
Adradas	Адрадас
Alconaba	Альконаба
Abejar	Абехар
Aldealpozo	Альдеальпосо
Alcubilla de las Peñas	Алькубилья-де-лас-Пеньяс
Aldealseñor	Альдеальсеньор
Alcubilla de Avellaneda	Алькубилья-де-Авельянеда
Covaleda	Коваледа
Almazul	Альмасуль
Arcos de Jalón	Аркос-де-Халон
Aldehuela de Periáñez	Альдеуэла-де-Перианьес
Almenar de Soria	Альменар-де-Сория
Vinuesa	Винуэса
Duruelo de la Sierra	Дуруэло-де-ла-Сьерра
San Leonardo de Yagüe	Сан-Леонардо-де-Ягуэ
Shâu-sân-sṳ	Шаошань
Tai-tshu̍k	Дайцы
Mùn-pâ-tshu̍k	Монпа
Kudamatsu-sṳ	Кудамацу
Kiong-tshu̍k	Цян (народ)
Afrikaner-ngìn	Африканеры
Ngá-tshu̍k	Ва
Brummen	Брюммен
Fû-yûng-sṳ	Серембан
Jasło	Ясло
Â-chhông-chhu̍k	Ачаны
Bielsk Podlaski	Бельск-Подляски
Beuningen	Бёнинген
Thú-tshu̍k	Монгоры
Sîn-lòng	Жених
Pân-kap	Крапчатый голубь
Súi-tshu̍k	Шуйцы
Nyet-láu-tshu̍k	Гэлао (народ)
Kín-phó-tshu̍k	Качины
Lo̍k-pâ-tshu̍k	Лоба (народ)
Li̍t-siuk-tshu̍k	Лису (народ)
Vì-kî Pak-khô Ngî-ngièn Lie̍t-péu	Википедия:Список Википедий
Siên-pî-chhu̍k	Сяньби
Sanyo-Onoda-sṳ	Санъёонода
Fap-ho̍k	Юридическое образование
Pet-khî (Hiông-kóng)	Северный округ Гонконга
Mô-nàm-tshu̍k	Маонань
Nu-tshu̍k	Ну (народ)
Mu̍k-láu-tshu̍k	Мулао
Sî-sûng-pán-na̍p Thài-tshu̍k Tshṳ-tshṳ-chû	Сишуанбаньна-Дайский автономный округ
Ngièn-lóng-khî	Юньлон
Kôn-thòng-khî	Куньтхон
Khwûi-tshiâng-khî	Кхуайчхин
Phù-mí-tshu̍k	Пуми (народ)
Thai-pu-khî	Тайпоу
Tet-ngo-tshu̍k	Палаунг
Vòng-thai-siên-khî	Вонтайсинь
Tshiên-vân-khî	Чхюньвань
Pu-lóng-chhu̍k	Буланы
Bracknell Sêm-lìm	Бракнелл-Форест
Mìn-chú Chin-phu-tóng	Демократическая прогрессивная партия
Tomaszów Lubelski	Томашув-Любельский
Hrubieszów	Грубешов
Pet Québec Thi-khî	Север Квебека
Montérégie	Монтережи
Hói-nàm-fa	Хайнаньский язык
Chhièn-Liòng	Ранняя Лян
Dębica	Дембица
Québec-ngìn Tóng	Квебекская партия
Grahamstown	Грэхэмстаун
Cape Town Thai-ho̍k	Кейптаунский университет
Sasolburg	Сасолбург
Kraśnik	Красник
Dęblin	Демблин
Radzyń Podlaski	Радзынь-Подляский
Thûn-mùn-khî	Тхюньмунь
Kiú-liùng-sàng-khî	Коулун-Сити
Nàm-khî (Hiông-kóng)	Южный округ Гонконга
Vân-chái-khî	Ваньчай
Prudnik	Прудник
Villanueva de Sigena	Вильянуэва-де-Сихена
Tân-vi	Единица
Stockton-on-Tees	Стоктон-он-Тис
Sî-Liòng	Западная Лян (400—421)
Kô-lò-sî	Колоссы
Khiâm-nàm Pu-yî-tshu̍k Mèu-tshu̍k Tshṳ-tshṳ-chû	Цяньнань-Буи-Мяоский автономный округ
Lìm-ha Fì-tshu̍k Tshṳ-tshṳ-chû	Линься-Хуэйский автономный округ
Graaff-Reinet	Храфф-Рейнет
Orania	Орания
Yì-yâu-sṳ	Юйяо
Â-pa Chhong-chhu̍k Kiông-chhu̍k Chhṳ-chhṳ-chû	Нгава-Тибетско-Цянский автономный округ
Vong-kok Tshàm(MOK)	Вонкок (станция метро)
Welkom	Велком (город)
Hoedspruit	Хоэдспруит
Vryheid	Фрейхейд
Swellendam	Свеллендам
Tû-kông-yén-sṳ	Дуцзянъянь (Чэнду)
Mo̍k-li̍t Tha̍t-ngá Tha̍t-vat-ngì-tshu̍k Tshṳ-tshṳ-khì	Морин-Дава-Даурский автономный хошун
Liùng-hói-sṳ	Лунхай
Lói-yòng-sṳ	Лэйян
Hói-shù-khî	Хайшу
Phî-yen	Писянь
Sîn-tû-khî	Синьду
Sṳ̍p-fong-sṳ	Шифан
Vi	Желудок человека
Liùng-hâ	Омары
Kî-nok-tshu̍k	Цзино (народ)
Ngo̍k-lùn-tshùn-tshu̍k	Орочоны
Chaudière-Appalaches	Шодьер — Аппалачи
Sî-Chû	Западная Чжоу (династия)
Liông (Nàm-chhèu)	Лян (династия)
Sṳ̀n-Hòn	Чэн
Chhùng-chû-sṳ	Чунчжоу
Christiana (Nàm-fî)	Христиана
Pet-ngan Thi-khî (Québec)	Кот-Нор
Mí-nàm-kâ-pó-ngìn	Минангкабау (народ)
Néu-yok-kóng	Нью-Йоркская бухта
Tha̍k-é	Ди (музыкальный инструмент)
Sâ-vân-khî	Шавань (Лэшань)
Thûng-chhôn-khî	Тунчуань (район)
Sṳ-chûng-khî (Lo̍k-Sân-sṳ)	Шичжун (Лэшань)
Mâ-piên Yì-chhu̍k Chhṳ-chhṳ-yen	Мабянь-Иский автономный уезд
Tí-chhu̍k	Ди (Сычуань)
Chiáng-ngân-yen	Цзинъянь
Khien-vì-yen	Цяньвэй
Ńg-thûng-khiàu-khî	Утунцяо
Khì-yen	Цюйсянь
Sun-khin-khî	Шуньцин
Kô-phiàng-khî	Гаопин (Наньчун)
Mu̍k-chhôn-yen	Мучуань
Mòi-yen	Мэйсянь (Гуандун)
Sâm-kông Thûng-chhu̍k Chhṳ-chhṳ-yen	Саньцзян-Дунский автономный уезд
Na̍p-hâi-khî	Наси (район)
Mièn-chuk-sṳ	Мяньчжу
Khiûng-lôi-sṳ	Цюнлай
Àu-choi Fôn	Седлоклювый ябиру
Tûng-khî (Pan-kî-fâ-sṳ)	Дунцюй (Паньчжихуа)
Kî-chhòng	Аэропорт
Téu-mùn-khî	Доумэнь
Tsen-zi-wun	Тысячесловие
Lî Ngâ-kok	Легг, Джеймс
Yen	Уезды КНР
Lò-kông-yen	Лоцзян
Nàm-Yèn	Южная Янь
Nàm-Liòng	Южная Лян
Ngò-mì-sân-sṳ	Эмэйшань (городской уезд)
Liùng-mâ-thâm-khî	Лунматань
Yùng-yen (Chhṳ-kung-sṳ)	Жунсянь (Цзыгун)
Lû-yen	Лусянь
Chin-yòng-khî	Цзинъян (Дэян)
Kung-chiáng-khî	Гунцзин
Kú-nìn-yen	Гулинь
Yàm-piên-yen	Яньбянь
Sî-khî (Pan-kî-fâ-sṳ)	Сицюй (Паньчжихуа)
Sé-kiok-lî	Омовение ног
Phû-kông-yen	Пуцзян (Чэнду)
Kîm-thòng-yen	Цзиньтан
Vûn-kông-khî	Вэньцзян
Vú-hêu-khî	Ухоу
Liùng-chhièn-yi̍t-khî	Лунцюаньи
Kîm-ngiù-khî	Цзиньню
Kím-kông-khî	Цзиньцзян (Чэнду)
Phàng-chû-sṳ	Пэнчжоу
Kông-tûng-khî (Nèn-pô-sṳ)	Цзяндун
Chûng-koet Ngò-lò-sṳ̂-tshu̍k	Русские в Китае
Windsor lâu Maidenhead	Виндзор и Мейденхед
Fuk-ôn-sṳ	Фуань
Thí-ngoi Mo̍k-yòng-ha̍p	Экстракорпоральная мембранная оксигенация
Lìm Tan	Линь Дань
分類:Tet-koet	Категория:Германия
分類:Yi-thai-li	Категория:Италия
分類:Kâ-nâ-thai	Категория:Канада
分類:Sî-pân-ngà	Категория:Испания
分類:Chûng-koet	Категория:Китай
分類:Ngi̍t-pún	Категория:Япония
分類:Àu-thai-li-â	Категория:Австралия
分類:Yin-thu	Категория:Индия
分類:Yî-set-lie̍t	Категория:Израиль
分類:Nàm-fî	Категория:ЮАР
Thiên-sái (Hiông-kóng)	Башни Куллинан
Redcar and Cleveland	Редкар и Кливленд
分類:Yin-thu-nì-sî-â	Категория:Индонезия
分類:Pâ-kî-sṳ̂-thán	Категория:Пакистан
分類:Pô-làn	Категория:Польша
分類:Sîn-kâ-po	Категория:Сингапур
分類:Hòn-koet	Категория:Южная Корея
分類:Thai-koet	Категория:Таиланд
分類:Ye̍t-nàm	Категория:Вьетнам
分類:Phú-nen-lui	Категория:Млекопитающие
分類:Tiâu	Категория:Птицы
分類:Chhṳ̍t-vu̍t	Категория:Растения
分類:Vu̍t-lí-ho̍k	Категория:Физика
分類:Chhṳ-yèn Khô-ho̍k	Категория:Естественные науки
分類:Sâng-vu̍t-ho̍k	Категория:Биология
分類:Fa-ho̍k	Категория:Химия
分類:Li̍t-sṳ́	Категория:История
分類:Thi-lî	Категория:География
分類:Sa-fi	Категория:Общество
分類:Chûng-kau	Категория:Религия
分類:Thí-yuk	Категория:Спорт
分類:Khô-ho̍k	Категория:Наука
分類:Lièn-ha̍p-koet	Категория:ООН
分類:Êu-chû Lièn-mèn	Категория:Европейский союз
分類:Kien-chuk-vu̍t	Категория:Здания и сооружения
分類:Thûng-sin	Категория:Связь
分類:Thi-khiù	Категория:Земля
Chhièn-Chhîn	Ранняя Цинь
Chhièn-Yèn	Ранняя Янь
Sî Berkshire	Западный Беркшир
Hiông-kóng Thiet-lu Yû-han Kûng-sṳ̂	MTR Corporation
Heu-Yèn	Поздняя Янь
Pet-Liòng	Северная Лян
Chhièn-Chhàu	Северная Хань
Zuera	Суэра
Langa del Castillo	Ланга-дель-Кастильо
Contamina	Контамина
Louis Trichardt	Луис-Тричард
Abiego	Абьего
Abanto	Абанто
Sî-Chhîn	Западная Цинь
Heu-Chhîn	Поздняя Цинь
Kú Lò-mâ	Древний Рим
La Fueva	Ла-Фуэва
Ibanag-ngî	Ибанаг
Sân-thi-mâ-lî-ngî	Горномарийский язык
Tsui-heu ke Sṳ́m-phan	Страшный суд
Middelburg, Mpumalanga-sén	Мидделбург (Мпумаланга)
Sat-mû-ngí-ki-song	Первая книга Царств
分類:Chet-ho̍k	Категория:Философия
分類:Fu̍t-kau	Категория:Буддизм
分類:Kî-tuk-kau	Категория:Христианство
分類:Yù-thai-kau	Категория:Иудаизм
Ventersdorp	Вентерсдорп
Pet-Yèn	Северная Янь
Sià-ok Sṳn-kîn	Злая Библия
Ên-tiâu	Орлиные
Heu-Liòng	Поздняя Лян
Heu-Chhàu	Поздняя Чжао
Bochotnica	Бохотница
Jagersfontein	Яхерсфонтейн
Zung-kok tsen-thung zit-nit	Традиционные китайские праздники
Viljoenskroon	Фильюнскрун
琴浦同學	Kotoura-san
分類:Hàng-sên	Категория:Планеты
分類:Vùn-fa	Категория:Культура
分類:Ngìn-vùn Khô-ho̍k	Категория:Гуманитарные науки
分類:Tî-sṳt	Категория:Знание
Chṳ́-set	Пурпурный цвет
Ngiu̍k-sân Koet-kâ Kûng-yèn	Юйшань (национальный парк)
Steynsrus	Стейнсрюс
Ap-è	Утки
Lù-tshṳ̀	Баклановые
分類:Yên-yèn	Категория:Актёры
模板:Tl	Шаблон:Tl
模板:Userbox	Шаблон:Userbox
模板:Wikipedialang	Шаблон:Wikipedialang
分類:Koet-kâ	Категория:Страны
Wikipedia:Kón-lî-yèn	Википедия:Администраторы
分類:Chûng-fà Mìn-chhu̍k	Категория:Народы Китая
分類:Ngìn-vu̍t	Категория:Люди
分類:Mìn-chhu̍k	Категория:Народы
Wikipedia:Hàng-tsṳn-yèn	Википедия:Бюрократы
Wikipedia:IP chhà-fûng li-ngoi-chá	Википедия:Исключение из IP-блокировок
Wikipedia:Kî-hi-ngìn	Википедия:Бот
分類:Sṳ̀-kiên	Категория:Время
分類:Chhṳ-yèn	Категория:Природа
分類:Kûng-chhàng	Категория:Инженерия
分類:Yî-ho̍k	Категория:Медицина
分類:Chṳn-chṳ	Категория:Политика
分類:Kau-yuk	Категория:Образование
分類:Kông-ho̍k	Категория:Оптика
Âi-khi̍p	Египет
分類:Chat-ho̍k-kâ	Категория:Философы
模板:Bot	Шаблон:Bot
Kâ-nâ-thai	Канада
分類:Hiûng-ngà-li	Категория:Венгрия
分類:Hî-lia̍p	Категория:Греция
分類:Lâ-thot-vì-â	Категория:Латвия
分類:Yù-hi	Категория:Игры
Thiên-koet	Небеса
Zong Thaai-pheng	Чжан Дапэн, Иосиф
分類:Êu-chû koet-kâ	Категория:Страны Европы
分類:Êu-chû	Категория:Европа
模板:Documentation	Шаблон:Doc
Wikipedia:Yung-fu	Википедия:Права участников
Pok-sṳ	Доктор (звание)
Wikipedia:Sa-khî	Википедия:Портал сообщества
分類:Wikipedians by language	Категория:Википедия:Участники по языкам
Sṳ̀n Chhai-kî	Сон Джэги
Ngiù-è	Крупный рогатый скот
Khi-néu Kî-chhòng	Узловой аэропорт
Khî-ngia̍p	Предпринимательство
Ngiuk-yèn	Тефтели
模板:Softredirect	Шаблон:Soft redirect
模板:Delete	Шаблон:К быстрому удалению
分類:Kî-su̍t	Категория:Технология
分類:Ngî-ngièn	Категория:Языки
Wikipedia:Chhóng-kien Sîn Thiàu-muk	Википедия:Как создать статью
分類:還無索引嘅頁面	Категория:Неиндексируемые страницы
分類:含有損壞文件鏈接嘅頁面	Категория:Страницы со ссылками на отсутствующие файлы
模板:Navbox	Шаблон:Navbox
Thoi-chhú	Кенгуру
Pak-ha̍p-fâ	Лилия
模板:!-	Шаблон:!-
模板:Tnavbar	Шаблон:Tnavbar
模板:Unicode	Шаблон:Unicode
模板:Smallcaps	Шаблон:Smallcaps
模板:Small	Шаблон:Small
模板:Nowrap	Шаблон:Nobr
分類:Fî-chû	Категория:Африка
分類:Chhṳ-yù Pâng-sén	Категория:Фри-Стейт
分類:Tûng Khôi-phú-sén	Категория:Восточная Капская провинция
分類:Gauteng-sén	Категория:Гаутенг
分類:KwaZulu-Natal-sén	Категория:Квазулу-Натал
分類:Mpumalanga-sén	Категория:Мпумаланга
分類:Sṳn-kîn	Категория:Библия
分類:Limpopo-sén	Категория:Лимпопо
分類:Sî Khôi-phú-sén	Категория:Западно-Капская провинция
分類:Sî-pet-sén	Категория:Северо-Западная провинция
分類:Si	Категория:Книги
模板:Pâ-phe̍t	Шаблон:Babel
模板:Reflist	Шаблон:Примечания
模板:Stub	Шаблон:Заготовка
模板:User ca-1	Шаблон:User ca-1
模板:User de	Шаблон:User de
模板:User de-1	Шаблон:User de-1
模板:User en-3	Шаблон:User en-3
模板:User en-1	Шаблон:User en-1
模板:User en-2	Шаблон:User en-2
模板:User en-4	Шаблон:User en-4
模板:User en-0	Шаблон:User en-0
模板:User en	Шаблон:User en
模板:User de-2	Шаблон:User de-2
模板:User fr-2	Шаблон:User fr-2
模板:User ja-1	Шаблон:User ja-1
模板:User fr	Шаблон:User fr
模板:Location map/Info	Шаблон:ПозКарта/Инфо
分類:Khûn-chhùng	Категория:Насекомые
分類:Â-chû	Категория:Азия
分類:Chṳ-li	Категория:Чили
分類:Nàm-mî-chû	Категория:Южная Америка
分類:Khà-sṳ̂-tì-li-â lâu Lòi-ngong	Категория:Кастилия и Леон
模板:Esoteric	Шаблон:Эзотерика
分類:Mâ-lòi-sî-â	Категория:Малайзия
分類:Sṳ̍t-phín	Категория:Пища
模板:Mod	Шаблон:Mod
模板:User es-2	Шаблон:User es-2
模板:Fôn-ngiàng	Шаблон:Приветствие
分類:Thiàu-mi-liau	Категория:Приправы
分類:Chû-chṳt	Категория:Организации
分類:Ngî-ngièn-ho̍k	Категория:Лингвистика
模板:ITA	Шаблон:ITA
模板:非洲行政區劃	Шаблон:Страны Африки
模板:SVK	Шаблон:SVK
模板:Infobox Country	Шаблон:Государство
模板:TUR	Шаблон:TUR
分類:User en-4	Категория:User en-4
分類:User en	Категория:User en
分類:User zh	Категория:User zh
分類:User zh-N	Категория:User zh-N
分類:User en-2	Категория:User en-2
模板:User zh	Шаблон:User zh
模板:Cite web	Шаблон:Cite web
模板:Ombox	Шаблон:Ombox
分類:Hòng-khûng	Категория:Авиация
分類:Yím-sṳ̍t	Категория:Еда и напитки
模板:Fong-wui	Шаблон:Стороны света
模板:BS3	Шаблон:BS3
分類:Tsúng-thúng	Категория:Президенты государств
模板:IPA	Шаблон:IPA1
分類:Chṳn-chṳ Ngìn-lui	Категория:Политики
分類:Mî-chû	Категория:Америка
模板:其他	Шаблон:Другие значения
分類:Language user templates	Категория:Шаблоны участников:По языкам
模板:Topicon	Шаблон:Right-uppermost image
模板:Fmbox	Шаблон:Fmbox
模板:大洋洲行政區劃	Шаблон:Океания
分類:Vùn-ho̍k-kâ	Категория:Писатели
分類:Kiûn-sṳ	Категория:Вооружённые силы
分類:Thai-ho̍k	Категория:Университеты
模板:Country data Malaysia	Шаблон:Флагификация/Малайзия
模板:Lang-he	Шаблон:Lang-he
模板:Both	Шаблон:Both
分類:Sṳ-kie Pok-lám-fi	Категория:Всемирные выставки
分類:Chûng-fà Ngìn-mìn Khiung-fò-koet Chú-sit	Категория:Председатели КНР
模板:Documentation subpage	Шаблон:Docpage
分類:Fu̍k-tsông	Категория:Буддийские монахи
模板:FIN	Шаблон:FIN
模板:Purge	Шаблон:Очистить кэш
模板:Lang-de	Шаблон:Lang-de
模板:DNK	Шаблон:DNK
模板:Provinces of China	Шаблон:Провинции КНР
模板:Userpage	Шаблон:Userpage
模板:DEU	Шаблон:DEU
模板:SWE	Шаблон:SWE
分類:Ye̍t-nàm kî-chhòng	Категория:Аэропорты Вьетнама
Kiet-tshòng	Ободочная кишка человека
分類:Kûng-sṳ̂	Категория:Компании
模板:User fr-3	Шаблон:User fr-3
模板:Allcaps	Шаблон:Uppercase
模板:JPN	Шаблон:JPN
分類:Thien-nó	Категория:Компьютеры
模板:MKD	Шаблон:MKD
模板:LTU	Шаблон:LTU
分類:Sṳ-chhòng	Категория:Рынки и базары
Mô-li-ngìn	Маори
模板:Disambig	Шаблон:Неоднозначность
模板:Tick	Шаблон:Ok
分類:Hàng-thung Thien-fa	Категория:Сотовые телефоны
模板:User nan	Шаблон:User nan
模板:GRC	Шаблон:GRC
模板:Lang-grc	Шаблон:Lang-grc
模板:CZE	Шаблон:CZE
模板:Lang-en	Шаблон:Lang-en
分類:Chhòn-ngiam-phiang	Категория:Инфекционные заболевания
分類:Sîn-kau	Категория:Протестантизм
模板:GBR	Шаблон:GBR
分類:Sâng-vu̍t	Категория:Организмы
模板:SVN	Шаблон:SLO
模板:FRA	Шаблон:FRA
模板:User pt-2	Шаблон:User pt-2
分類:Kâ-li-sî-â	Категория:Галисия
模板:歐洲行政區劃	Шаблон:Страны Европы
分類:User yue	Категория:User zh-yue
分類:User fr	Категория:User fr
分類:User ja	Категория:User ja
分類:User pt	Категория:User pt
分類:User nl-3	Категория:User nl-3
分類:User fr-2	Категория:User fr-2
分類:User ja-2	Категория:User ja-2
分類:User ko-N	Категория:User ko-N
分類:User fr-N	Категория:User fr-N
分類:Vùn-sṳ	Категория:Письменность
分類:Tho-kau	Категория:Даосизм
分類:User ca	Категория:User ca
分類:User ca-1	Категория:User ca-1
分類:User de	Категория:User de
分類:User de-2	Категория:User de-2
分類:User de-N	Категория:User de-N
分類:User en-3	Категория:User en-3
分類:User en-N	Категория:User en-N
分類:User es	Категория:User es
分類:User es-2	Категория:User es-2
分類:User es-N	Категория:User es-N
分類:Hiông-kóng Thi-lî	Категория:География Гонконга
模板:Lang-lv	Шаблон:Lang-lv
分類:Yî-set-lie̍t kiûn-vòng	Категория:Цари Израиля
分類:Yù-thai kiûn-vòng	Категория:Цари Иудеи
分類:Kí-hò-ho̍k	Категория:Геометрия
模板:Ye̍t-nàm	Шаблон:Административное деление Вьетнама
分類:User ja-1	Категория:User ja-1
分類:User ko	Категория:User ko
模板:Lang-vi	Шаблон:Lang-vi
分類:Thiên-hi	Категория:Погода
分類:Lièn-ha̍p-koet Pi-sû-chóng	Категория:Генеральные секретари ООН
分類:Hói-yòng	Категория:Моря
分類:Ido-ngî	Категория:Идо
模板:LUX	Шаблон:LUX
分類:Thai-yòng-ne	Категория:Солнечная система
分類:Chhîn-su̍k Ne-thúng	Категория:Родственные отношения
分類:Kóng-tûng-sén	Категория:Гуандун
分類:Fuk-kian	Категория:Фуцзянь
分類:Koet-chi Chû-chṳt	Категория:Международные организации
分類:Fat-mìn-kâ	Категория:Изобретатели
分類:Yím-liau	Категория:Напитки
分類:User nan-N	Категория:User nan-N
分類:Sa-fi Khô-ho̍k	Категория:Общественные науки
分類:Mî-koet Koet-kâ Kûng-yèn	Категория:Национальные парки США
分類:Kô-tén Kau-yuk	Категория:Высшее образование
分類:Thi-hìn	Категория:Формы рельефа
分類:Pâ-lùn-sî-â Chhṳ-chhṳ-khî	Категория:Валенсия
模板:User ja-2	Шаблон:User ja-2
分類:Thiên-chú-kau	Категория:Католицизм
分類:User yue-N	Категория:User zh-yue-N
分類:Yîm-ngo̍k-kâ	Категория:Музыканты
模板:!((	Шаблон:!((
模板:))!	Шаблон:))!
模板:Lang	Шаблон:Lang
分類:Fa-kâ	Категория:Художники
分類:Yin-thu chûng-kau	Категория:Религия в Индии
分類:Ho̍k-su̍t	Категория:Наука и образование
分類:Sa-fi chṳ-thu	Категория:Социальные институты
模板:.w	Шаблон:•wrap
分類:Ngìn-lui	Категория:Человек
模板:CYP	Шаблон:CYP
分類:Yin-thu Thi-lî	Категория:География Индии
分類:Sông-ngia̍p	Категория:Коммерция
分類:Fap-koet fòng-ti	Категория:Императоры Франции
模板:EST	Шаблон:EST
模板:AUT	Шаблон:AUT
分類:Meu-khô	Категория:Кошачьи
分類:Kâ-le̍t-pí-hói	Категория:Карибское море
分類:Thòi-vân Thi-lî	Категория:География Китайской Республики
模板:User zh-3	Шаблон:User zh-3
模板:User zh-4	Шаблон:User zh-4
分類:Nì-pok Thi-lî	Категория:География Непала
分類:Thai-khûng-ngìn	Категория:Космонавты
分類:Chûng-fà Mìn-tshu̍k Tshṳ-tshṳ-chû	Категория:Автономные округа КНР
分類:Khî-ngia̍p-kâ	Категория:Предприниматели
分類:Fî-li̍t-pîn	Категория:Филиппины
分類:User nl	Категория:User nl
分類:User zh-1	Категория:User zh-1
分類:User zh-4	Категория:User zh-4
分類:User zh-3	Категория:User zh-3
分類:User zh-2	Категория:User zh-2
分類:Yin-thu kiûn-chú	Категория:Индийские монархи
分類:Ho̍k-vi	Категория:Учёные степени и звания
分類:Pô-sṳ̂ koet-vòng	Категория:Персидские цари
分類:Kîm-yùng	Категория:Финансы
分類:Chûng-fà mìn-koet tsúng-thúng	Категория:Правители Китайской Республики
分類:Thien-sṳ	Категория:Телевидение
分類:Chhòn-kau-sṳ	Категория:Миссионеры
分類:Hói-hia̍p	Категория:Проливы
粵語	Юэ (язык)
分類:Yin-Êu Ngî-ne	Категория:Индоевропейские языки
分類:Kî-chhòng	Категория:Аэропорты
分類:Fa-ho̍k ngièn-su	Категория:Химические элементы
分類:Khô-ho̍k-kâ	Категория:Учёные
分類:Pâ-kî-sṳ̂-thán Thi-lî	Категория:География Пакистана
分類:Kî-tuk-kau lî-ngì	Категория:Христианское богослужение
分類:Nì-pok	Категория:Непал
分類:Thòi-vân	Категория:Тайвань
分類:Chûng-koet chhèu-thoi	Категория:Китайские династии
分類:Pet-mî-chû koet-kâ	Категория:Страны Северной Америки
分類:Sṳ-tshòi	Категория:Овощи
分類:Súi-kó	Категория:Фрукты
分類:Khiu-yok Sṳn-kîn	Категория:Ветхий Завет
分類:Pok-vu̍t-kón	Категория:Музеи
分類:Hì-hèu	Категория:Климат
分類:Â-chû Thi-lî	Категория:География Азии
分類:Ngìn-lui-ho̍k	Категория:Антропология
分類:Thai-khûng Chhàm	Категория:Орбитальные станции
分類:Fap-koet Thai-ho̍k	Категория:Университеты Франции
模板:ESP	Шаблон:ESP
分類:Thung-vu̍t	Категория:Животные
分類:Chit-chhûi Thung-vu̍t	Категория:Позвоночные
分類:Ngî-yîm-ho̍k	Категория:Фонетика
分類:Hòng-khûng Kûng-sṳ̂	Категория:Авиакомпании
分類:Ngìn-khièn	Категория:Права человека
分類:Ngo̍k-hi	Категория:Музыкальные инструменты
分類:Ngî-ne	Категория:Языковые семьи
分類:Hon-sṳ	Категория:Китайская письменность
分類:Pó-sa̍k	Категория:Драгоценные камни
分類:Koet-kâ Kûng-yèn	Категория:Национальные парки
分類:Hi-siong-ho̍k	Категория:Метеорология
分類:Chûng-mî-chû	Категория:Центральная Америка
分類:Fî-kîm-su̍k	Категория:Неметаллы
分類:Hiông-kóng	Категория:Гонконг
分類:Kóng-sî-sén	Категория:Гуанси-Чжуанский автономный район
分類:Yên-liau	Категория:Топливо
分類:Sông-hói	Категория:Шанхай
分類:Sin-sit kî-su̍t	Категория:Информационные технологии
分類:Ngiuk-lui	Категория:Мясо
分類:Yo̍k-ho̍k	Категория:Фармация
分類:Sú-tû	Категория:Столицы государств
分類:Nàm-Â	Категория:Южная Азия
分類:Kham-thap-pu-lî-â	Категория:Кантабрия
分類:Â-sṳ̂-thù-lî-â-sṳ̂-sén	Категория:Астурия
分類:Kîm-su̍k	Категория:Металлы
分類:Thòi-pet-sṳ	Категория:Тайбэй
分類:Lò-màn Ngî-chhu̍k	Категория:Романские языки
分類:Kâu-thûng	Категория:Транспорт
分類:Ngiên-kiu	Категория:Научные исследования
分類:Thông-lui	Категория:Углеводы
分類:Fòng-ti	Категория:Императоры
分類:Nàm-tó ngî-hì	Категория:Австронезийские языки
分類:Pet-mî-chû	Категория:Северная Америка
分類:Kô-sú	Категория:Певцы и певицы
分類:Si-chhòng	Категория:Тибет
分類:Sú-ho̍k-kâ	Категория:Математики
分類:Vu̍t-lî ho̍k-kâ	Категория:Физики
分類:Kîn-chi ho̍k-kâ	Категория:Экономисты
分類:Mìn-tsú	Категория:Демократия
分類:Kî-tuk-kau Li̍t-sṳ́	Категория:История христианства
分類:Àu-mûn	Категория:Макао
分類:Hàng-sên-ne	Категория:Планетные системы
分類:Thòi-vân ngî-ngièn	Категория:Языки Тайваня
分類:Thòi-vân Koet-kâ Kûng-yèn	Категория:Национальные парки Китайской Республики
分類:Khiù-lui Yun-thung	Категория:Игры с мячом
分類:Ngiùn-hòng	Категория:Банки
Fu̍k-vu	Услуга
分類:Chûng-fà Ngìn-mìn Khiung-fò-koet	Категория:Китайская Народная Республика
分類:Kâ-thai-lò-nì-â	Категория:Каталония
Kap-kut-vùn	Цзягувэнь
分類:Khien-không	Категория:Здоровье
分類:User zh-classical-2	Категория:User zh-classical-2
模板:Lang-pl	Шаблон:Lang-pl
Trojany	Трояны (Мазовецкое воеводство)
分類:Â-chû koet-kâ	Категория:Страны Азии
模板:MLT	Шаблон:MLT
分類:Kûng-yèn	Категория:Сады и парки
分類:Thòi-vân ngièn-tshu-mìn ngî-ngièn	Категория:Тайваньские языки
分類:Si-chhòng Thi-lî	Категория:География Тибетского автономного района
分類:Nui-mùng-kú Tshṳ-tshṳ-khî	Категория:Внутренняя Монголия
分類:Koet-tsi kîn-tsi tsû-tsṳt	Категория:Международные экономические организации
分類:Lâ-tên Mî-chû	Категория:Латинская Америка
分類:Chúng-chhu̍k	Категория:Расы
分類:Chûng-fà Mìn-koet	Категория:Китайская Республика
分類:Siak-khiet-kau	Категория:Сикхизм
分類:Sa-fi Mìn-tsú Tsú-ngi	Категория:Социал-демократия
模板:BEL	Шаблон:BEL
分類:Kú-thoi chhu̍k-khiùn	Категория:Древние народы
分類:Vùi-sṳ̂-khà-sén	Категория:Уэска
分類:Thap-là-kô-na̍p-sén	Категория:Таррагона
分類:Chûng-kau-ho̍k	Категория:Религиоведение
分類:Thòi-vàn Ngièn-chhu-mìn	Категория:Аборигены Тайваня
分類:Thien-fa	Категория:Телефония
模板:TPE	Шаблон:TPE
分類:Ngân-set	Категория:Цвет
分類:Â-là-kung	Категория:Арагон
分類:Phòng-châ-phú	Категория:Пенджаб
模板:Chûng-fà Mìn-koet Hàng-chṳn Khî-va̍k	Шаблон:Административное деление Китайской Республики
分類:Sat-là-kô-sat-sén	Категория:Сарагоса
模板:HUN	Шаблон:HUN
Â-phô	Бабушка
Vòng-phûng	Осы
模板:Kóng-sî Hàng-chṳn Khî-va̍k	Шаблон:ГЧАР
模板:Kóng-tûng Hàng-chṳn Khî-va̍k	Шаблон:Гуандун
分類:User en-1	Категория:User en-1
分類:User de-1	Категория:User de-1
Liû-khiû Khiùn-tó	Рюкю
模板:User ru-3	Шаблон:User ru-3
模板:User nl-3	Шаблон:User nl-3
模板:Si-chhôn Hàng-chṳn Khî-va̍k	Шаблон:Сычуань
2013-ngièn Lù-sân Thi-chṳ́n	Землетрясение в Сычуани в 2013 году
Yòng-ya̍p-é	Булавоусые чешуекрылые
模板:Style/IPA	Шаблон:Style/IPA
模板:Style/yid	Шаблон:Style/yid
模板:Ping	Шаблон:Reply to
IPhone 5S	IPhone 5s
IPhone 5C	IPhone 5c
Kiông	Имбирь (пряность)
特殊:最近更改	Служебная:Свежие правки
模組:HtmlBuilder	Модуль:HtmlBuilder
模組:Navbox	Модуль:Navbox
馬來西亞航空17號班機空難	Катастрофа Boeing 777 в Донецкой области
