ʻApelika	Африка
Iāpana	Япония
‘Amelika Hema	Южная Америка
Nolewai	Норвегия
ʻIlelani	Ирландия
Hunakalia	Венгрия
Sepania	Испания
‘Amelika Hui Pū ‘ia	Соединённые Штаты Америки
Pelekiuma	Бельгия
Lukemapuka	Люксембург
Honua	Земля
Keoki Wakinekona	Вашингтон, Джордж
Pinilana	Финляндия
Kuekene	Швеция
Kenemaka	Дания
Pōlani	Польша
Lituania	Литва
ʻĪkālia	Италия
Kuikilani	Швейцария
ʻAukekulia	Австрия
Helene	Греция
Tureke	Турция
Potugala	Португалия
‘Eulopa	Европа
‘Ākia	Азия
‘Amelika ‘Ākau	Северная Америка
‘Ane‘ālika	Антарктида
Wikipikia	Википедия
Hōlani	Нидерланды
Wakinekona, D.C.	Вашингтон (округ Колумбия)
Kapalakiko	Сан-Франциско
Pelelina	Берлин
Barack Obama	Обама, Барак
Lākana	Лондон
Palika	Париж
Mekiko	Мексика
Moana ʻAkelanika	Атлантический океан
Moana Pākīpika	Тихий океан
Kaleponi	Калифорния
Pokekona	Бостон
Pō‘akahi	Понедельник
Ianuali	Январь
Pepeluali	Февраль
Malaki	Март
Hōkū‘ula	Марс
Kenia	Кения
‘Aikiopia	Эфиопия
‘Apelila	Апрель
Mei	Май
Iune	Июнь
Iulai	Июль
‘Aukake	Август
Kepakemapa	Сентябрь
‘Okakopa	Октябрь
Nowemapa	Ноябрь
Kēkēmapa	Декабрь
Pō‘alua	Вторник
Pō‘akolu	Среда
Pō‘ahá	Четверг
Pō‘alima	Пятница
Pō‘aono	Суббота
Pōpule	Воскресенье
Liona	Лев
Palani	Франция
‘Ōlelo Ekepelānako	Эсперанто
Aupuni Mōʻī Hui Pū ʻia	Великобритания
Pōpoki	Кошка
Kina	Китайская Народная Республика
‘Ōlelo Palani	Французский язык
Palakila	Бразилия
Rūsia	Россия
Pai (makemakika)	Пи (число)
‘Alapama	Алабама
Kelemānia	Германия
Belarusa	Белоруссия
ʻĀina Hau	Исландия
ʻEsetonia	Эстония
Makulu	Сатурн
1 (helu)	1 (число)
Lakawia	Латвия
ʻUkelena	Украина
Tiekia	Чехия
Solowakia	Словакия
Solowenia	Словения
Molodowa	Молдавия
Romānia	Румыния
Pulukalia	Болгария
Loma	Рим
Repupalika o Masedonia	Республика Македония
ʻAlepania	Албания
Koloatia	Хорватия
Bosenia me Hesegowina	Босния и Герцеговина
‘Akepaikana	Азербайджан
ʻAnakola	Андорра
Kupelo	Республика Кипр
Keokia	Грузия
Kasakana	Казахстан
Malata	Мальта
Monako	Монако
Montenegero	Черногория
Wakikana	Ватикан
Sana Marino	Сан-Марино
‘Inidonesia	Индонезия
Wolfgang Amadeus Mozart	Моцарт, Вольфганг Амадей
Ludwig van Beethoven	Бетховен, Людвиг ван
‘Alekelia	Алжир
Kelewikiona	Телевидение
Chile	Чили
Ukaliali‘i	Меркурий
Hōkūloa	Венера
Ka‘āwela	Юпитер
Hele‘ekela	Уран (планета)
Nepekune	Нептун
Kilo hōkū	Астрономия
Sinapoa	Сингапур
Akeakamai	Наука
Likenekaina	Лихтенштейн
Makemakika	Математика
Baharaina	Бахрейн
‘Āmēnia	Армения
Seripia	Сербия
‘Aukekulelia	Австралия
Kālaikūlohea	Физика
‘Alekina	Аргентина
Kālaimeaola	Биология
Kōlea ʻĀkau	Корейская Народно-Демократическая Республика
Kamabodia	Камбоджа
Nalala	Динозавры
Hoʻomana Mohameka	Ислам
Kālailau nahele	Ботаника
Sofia	София
Kūlanakauhale	Город
Lā	Солнце
Kahua o nā hōkū	Солнечная система
Haikokene	Водород
Hiliuma	Гелий
Likiuma	Литий
Beryllium	Бериллий
Makahiki	Год
Oslo	Осло
Likepona	Лиссабон
Rhône (kahawai)	Рона
Boron	Бор (элемент)
Kalepona	Углерод
Naikokene	Азот
‘Okikene	Кислород
Hōkū hele	Планета
Mokekao	Москва
Fluorine	Фтор
ʻŌlelo ʻĪkālia	Итальянский язык
Nīane	Неон
Sodiuma	Натрий
Makanekiuma	Магний
‘Aluminuma	Алюминий
‘Īnia	Индия
Silikone	Кремний
Pokepola	Фосфор
Sulufura	Сера
Kolorine	Хлор
William Shakespeare	Шекспир, Уильям
‘Aragona	Аргон
Potasiuma	Калий
Kalipuna	Кальций
Monokolia	Монголия
Scandium	Скандий
Titanium	Титан (элемент)
Vanadium	Ванадий
Maine	Мэн (штат)
Lio	Домашняя лошадь
Hoʻomana Buda	Буддизм
Nū Hamekia	Нью-Гэмпшир
Leonardo da Vinci	Леонардо да Винчи
Makakukeka	Массачусетс
Konekikuka	Коннектикут
Hawai‘i	Гавайи
Moana ʻĀlika	Северный Ледовитый океан
Heiti	Республика Гаити
‘Ilana	Иран
‘Ilaka	Ирак
‘Ālaka	Аляска
ʻIseraʻela	Израиль
Panamā	Панама
Iemene	Йемен
Ioredāne	Иордания
Pololika	Флорида
Kaikikana	Киргизия
‘Alikona	Аризона
Kuete	Кувейт
Laosa	Лаос
Lepanona	Ливан
‘Olekona	Орегон
Maladiwa	Мальдивы
Uka	Юта
Malaisia	Малайзия
Puruma	Мьянма
Nepala	Непал
ʻOmana	Оман
Pakitana	Пакистан
Katala	Катар
Saudi ʻAlapia	Саудовская Аравия
Sililanaka	Шри-Ланка
Suria	Сирия
Pokémon	Покемон
Tailani	Таиланд
Wiekanama	Вьетнам
‘Apekanikana	Афганистан
Banagaladesa	Бангладеш
Butana	Бутан
Brunei	Бруней
ʻĀina Pilipino	Филиппины
Isaac Newton	Ньютон, Исаак
Albert Einstein	Эйнштейн, Альберт
Tunisia	Тунис
Beijing	Пекин
Burakina Faso	Буркина-Фасо
ʻElikilea	Эритрея
Mauritiusa	Маврикий
Iulius Caesar	Гай Юлий Цезарь
Hamepuka	Гамбург
Huli honua	Геология
Mikikana	Мичиган
‘Ilinoe	Иллинойс
Tulinia	Тюрингия
Kakoka ‘Ākau	Северная Дакота
Kakoka Hema	Южная Дакота
Monekana	Монтана
Waiomina	Вайоминг
‘Ikahō	Айдахо
Wakinekona	Вашингтон (штат)
Moana ʻIniana	Индийский океан
Kololako	Колорадо
ʻAlepa	Альпы
Kikako, ʻIlinoe	Чикаго
‘Ōlelo Sepania	Испанский язык
Montevideo	Монтевидео
Johann Sebastian Bach	Бах, Иоганн Себастьян
Wilikinia	Виргиния
Wilikinia Komohana	Западная Виргиния
Nuioka	Нью-Йорк (штат)
Loke ‘Ailana	Род-Айленд
Melelana	Мэриленд
Kelawea	Делавэр
‘Ohaio	Огайо
Penekelewinia	Пенсильвания
Uetersen	Итерзен
Augustus	Октавиан Август
Nū ‘Ieleke	Нью-Джерси
‘Ōlelo Pinilana	Финский язык
‘Inikiana	Индиана
Keokia (‘Amelika Hui Pū ‘ia)	Джорджия
Kekeka	Техас
Kalolaina Hema	Южная Каролина
Seine	Сена
Buenos Aires	Буэнос-Айрес
Mēkiko D.F.	Мехико
Mikikipi	Миссисипи (штат)
Kenekī	Теннесси
Nū Mekiko	Нью-Мексико
‘Akenai	Афины
Minekoka	Миннесота
Wikonekina	Висконсин
‘Iowa	Айова
Nepalaka	Небраска
Kanekaka	Канзас
Mikouli	Миссури (штат)
Luikiana	Луизиана
Kenekuke	Кентукки
‘Akanaka	Арканзас
‘Okalahoma	Оклахома
Makekepuka	Магдебург
Reykjavík	Рейкьявик
Paipala	Библия
Thulium	Тулий
Ka Ho‘omana Iesū ‘Oia‘i‘o	Церковь истинного Иисуса
‘Ōlelo Pelekania	Английский язык
Đồng Hới	Донгхой
Concepción, Chile	Консепсьон (город, Чили)
Końskowola	Коньсковоля
2000	2000 год
2003	2003 год
2002	2002 год
2001	2001 год
2009	2009 год
2008	2008 год
2004	2004 год
2005	2005 год
2006	2006 год
2007	2007 год
Lipekika	Лейпциг
1998	1998 год
1999	1999 год
Kurów	Курув
Kemika	Химия
Makelika	Мадрид
Lima	Лима
Santiago de Chile	Сантьяго
Quito	Кито
Ankara	Анкара
Riyadh	Эр-Рияд
Kamakeko	Дамаск
Amman	Амман
Muscat	Маскат
Wikipedia:Sandbox	Википедия:Песочница
Wehimala	Веймар
Osasco	Озаску
Dong Hoi Airport	Донгхой (аэропорт)
Curitiba	Куритиба
Zichyújfalu	Зичиуйфалу
Sarah Bernhardt	Бернар, Сара
Mauna Kana Helena	Сент-Хеленс
Mokuhonua	Континент
Kapikala	Столица
Monzón	Монсон
Almazán	Альмасан
Puke noi‘i kū‘ikena	Энциклопедия
Ka papa kinohi	Заглавная страница
Vincent van Gogh	Ван Гог, Винсент
Frida Kahlo	Кало, Фрида
Michelangelo	Микеланджело
Pablo Picasso	Пикассо, Пабло
Raffael Santi	Рафаэль Санти
Rembrandt	Рембрандт
Frank Lloyd Wright	Райт, Фрэнк Ллойд
Matsuo Bashō	Мацуо Басё
Castille a Leon	Кастилия-Леон
Meka	Мекка
Gabriel García Márquez	Гарсиа Маркес, Габриэль
Johann Wolfgang von Goethe	Гёте, Иоганн Вольфганг фон
Māhele:Candidates for speedy deletion	Категория:Википедия:К быстрому удалению
Kaumokuʻāina	Страна
Homer	Гомер
Hōʻole Akua	Атеизм
Kālaikaiaola	Экология
Kālaiʻāina	Политика
Aupuni	Правительство
Qin Shi Huang	Цинь Шихуанди
Tolstoi	Толстой, Лев Николаевич
Moku‘āina	Государство
ʻŌlelo Lūkini	Русский язык
‘Ōlelo Pākē	Китайский язык
Nelson Mandela	Мандела, Нельсон
Makani Pāhili	Тропический циклон
Moʻokalaleo	Литература
Māhele:Palani	Категория:Франция
Oboe	Гобой
ʻOlumepika Kauwela ma 2008	Летние Олимпийские игры 2008
Granada	Гранада
ʻĀtoma	Атом
Lāpaki	Кролики
Mohameka	Мухаммед
Burgos	Бургос
Ronald Reagan	Рейган, Рональд
‘Ōlelo Zaza	Зазаки
Māhele:Palakila	Категория:Бразилия
Kumumea kemikala	Химический элемент
‘Ohe kani	Флейта
ʻAlea	Площадь
Hulahula	Танец
Papa o nā ʻāina	Алфавитный список стран и территорий
Miranda de Ebro (Burgos)	Миранда-де-Эбро
Kuli	Нарушение слуха
Ponferrada	Понферрада
Santander	Сантандер
Helu piha	Целое число
Malgrat de Mar	Мальграт-де-Мар
‘Ōlelo ‘Alapia	Арабский язык
Tiranosauru	Тираннозавр
Terikeratopa	Трицератопсы
Setegasauru	Стегозавры
Barakiosauru	Брахиозавр
Welokirapetoa	Велоцираптор
Hae	Флаг
‘Ulu	Хлебное дерево
Aupuni kiwikā	Муниципалитет
Salamanca	Саламанка
Zamora (España)	Самора (Испания)
León (España)	Леон (Испания)
Welemoneka	Вермонт
Houston, Kekeka	Хьюстон
Pēniki	Финикс
Kakalameko	Сакраменто (Калифорния)
Honolulu, Hawaiʻi	Гонолулу
Kauoha Hou	Новый Завет
Rafael Correa	Корреа, Рафаэль
Louvre	Лувр
‘Ao‘ao Kū‘oko‘a Pokoliko	Партия независимости Пуэрто-Рико
Kalikimaka	Рождество Христово
Mo‘ai	Моаи
Hoʻolele hualono	Подкастинг
Friedrich Schiller	Шиллер, Фридрих
Jean Auguste Dominique Ingres	Энгр, Жан Огюст Доминик
Pule	Неделя
Cervidae	Оленевые
Pule Alaka‘i A Ka Haku	Отче наш
Musée d'Orsay	Музей Орсе
Mokupuni	Остров
Moshchena	Мощёная
ʻōhiʻa lomi	Томат
Paltoga	Палтога
Panalā‘au o Quảng Binh	Куангбинь
Bryan Cranston	Крэнстон, Брайан
Felidae	Кошачьи
Pichilemu	Пичилему
Canidae	Псовые
Karlstad	Карлстад
Mölnlycke	Мёльнлюкке
Bovidae	Полорогие
Phocidae	Настоящие тюлени
ʻAnekelopa	Антилопы
‘Amelika	Amerika
Cabañas Raras	Кабаньяс-Рарас
Ardón (León)	Ардон (Леон)
Algadefe	Альгадефе
Acebedo	Асебедо
Los Barrios de Luna	Лос-Барриос-де-Луна
Fresno de la Vega	Фресно-де-ла-Вега
La Antigua (Sepania)	Ла-Антигуа (Испания)
Almanza	Альманса (Леон)
El Burgo Ranero	Эль-Бурго-Ранеро
Boca de Huérgano	Бока-де-Уэргано
Bustillo del Páramo	Бустильо-дель-Парамо
Boñar	Боньяр
Alija del Infantado	Алиха-дель-Инфантадо
Brazuelo	Брасуэло
Berlanga del Bierzo	Берланга-дель-Бьерсо
Cabreros del Río	Кабрерос-дель-Рио
Bercianos del Real Camino	Берсьянос-дель-Реаль-Камино
Burón (León)	Бурон (Леон)
Bercianos del Páramo	Берсьянос-дель-Парамо
Otariidae	Ушастые тюлени
Pinnipedia	Ластоногие
Zhengzhou	Чжэнчжоу
Mīkini helu	Калькулятор
Halakepoka	Хартфорд (Коннектикут)
‘Ōlelo Hawai‘i	Гавайский язык
Pea kina	Большая панда
Pae moku	Архипелаг
Valparaíso	Вальпараисо
‘Ōlelo Sāmoa	Самоанский язык
Marlon Brando	Брандо, Марлон
‘Ōlelo Kahiki	Таитянский язык
Wailele ‘o Niakala	Ниагарский водопад
Mošovce	Мошовце
Kauō	Лайсан
ʻAperodite	Афродита
Nā mokuʻāina o ʻAmelika Hui	Штат США
Pauka niho	Зубная паста
Mineapoli	Миннеаполис
Apia	Апиа
Brigitte Bardot	Бардо, Брижит
Arancón	Аранкон
'ōlelo toki pona	Токипона
Paul Gauguin	Гоген, Поль
Teide	Тейде
Kālaiʻelala	Энтомология
Ágreda	Агреда
ʻAnekilosauru	Анкилозавр
Waleluka	Морж
Johannes Vermeer	Вермеер, Ян
Teletubbies	Телепузики
Kahiki	Таити
Israel Kamakawiwoʻole	Камакавивооле, Израэль
Johnny Cash	Кэш, Джонни
Nanahana	Гинкго двулопастной
Hesioda	Гесиод
Cubillos del Sil	Кубильос-дель-Силь
Igüeña	Игуэнья
Noceda del Bierzo	Носеда-дель-Бьерсо
Castropodame	Кастроподаме
Páramo del Sil	Парамо-дель-Силь
Molinaseca	Молинасека
Toreno	Торено
Folgoso de la Ribera	Фольгосо-де-ла-Рибера
Sancedo	Санседо
Josepa Samika	Смит, Джозеф
Pihemanu	Мидуэй
Paris Hilton	Хилтон, Пэрис
Palapola	Парабола
Helu kumu	Простое число
Palencia	Паленсия (провинция)
El Royo	Эль-Ройо
Reyero	Рейеро
La Ercina	Ла-Эрсина
La Robla	Ла-Робла
Santa Colomba de Curueño	Санта-Коломба-де-Куруэньо
Santa María del Monte de Cea	Санта-Мария-дель-Монте-де-Сеа
San Cristóbal de la Polantera	Сан-Кристобаль-де-ла-Полантера
ʻUkulele	Укулеле
Santa María del Páramo	Санта-Мария-дель-Парамо
Santa Elena de Jamuz	Санта-Элена-де-Хамус
San Justo de la Vega	Сан-Хусто-де-ла-Вега
Hawai‘i (mokupuni)	Гавайи (остров)
Georg Philipp Telemann	Телеман, Георг Филипп
ʻUlano	Уран (мифология)
Coronel Fabriciano	Коронел-Фабрисиану
Quintana y Congosto	Кинтана-и-Конгосто
Matallana de Torío	Матальяна-де-Торио
Pamela Anderson	Андерсон, Памела
Gema	Драгоценные камни
Nā panalā‘au o Burgos	Муниципалитеты Бургоса
Puahōlani	Тюльпан
Nā panalā‘au o León	Муниципалитеты Леона
Nikolai Rimsky-Korsakov	Римский-Корсаков, Николай Андреевич
Nā panalā‘au o Salamanca	Муниципалитеты Саламанки
Nā panalā‘au o Soria	Муниципалитеты Сории
Nā panalā‘au o Tarragona	Муниципалитеты Таррагоны
Donald Sutherland	Сазерленд, Дональд
Peter O'Toole	О’Тул, Питер
Nā panalā‘au o Zamora	Муниципалитеты Саморы
Lili‘uokalani	Лилиуокалани
Joey King	Кинг, Джоуи
X-Men	Люди Икс
Nika	Нюкта
Mauna Kea	Мауна-Кеа
O‘ahu	Оаху
Lucillo	Лусильо
Cimanes de la Vega	Симанес-де-ла-Вега
Cebrones del Río	Себронес-дель-Рио
Quintana del Marco	Кинтана-дель-Марко
San Millán de los Caballeros	Сан-Мильян-де-лос-Кабальерос
Cubillas de Rueda	Кубильяс-де-Руэда
Cea (León)	Сеа (Леон)
Garrafe de Torío	Гаррафе-де-Торио
Santa María de Ordás	Санта-Мария-де-Ордас
Cuadros	Куадрос (Леон)
Llamas de la Ribera	Льямас-де-ла-Рибера
Riello	Риельо
Palacios de la Valduerna	Паласьос-де-ла-Вальдуэрна
Castrocalbón	Кастрокальбон
Carrocera	Карросера
Murias de Paredes	Мурьяс-де-Паредес
Rioseco de Tapia	Риосеко-де-Тапия
Santa Cristina de Valmadrigal	Санта-Кристина-де-Вальмадригаль
Grajal de Campos	Грахаль-де-Кампос
Santa María de la Isla	Санта-Мария-де-ла-Исла
Campo de Villavidel	Кампо-де-Вильявидель
Crémenes	Кременес
Cimanes del Tejar	Симанес-дель-Техар
Castilfalé	Кастильфале
Quintana del Castillo	Кинтана-дель-Кастильо
Campazas	Кампасас
Pajares de los Oteros	Пахарес-де-лос-Отерос
San Pedro Bercianos	Сан-Педро-Берсьянос
Santa Marina del Rey	Санта-Марина-дель-Рей
Cebanico	Себанико
Gordaliza del Pino	Гордалиса-дель-Пино
Castrillo de la Valduerna	Кастрильо-де-ла-Вальдуэрна
Pozuelo del Páramo	Посуэло-дель-Парамо
Prado de la Guzpeña	Прадо-де-ла-Гуспенья
Matanza (León)	Матанса (деревня)
Santa Colomba de Somoza	Санта-Коломба-де-Сомоса
Cubillas de los Oteros	Кубильяс-де-лос-Отерос
Mansilla Mayor	Мансилья-Майор
Gordoncillo	Гордонсильо
San Esteban de Nogales	Сан-Эстебан-де-Ногалес
Regueras de Arriba	Регерас-де-Арриба
Luyego	Луйего
Maraña	Маранья
Castrotierra de Valmadrigal	Кастротьерра-де-Вальмадригаль
Magaz de Cepeda	Магас-де-Сепеда
Matadeón de los Oteros	Матадеон-де-лос-Отерос
Castrillo de Cabrera	Кастрильо-де-Кабрера
Gusendos de los Oteros	Гусендос-де-лос-Отерос
Chozas de Abajo	Чосас-де-Абахо
Roperuelos del Páramo	Роперуэлос-дель-Парамо
Sonata No. 8 no Piano (Beethoven)	Соната для фортепиано № 8 (Бетховен)
ʻĀpana	Дистрикт
John Singer Sargent	Сарджент, Джон Сингер
Sesame Street	Улица Сезам
Aupuni Mōʻī o Hawaiʻi	Королевство Гавайи
Mauna Loa	Мауна-Лоа
Pat Hingle	Хингл, Пэт
Frans Hals	Халс, Франс
Pō La‘i Ē	Тихая ночь
Nuʻuhiwa	Маркизские острова
Edentata	Xenarthra
Hualālai	Хуалалаи (вулкан)
Caltojar	Кальтохар
Berlanga de Duero	Берланга-де-Дуэро
Christopher Lee	Ли, Кристофер
Knoxville, Kenekī	Ноксвилл
Lāna‘i	Ланаи
Carl Larsson	Ларссон, Карл Улоф
Kīlauea	Килауэа
Maui	Мауи
Māmā	Музыкальный темп
Christopher Plummer	Пламмер, Кристофер
Mokupuni o Hawai‘i	Гавайские острова
Ivan Shishkin	Шишкин, Иван Иванович
Moloka‘i	Молокаи
Nancy Reagan	Рейган, Нэнси
Almuñécar	Альмуньекар
Hakakā ‘ole	Неприятие убийства
Kaua‘i	Кауаи
Tigranes II	Тигран II
Georges de La Tour	Латур, Жорж де
Adour	Адур
Ivan Kramskoi	Крамской, Иван Николаевич
Motril	Мотриль
Roger Ebert	Эберт, Роджер
John Bauer	Бауэр, Йон
Adolfo Suárez	Суарес, Адольфо
Thomas Eakins	Икинс, Томас
Kamehameha I	Камеамеа I
Hilo	Хило
Anggun	Анггун
Kaho‘olawe	Кахоолаве
Kalo	Таро (растение)
Makua Kamiano	Вёстер, Дамиан де
Ni‘ihau	Ниихау
Dixie Carter	Картер, Дикси
Guadix	Гуадикс
Pete Seeger	Сигер, Пит
Heleuī	Хэллоуин
Waikīkī	Вайкики
Castrojeriz	Кастрохерис
Camponaraya	Кампонарая
Ituero de Azaba	Итуэро-де-Асаба
Villardiegua de la Ribera	Вильярдьегуа-де-ла-Рибера
Małgorzata Braunek	Браунек, Малгожата
O Clone	Клон (телесериал)
Xuxa	Шуша (певица)
Bañuelos de Bureba (Burgos)	Баньуэлос-де-Буреба
Imelda Marcos	Маркос, Имельда Ромуальдес
Mariana Ximenes	Шименес, Мариана
Órgiva	Орхива
Michael Gough	Гоф, Майкл
Sargentes de la Lora (Burgos)	Сархентес-де-ла-Лора
Vadillo	Вадильо
Makeima	Макадамия
Richard Griffiths	Гриффитс, Ричард
Donald Pleasence	Плезенс, Дональд
Andrew Wyeth	Уайет, Эндрю
'Imi loa Dora	Даша — путешественница
Loja	Лоха (Испания)
Richard Schiff	Шифф, Ричард
Pedro de Betancur	Бетанкур, Педро де Сан Хосе
Calzada de Valdunciel	Кальсада-де-Вальдунсьель
Villarcayo de Merindad de Castilla la Vieja (Burgos)	Вильяркайо-де-Мериндад-де-Кастилья-ла-Вьеха
Tubilla del Lago (Burgos)	Тубилья-дель-Лаго
Pino del Oro	Пино-дель-Оро
Maki a Ruby	Макс и Руби
Jeddah	Джидда
Almaluez	Альмалуэс
Salas de los Infantes (Burgos)	Салас-де-лос-Инфантес
Kamehameha II	Камеамеа II
Makakilo	Макакило
Arraya de Oca (Burgos)	Аррая-де-Ока
Valencia de Don Juan	Валенсия-де-Дон-Хуан
Manzanal del Barco	Мансаналь-дель-Барко
Bugedo (Burgos)	Бухедо
Anne Hathaway	Хатауэй, Энн (значения)
Partido de la Sierra en Tobalina (Burgos)	Партидо-де-ла-Сьерра-эн-Тобалина
Valdefresno	Вальдефресно
Salobreña	Салобренья
Aldea del Obispo	Альдеа-дель-Обиспо
Arabayona de Mógica	Арабайона-де-Мохика
El Maderal	Эль-Мадераль
Roa (Burgos)	Роа (город)
Calvarrasa de Arriba	Кальварраса-де-Арриба
Kamehameha III	Камеамеа III
Buke a Moramona	Книга Мормона
Carazo	Карасо (департамент)
Astorga	Асторга
Pōmare IV	Помаре IV
Alexander ʻIolani Liholiho	Камеамеа IV
Tan Son Nhat International Airport	Таншоннят
Aliud	Альюд
Baraona	Бараона
Medinaceli	Мединасели
Láchar	Лачар
Burgo de Osma-Ciudad de Osma	Бурго-де-Осма-Сьюдад-де-Осма
Suellacabras	Суэльякабрас
Yanguas	Янгуас
San Esteban de Gormaz	Сан-Эстебан-де-Гормас
Baza	Баса (город)
San Vicente del Raspeig	Сан-Висенте-дель-Распеч
Aranda de Duero (Burgos)	Аранда-де-Дуэро
Nā kiaʻāina o Hawaiʻi	Список губернаторов штата Гавайи
Ka'aahi Thomas	Томас и друзья
Likaono	Ликаон
Alhama de Granada	Альхама-де-Гранада
Mauna kai	Подводная гора
Gallegos del Río	Гальегос-дель-Рио
Espinosa de los Monteros (Burgos)	Эспиноса-де-лос-Монтерос
Rabanera del Pinar (Burgos)	Рабанера-дель-Пинар
Cañamaque	Каньямаке
Cazurra	Касурра
Requejo (Zamora)	Рекехо
Haleakalā	Халеакала (вулкан)
Navaleno	Навалено
Tremedal de Tormes	Тремедаль-де-Тормес
Las Omañas	Лас-Оманьяс
Santa Eufemia del Barco	Санта-Эуфемия-дель-Барко
Huahine	Хуахине
Alfoz de Bricia (Burgos)	Альфос-де-Брисия
Villalbilla de Burgos (Burgos)	Вильяльбилья-де-Бургос
Negrilla de Palencia	Негрилья-де-Паленсия
Honolulu International Airport	Гонолулу (аэропорт)
Efrem Zimbalist, Jr.	Цимбалист, Ефрем (младший)
Belorado (Burgos)	Белорадо
Peleas de Abajo	Пелеас-де-Абахо
Fresneda de la Sierra Tirón (Burgos)	Фреснеда-де-ла-Сьерра-Тирон
Morales de Toro	Моралес-де-Торо
Carcedo de Burgos	Карседо-де-Бургос
Cijuela	Сихуэла
Armilla	Армилья
Chauchina	Чаучина
Dúrcal	Дуркаль
Cantabrana	Кантабрана
Fuente Vaqueros	Фуэнте-Вакерос
Huéscar	Уэскар
Trévago	Треваго
Maracena	Марасена
La Bouza	Ла-Боуса
El Campo de Peñaranda	Эль-Кампо-де-Пеньяранда
Palacios de Riopisuerga (Burgos)	Паласьос-де-Риописуэрга
Līhuʻe	Лихуэ
Pedrosa del Príncipe (Burgos)	Педроса-дель-Принсипе
Merindad de Valdeporres (Burgos)	Мериндад-де-Вальдепоррес
Aldealengua	Альдеаленгуа
Cañizal	Каньисаль
Tubilla del Agua (Burgos)	Тубилья-дель-Агуа
La Encina (Salamanca)	Ла-Энсина
Valdepiélago	Вальдепьелаго
Villademor de la Vega	Вильядемор-де-ла-Вега
Camarzana de Tera	Камарсана-де-Тера
Dévanos	Деванос
Poʻipū	Поипу
Zotes del Páramo	Сотес-дель-Парамо
Cañizo	Каньисо
Priaranza del Bierzo	Приаранса-дель-Бьерсо
Villagonzalo Pedernales (Burgos)	Вильягонсало-Педерналес
Frades de la Sierra	Фрадес-де-ла-Сьерра
Avellanosa de Muñó (Burgos)	Авельяноса-де-Муньо
Pinos Puente	Пинос-Пуэнте
Fuentes de Carbajal	Фуэнтес-де-Карбахаль
Garcibuey	Гарсибуэй
Rollán	Рольян
Moreruela de Tábara	Мореруэла-де-Табара
El Bodón	Эль-Бодон
Monasterio de la Sierra (Burgos)	Монастерио-де-ла-Сьерра
Villamiel de la Sierra (Burgos)	Вильямьель-де-ла-Сьерра
Santa Fe	Санта-Фе (Гранада)
Ólvega	Ольвега
Solarana (Burgos)	Соларана
Kailua-Kona	Каилуа-Кона
Barrio de Muñó (Burgos)	Баррио-де-Муньо
Valmala (Burgos)	Вальмала (Испания)
Casaseca de Campeán	Касасека-де-Кампеан
Terradillos de Esgueva (Burgos)	Террадильос-де-Эсгева
Villamartín de Don Sancho	Вильямартин-де-Дон-Санчо
Viveiro	Виверо
Burganes de Valverde	Бурганес-де-Вальверде
Sobrado	Собрадо
Basconcillos del Tozo (Burgos)	Басконсильос-дель-Тосо
San Martín de Valderaduey	Сан-Мартин-де-Вальдерадуэй
Palapala ‘Āina Honua	Карта мира
Magaña	Маганья
La Calzada de Béjar	Ла-Кальсада-де-Бехар
Kapaʻa	Капаа
Abajas (Burgos)	Абахас
Itero del Castillo (Burgos)	Итеро-дель-Кастильо
Hawaiʻi Ponoʻī	Hawaii Pono’i
Huinakolu Polenekia	Полинезийский треугольник
Izagre	Исагре
Reinosa	Рейноса
Centenera de Andaluz	Сентенера-де-Андалус
Villalazán	Вильяласан
Almenara de Tormes	Альменара-де-Тормес
Bermellar	Бермельяр
Mokupāpapa	Куре (атолл)
Sila Hawaiʻi	Гавайский тюлень-монах
Cacabelos	Какабелос
Béjar	Бехар
Topas	Топас
Vidayanes	Видаянес
Villanázar	Вильянасар
Soto de la Vega	Сото-де-ла-Вега
Faramontanos de Tábara	Фарамонтанос-де-Табара
Manzanal de los Infantes	Мансаналь-де-лос-Инфантес
Kaunakakai	Каунакакаи
Peque	Пеке
Fermoselle	Фермоселье
Valle de Sedano (Burgos)	Валье-де-Седано
Junta de Traslaloma (Burgos)	Хунта-де-Траслалома
Mansilla de las Mulas	Мансилья-де-лас-Мулас
ʻOeneusa	Ойней
Atapuerca (Burgos)	Атапуэрка (муниципалитет)
Riocavado de la Sierra (Burgos)	Риокавадо-де-ла-Сьерра
Belver de los Montes	Бельвер-де-лос-Монтес
Villanueva de Argaño (Burgos)	Вильянуэва-де-Арганьо
Valderas	Вальдерас
Menekikā	Менди
Gradefes	Градефес
Onzonilla	Онсонилья
Arenas de Iguña	Аренас-де-Игуния
Ciudad Rodrigo	Сьюдад-Родриго
Sahagún	Саагун
Villatuelda (Burgos)	Вильятуэльда
Almarza	Альмарса
Aldealices	Альдеалисес
Aldealafuente	Альдеалафуэнте
Alentisque	Алентиске
Adradas	Адрадас
Alconaba	Альконаба
Abejar	Абехар
Almajano	Альмахано
Arenillas	Аренильяс
Aldealpozo	Альдеальпосо
Alcubilla de las Peñas	Алькубилья-де-лас-Пеньяс
Aldealseñor	Альдеальсеньор
Alcubilla de Avellaneda	Алькубилья-де-Авельянеда
Covaleda	Коваледа
Casarejos	Касарехос
Cerbón	Сербон
Calatañazor	Калатаньясор
Almazul	Альмасуль
Cidones	Сидонес
Alpanseque	Альпансеке
Arcos de Jalón	Аркос-де-Халон
Aldehuela de Periáñez	Альдеуэла-де-Перианьес
Beratón	Бератон
Almenar de Soria	Альменар-де-Сория
Maján	Махан (Сория)
Coscurita	Коскурита
Barcones	Барконес
Castilfrío de la Sierra	Кастильфрио-де-ла-Сьерра
Castilruiz	Кастильруис
Miño de Medinaceli	Миньо-де-Мединасели
Vinuesa	Винуэса
Cigudosa	Сигудоса
Candilichera	Кандиличера
Ausejo de la Sierra	Аусехо-де-ла-Сьерра
Carabantes	Карабантес (Сория)
Soliedra	Сольедра
Taroda	Тарода
Nepas	Непас
Valtajeros	Вальтахерос
Arévalo de la Sierra	Аревало-де-ла-Сьерра
Pozalmuro	Посальмуро
Cabrejas del Pinar	Кабрехас-дель-Пинар
Villasayas	Вильясаяс
Cubilla	Кубилья
Castillejo de Robledo	Кастильехо-де-Робледо
Escobosa de Almazán	Эскобоса-де-Альмасан
Estepa de San Juan	Эстепа-де-Сан-Хуан
Carrascosa de la Sierra	Карраскоса-де-ла-Сьерра
Las Aldehuelas	Лас-Альдеуэлас
Bayubas de Arriba	Баюбас-де-Арриба
Borobia	Боробия
Bliecos	Бльекос
Buberos	Буберос
Muriel Viejo	Мурьель-Вьехо
Oncala	Онкала
Fuentecambrón	Фуэнтекамброн
Cabrejas del Campo	Кабрехас-дель-Кампо
Frechilla de Almazán	Фречилья-де-Альмасан
Valdelagua del Cerro	Вальделагуа-дель-Серро
Ciria	Сирия (Сория)
Buitrago	Буитраго
Talveila	Тальвейла
Salduero	Сальдуэро
Fuentes de Magaña	Фуэнтес-де-Маганья
Viana de Duero	Вьяна-де-Дуэро
Tardelcuende	Тарделькуэнде
Duruelo de la Sierra	Дуруэло-де-ла-Сьерра
Bayubas de Abajo	Баюбас-де-Абахо
Fuentearmegil	Фуэнтеармехиль
Fuentelmonge	Фуэнтельмонхе
Rollamienta	Рольямьента
Villar del Ala	Вильяр-дель-Ала
Velilla de los Ajos	Велилья-де-лос-Ахос
Momblona	Момблона
Fresno de Caracena	Фресно-де-Карасена
Valdegeña	Вальдехенья
Velamazán	Веламасан
Torlengua	Торленгуа
Fuentecantos	Фуэнтекантос
Carrascosa de Abajo	Карраскоса-де-Абахо
Pinilla del Campo	Пинилья-дель-Кампо
Serón de Nágima	Серон-де-Нахима
Blacos	Блакос
Valdeavellano de Tera	Вальдеавельяно-де-Тера
Narros	Наррос
Valdeprado	Вальдепрадо
Borjabad	Борхабад
Fuentelsaz de Soria	Фуэнтельсас-де-Сория
San Leonardo de Yagüe	Сан-Леонардо-де-Ягуэ
Muriel de la Fuente	Мурьель-де-ла-Фуэнте
Villar del Río	Вильяр-дель-Рио
Valderrodilla	Вальдерродилья
Espejón	Эспехон
Liceras	Лисерас
Matalebreras	Маталебрерас
Quintana Redonda	Кинтана-Редонда
Nafría de Ucero	Нафрия-де-Усеро
Sotillo del Rincón	Сотильо-дель-Ринкон
Torrubia de Soria	Торрубия-де-Сория
Noviercas	Новьеркас
Tajueco	Тахуэко
Valdenebro	Вальденебро
Villaciervos	Вильясьервос
Villanueva de Gormaz	Вильянуэва-де-Гормас
Yelo	Ело (Испания)
Montenegro de Cameros	Монтенегро-де-Камерос
Ucero	Усеро
Langa de Duero	Ланга-де-Дуэро
Quiñonería	Киньонерия
Villar del Campo	Вильяр-дель-Кампо
Portillo de Soria	Портильо-де-Сория
Gormaz	Гормас
Santa Cruz de Yanguas	Санта-Крус-де-Янгуас
Villaseca de Arciel	Вильясека-де-Арсьель
Reznos	Реснос
Cueva de Ágreda	Куэва-де-Агреда
Nolay	Нолай
Cirujales del Río	Сирухалес-дель-Рио
Caracena	Карасена (Сория)
Cubo de la Solana	Кубо-де-ла-Солана
Miño de San Esteban	Миньо-де-Сан-Эстебан
Fuentestrún	Фуэнтеструн
Espeja de San Marcelino	Эспеха-де-Сан-Марселино
Matamala de Almazán	Матамала-де-Альмасан
La Póveda de Soria	Ла-Поведа-де-Сория
Los Rábanos	Лос-Рабанос
Quintanas de Gormaz	Кинтанас-де-Гормас
Santa María de Huerta	Санта-Мария-де-Уэрта
San Pedro Manrique	Сан-Педро-Манрике
Velilla de la Sierra	Велилья-де-ла-Сьерра
Valdemaluque	Вальдемалуке
San Felices	Сан-Фелисес
Renieblas	Реньеблас
Toro (Zamora)	Торо (Самора)
Morón de Almazán	Морон-де-Альмасан
Los Villares de Soria	Лос-Вильярес-де-Сория
Torreblacos	Торреблакос
Vizmanos	Висманос
Tejado	Техадо
Retortillo de Soria	Ретортильо-де-Сория
Herrera de Soria	Эррера-де-Сория
Deza	Деса
Monteagudo de las Vicarías	Монтеагудо-де-лас-Викариас
La Riba de Escalote	Ла-Риба-де-Эскалоте
Montejo de Tiermes	Монтехо-де-Тьермес
La Losilla	Ла-Лосилья
Recuerda	Рекуэрда
Tajahuerce	Тахауэрсе
Santa María de las Hoyas	Санта-Мария-де-лас-Ойяс
Fuentepinilla	Фуэнтепинилья
Golmayo	Гольмайо
Rioseco de Soria	Риосеко-де-Сория
Gómara	Гомара
Cihuela	Сиуэла
Trabadelo	Трабадело
Caleruega	Калеруэга
Hospital de Órbigo	Оспиталь-де-Орбиго
Villafranca del Bierzo	Вильяфранка-дель-Бьерсо
Cyclops (Marvel)	Циклоп (Marvel Comics)
Pōmare II	Помаре II
Pōmare I	Помаре I
Pōmare III	Помаре III
Peñausende	Пеньяусенде
Villadangos del Páramo	Вильядангос-дель-Парамо
Vega de Valcarce	Вега-де-Валькарсе
Valverde de la Virgen	Вальверде-де-ла-Вирхен
Barbalos	Барбалос
Susinos del Páramo (Burgos)	Сусинос-дель-Парамо
Quintanar de la Sierra (Burgos)	Кинтанар-де-ла-Сьерра
Olmedillo de Roa (Burgos)	Ольмедильо-де-Роа
Valle de Valdebezana (Burgos)	Валье-де-Вальдебесана
Calzada del Coto	Кальсада-дель-Кото
Valdesamario	Вальдесамарио
Fuentes de Oñoro	Фуэнтес-де-Оньоро
Val de San Lorenzo	Валь-де-Сан-Лоренсо
Baños de Valdearados (Burgos)	Баньос-де-Вальдеарадос
Insane Clown Posse	Insane Clown Posse
Losacino	Лосасино
Villaquilambre	Вильякиламбре
Pradoluengo (Burgos)	Прадолуэнго
Aldearrodrigo	Альдеарродриго
Padilla de Arriba (Burgos)	Падилья-де-Арриба
Trabazos	Трабасос
La Cueva de Roa	Ла-Куэва-де-Роа
Valdemora	Вальдемора
Tardajos (Burgos)	Тардахос
Sotragero (Burgos)	Сотрахеро
Hurones (Burgos)	Уронес
Villanueva de Teba (Burgos)	Вильянуэва-де-Теба
Condado de Treviño	Кондадо-де-Тревиньо
Castildelgado	Кастильдельгадо
Cardeñuela Riopico	Карденьуэла-Риопико
Villaveza del Agua	Вильявеса-дель-Агуа
Alba de Tormes	Альба-де-Тормес
Espinosa del Camino (Burgos)	Эспиноса-дель-Камино
Villares de Órbigo	Вильярес-де-Орбиго
Orbaneja Riopico (Burgos)	Орбанеха-Риопико
Pozuelo de Tábara	Посуэло-де-Табара
Palazuelos de Muñó (Burgos)	Паласуэлос-де-Муньо
Nebreda (Burgos)	Небреда
Benavente (Zamora)	Бенавенте (Испания)
Galbarros (Burgos)	Гальбаррос
Palacios de la Sierra (Burgos)	Паласьос-де-ла-Сьерра
Peñaranda de Duero (Burgos)	Пеньяранда-де-Дуэро
Fuentesecas	Фуэнтесекас
Riego de la Vega	Риего-де-ла-Вега
Viloria de Rioja (Burgos)	Вилория-де-Риоха
Ferreras de Abajo	Феррерас-де-Абахо
Pinilla de los Barruecos (Burgos)	Пинилья-де-лос-Барруэкос
Villambistia (Burgos)	Вильямбистия
Tosantos (Burgos)	Тосантос
Hornillos del Camino (Burgos)	Орнильос-дель-Камино
Villafranca Montes de Oca (Burgos)	Вильяфранка-Монтес-де-Ока
Hontanas (Burgos)	Онтанас
Villahoz (Burgos)	Вильяос
Losacio	Лосасио
Pardilla (Burgos)	Пардилья
Ledesma (Salamanca)	Ледесма
Villafáfila	Вильяфафила
Figueruela de Arriba	Фигеруэла-де-Арриба
Hontoria del Pinar (Burgos)	Онтория-дель-Пинар
Haʻikū-Paʻuwela	Хаику-Паувела
Benuza	Бенуса
Rabanales	Рабаналес
Milles de la Polvorosa	Мильес-де-ла-Польвороса
Celada del Camino	Селада-дель-Камино
Forfoleda	Форфоледа
Castrillo Matajudíos	Кастрильо-Матахудиос
Villamanín	Вильяманин
Vegalatrave	Вегалатраве
N. C. Wyeth	Уайет, Ньюэлл Конверс
Molinos de Duero	Молинос-де-Дуэро
Vozmediano	Восмедьяно
Hinojosa del Campo	Инохоса-дель-Кампо
Garcihernández	Гарсиернандес
La Alberca	Ла-Альберка
Redecilla del Camino (Burgos)	Редесилья-дель-Камино
Kahului	Кахулуи
Rabé de las Calzadas (Burgos)	Рабе-де-лас-Кальсадас
Kīhei	Кихеи
Pelanekelina	Франклин (мультсериал)
Rello	Рельо
Rebollar	Ребольяр (Сория)
Garray	Гаррай
Iglesias (Burgos)	Иглесиас (Бургос)
Covarrubias	Коваррубиас
Aldearrubia	Альдеаррубия
Llano de Bureba (Burgos)	Льяно-де-Буреба
Adrada de Haza (Burgos)	Адрада-де-Аса
Cerezo de Río Tirón	Сересо-де-Рио-Тирон
Pele	Пеле (мифология)
Lōʻihi	Лоихи
Aiga-i-le-Tai	Аига-и-ле-Таи
Kartlis Deda	Мать Картли
Bembibre	Бембибре
Santovenia	Сантовения
Wikipedia:Nohona kuhina	Википедия:Посольство
Hawaiʻi Aloha	Гавайи Алоха
Aloha ʻOe	Алоха Оэ
Letícia Sabatella	Сабатела, Летисия
Poʻe Hawaiʻi	Гавайцы
Manuae	Мануаэ (Французская Полинезия)
Holoikauaua	Перл-энд-Хермес
Alfoz de Lloredo	Альфос-де-Льоредо
Cármenes	Карменес
Ampuero	Ампуэро
Palacios del Sil	Паласьос-дель-Силь
Cabrillanes	Кабрильянес
Briviesca (Burgos)	Бривьеска
Iznalloz	Иснальос
Māhele:Kelemānia	Категория:Германия
Māhele:ʻAmelika Hui Pū ʻia	Категория:США
Māhele:Sepania	Категория:Испания
Māhele:Mekiko	Категория:Мексика
Gallegos del Pan	Гальегос-дель-Пан
La Bañeza	Ла-Баньеса
Carracedelo	Карраседело
Carucedo	Каруседо
Corullón	Корульон
Castrocontrigo	Кастроконтриго
Fabero	Фаберо
Corrales	Лос-Корралес-де-Буэльна
Anievas	Аньевас
Anguix (Burgos)	Ангикс
Arauzo de Miel (Burgos)	Араусо-де-Мьель
Arauzo de Salce (Burgos)	Араусо-де-Сальсе
Brazacorta (Burgos)	Брасакорта
Aguilar de Bureba (Burgos)	Агилар-де-Буреба
Bascuñana (Burgos)	Баскуньяна
Altable (Burgos)	Альтабле
Barbadillo del Pez (Burgos)	Барбадильо-дель-Пес
Bahabón de Esgueva (Burgos)	Баабон-де-Эсгева
Alfoz de Quintanadueñas (Burgos)	Альфос-де-Кинтанадуэньяс
Barrios de Colina (Burgos)	Барриос-де-Колина
Berberana (Burgos)	Берберана
Berlangas de Roa (Burgos)	Берлангас-де-Роа
Aguas Cándidas (Burgos)	Агуас-Кандидас
Belbimbre (Burgos)	Бельбимбре
Montorio (Burgos)	Монторио
Māhele:Pōlani	Категория:Польша
Māhele:Wiekanama	Категория:Вьетнам
Māhele:Hōʻike honua	Категория:География
Māhele:Akeakamai	Категория:Наука
Waiʻaleʻale	Ваиалеале
Guijuelo	Гихуэло
Vegas del Condado	Вегас-дель-Кондадо
Borrenes	Борренес
Santovenia de la Valdoncina	Сантовения-де-ла-Вальдонсина
La Pola de Gordón	Ла-Пола-де-Гордон
Villablino	Вильяблино
Torre del Bierzo	Торре-дель-Бьерсо
Vega de Espinareda	Вега-де-Эспинареда
Barjas	Бархас
Cistierna	Систьерна
Babilafuente	Бабилафуэнте
Cereceda de la Sierra	Сереседа-де-ла-Сьерра
Cardeñajimeno	Карденьяхимено
Castil de Peones	Кастиль-де-Пеонес
Jurisdicción de Lara (Burgos)	Хурисдиксьон-де-Лара
Arganza (León)	Арганса
Valdevimbre	Вальдевимбре
Villaturiel	Вильятурьель
Valdepolo	Вальдеполо
Gumiel de Mercado (Burgos)	Гумьель-де-Меркадо
Oquillas (Burgos)	Окильяс
Villamañán	Вильяманьян
Puente de Domingo Flórez	Пуэнте-де-Доминго-Флорес
Olmillos de Muñó (Burgos)	Ольмильос-де-Муньо
Encío (Burgos)	Энсио
Ibeas de Juarros (Burgos)	Ибеас-де-Хуаррос
Santibáñez del Val (Burgos)	Сантибаньес-дель-Валь
Urdiales del Páramo	Урдьялес-дель-Парамо
Sena de Luna	Сена-де-Луна
Oña (Burgos)	Онья
Grisaleña (Burgos)	Грисаленья
Coruña del Conde	Корунья-дель-Конде
Zazuar (Burgos)	Сасуар
Buniel (Burgos)	Буньель
Arauzo de Torre (Burgos)	Араусо-де-Торре
Berzosa de Bureba (Burgos)	Берсоса-де-Буреба
Alfoz de Santa Gadea (Burgos)	Альфос-де-Санта-Гадеа
Barbadillo de Herreros (Burgos)	Барбадильо-де-Эррерос
Albillos (Burgos)	Альбильос
Arenillas de Riopisuerga (Burgos)	Аренильяс-де-Риописуэрга
Barbadillo del Mercado	Барбадильо-дель-Меркадо
Arlanzón (Burgos)	Арлансон (город)
Medina de Pomar (Burgos)	Медина-де-Помар
Arandilla (Burgos)	Арандилья
Bozoó (Burgos)	Босоо
Fuentelisendo (Burgos)	Фуэнтелисендо
Zarzosa de Río Pisuerga (Burgos)	Сарсоса-де-Рио-Писуэрга
Alcocero de Mola (Burgos)	Алькосеро-де-Мола
Valle de Mena (Burgos)	Валье-де-Мена
Zael (Burgos)	Саэль (Испания)
Ameyugo (Burgos)	Амеюго
Lerma (Burgos)	Лерма (Испания)
Villaquejida	Вильякехида
Sariegos	Сарьегос
Corbillos de los Oteros	Корбильос-де-лос-Отерос
Vega de Infanzones	Вега-де-Инфансонес
Peranzanes	Перансанес
Sabero	Саберо
Candín (León)	Кандин
Valderrueda	Вальдерруэда
Puebla de Lillo	Пуэбла-де-Лильо
Soto y Amío	Сото-и-Амио
Laguna de Negrillos	Лагуна-де-Негрильос
Villarejo de Órbigo	Вильярехо-де-Орбиго
La Vecilla	Ла-Весилья
San Andrés del Rabanedo	Сан-Андрес-дель-Рабанедо
Villazala	Вильясала
Villamontán de la Valduerna	Вильямонтан-де-ла-Вальдуэрна
Nava de Roa (Burgos)	Нава-де-Роа
Villasabariego	Вильясабарьего
Oencia	Оэнсия
Encinedo	Энсинедо
Zuñeda (Burgos)	Суньеда
Valdeande (Burgos)	Вальдеанде
Destriana	Дестриана
Villagatón	Вильягатон
Arija (Burgos)	Ариха (Бургос)
Busto de Bureba (Burgos)	Бусто-де-Буреба
Abezames	Абесамес
Alcañices	Альканьисес
Laguna Dalga	Лагуна-Дальга
Alaraz	Аларас
Brincones	Бринконес
Aldeadávila de la Ribera	Альдеадавила-де-ла-Рибера
Castellanos de Castro	Кастельянос-де-Кастро
Cascajares de la Sierra	Каскахарес-де-ла-Сьерра
Iglesiarrubia (Burgos)	Иглесьяррубия
Castrillo de la Vega	Кастрильо-де-ла-Вега
Sasamón (Burgos)	Сасамон
Torrepadre (Burgos)	Торрепадре
Sotillo de la Ribera (Burgos)	Сотильо-де-ла-Рибера
Torrecilla del Monte (Burgos)	Торресилья-дель-Монте
Linares de Riofrío	Линарес-де-Риофрио
Ahigal de Villarino	Аигаль-де-Вильярино
Gumiel de Izán (Burgos)	Гумьель-де-Исан
Cabrerizos	Кабрерисос
Cantalapiedra	Канталапьедра
Ahigal de los Aceiteros	Аигаль-де-лос-Асейтерос
Barceo	Барсео
Castellanos de Moriscos	Кастельянос-де-Морискос
Casafranca	Касафранка
Vizcaínos (Burgos)	Вискаинос
Casillas de Flores	Касильяс-де-Флорес
Los Balbases (Burgos)	Лос-Бальбасес
Santibáñez de Esgueva (Burgos)	Сантибаньес-де-Эсгева
San Martín de Rubiales (Burgos)	Сан-Мартин-де-Рубьялес
Tórtoles de Esgueva (Burgos)	Тортолес-де-Эсгева
Villaescusa de Roa (Burgos)	Вильяэскуса-де-Роа
Mamolar (Burgos)	Мамолар
Moradillo de Roa (Burgos)	Морадильо-де-Роа
Mambrilla de Castrejón (Burgos)	Мамбрилья-де-Кастрехон
Pedrosa de Duero (Burgos)	Педроса-де-Дуэро
Quintanilla del Coco (Burgos)	Кинтанилья-дель-Коко
Pinilla de los Moros (Burgos)	Пинилья-де-лос-Морос
Valle de Tobalina (Burgos)	Валье-де-Тобалина
Villanueva de Carazo (Burgos)	Вильянуэва-де-Карасо
Quemada (Burgos)	Кемада
Torresandino (Burgos)	Торресандино
Villalba de Duero (Burgos)	Вильяльба-де-Дуэро
Rubena (Burgos)	Рубена
Valluércanes (Burgos)	Вальуэрканес
Villadiego (Burgos)	Вильядьего
Merindad de Río Ubierna (Burgos)	Мериндад-де-Рио-Убьерна
Mazuela (Burgos)	Масуэла
Valle de Zamanzas (Burgos)	Валье-де-Самансас
Quintana del Pidio (Burgos)	Кинтана-дель-Пидио
Vadocondes (Burgos)	Вадокондес
Fuentelcésped (Burgos)	Фуэнтельсеспед
Ciadoncha	Сьядонча
Merindad de Montija (Burgos)	Мериндад-де-Монтиха
Pancorbo (Burgos)	Панкорбо
Monterrubio de la Demanda (Burgos)	Монтеррубио-де-ла-Деманда
Fuentespina (Burgos)	Фуэнтеспина
Cillaperlata	Сильяперлата
Fontioso (Burgos)	Фонтиосо
La Sequera de Haza (Burgos)	Ла-Секера-де-Аса
La Horra (Burgos)	Ла-Орра
Cilleruelo de Arriba	Сильеруэло-де-Арриба
Jurisdicción de San Zadornil (Burgos)	Хурисдиксьон-де-Сан-Садорниль
Cuevas de San Clemente	Куэвас-де-Сан-Клементе
Fuentemolinos (Burgos)	Фуэнтемолинос
Hontangas (Burgos)	Онтангас
Hoyales de Roa (Burgos)	Оялес-де-Роа
Campolara	Камполара
Carrias	Карриас
Canicosa de la Sierra	Каникоса-де-ла-Сьерра
Cerralbo	Серральбо
Cabezón de la Sierra	Кабесон-де-ла-Сьерра
Cabañes de Esgueva	Кабаньес-де-Эсгева
Cardeñadijo	Карденьядихо
Castrillo de Riopisuerga	Кастрильо-де-Риописуэрга
Milagros (Burgos)	Милагрос
La Puebla de Arganzón (Burgos)	Ла-Пуэбла-де-Аргансон
Agallas	Агальяс
Abusejo	Абусехо
Posada de Valdeón	Посада-де-Вальдеон
Valderrey	Вальдеррей
Joarilla de las Matas	Хоарилья-де-лас-Матас
Neila (Burgos)	Нейла
Santiago Millas	Сантьяго-Мильяс
Turcia	Турсия
Prioro	Приоро
Valdelugueros	Вальделугерос
Santas Martas	Сантас-Мартас
Vegaquemada	Вегакемада
Pobladura de Pelayo García	Побладура-де-Пелайо-Гарсия
Navas de Bureba (Burgos)	Навас-де-Буреба
Vegacervera	Вегасервера
San Adrián del Valle	Сан-Адриан-дель-Валье
Valdefuentes del Páramo	Вальдефуэнтес-дель-Парамо
Jaramillo Quemado (Burgos)	Харамильо-Кемадо
Campillo de Aranda	Кампильо-де-Аранда
Jaramillo de la Fuente (Burgos)	Харамильо-де-ла-Фуэнте
Carcedo de Bureba	Карседо-де-Буреба
La Gallega (Burgos)	Ла-Гальега
Cebrecos	Себрекос
La Fuente de San Esteban	Ла-Фуэнте-де-Сан-Эстебан
Aldeanueva de Figueroa	Альдеануэва-де-Фигероа
Cerezal de Peñahorcada	Сересаль-де-Пеньяоркада
Cabeza del Caballo	Кабеса-дель-Кабальо
Lumbrales	Лумбралес
Villabraz	Вильябрас
Villamejil	Вильямехиль
Villaornate y Castro	Вильяорнате-и-Кастро
Valverde-Enrique	Вальверде-Энрике
Villaobispo de Otero	Вильяобиспо-де-Отеро
Villazanzo de Valderaduey	Вильясансо-де-Вальдерадуэй
Villanueva de las Manzanas	Вильянуэва-де-лас-Мансанас
Villamandos	Вильямандос
Villamol	Вильямоль
Villaselán	Вильяселан
Villamoratiel de las Matas	Вильяморатьель-де-лас-Матас
Toral de los Guzmanes	Тораль-де-лос-Гусманес
Bañobárez	Баньобарес
Barruecopardo	Барруэкопардо
Carrascal del Obispo	Карраскаль-дель-Обиспо
Castillejo de Martín Viejo	Кастильехо-де-Мартин-Вьехо
Fuenteguinaldo	Фуэнтегинальдо
Iruelos	Ируэлос
Tamames	Тамамес
Bóveda del Río Almar	Боведа-дель-Рио-Альмар
Doñinos de Ledesma	Доньинос-де-Ледесма
Encina de San Silvestre	Энсина-де-Сан-Сильвестре
Canillas de Abajo	Канильяс-де-Абахо
Castellanos de Villiquera	Кастельянос-де-Вильикера
Carpio de Azaba	Карпио-де-Асаба
Doñinos de Salamanca	Доньинос-де-Саламанка
Cantaracillo	Кантарасильо
Las Casas del Conde	Лас-Касас-дель-Конде
Aldeaseca de la Frontera	Альдеасека-де-ла-Фронтера
Castraz	Кастрас
Cepeda (Salamanca)	Сепеда
El Tornadizo	Эль-Торнадисо
Aldeaseca de Alba	Альдеасека-де-Альба
Navamorales	Наваморалес
El Cabaco	Эль-Кабако
Aldeanueva de la Sierra	Альдеануэва-де-ла-Сьерра
Cipérez	Сиперес
Cantalpino	Кантальпино
Colmenar de Montemayor	Кольменар-де-Монтемайор
Espadaña (Salamanca)	Эспаданья
Cespedosa de Tormes	Сеспедоса-де-Тормес
Carbajosa de la Sagrada	Карбахоса-де-ла-Саграда
Cabrillas	Кабрильяс
Berrocal de Huebra	Беррокаль-де-Уэбра
Calvarrasa de Abajo	Кальварраса-де-Абахо
Cilleros de la Bastida	Сильерос-де-ла-Бастида
Sotresgudo (Burgos)	Сотресгудо
Arapiles	Арапилес
Benavides	Бенавидес
Tordómar (Burgos)	Тордомар
Torrelara (Burgos)	Торрелара
San Millán de Lara (Burgos)	Сан-Мильян-де-Лара
Sordillos (Burgos)	Сордильос
Santa María del Mercadillo (Burgos)	Санта-Мария-дель-Меркадильо
Santa Cruz de la Salceda (Burgos)	Санта-Крус-де-ла-Сальседа
Santa Gadea del Cid (Burgos)	Санта-Гадеа-дель-Сид
Tamarón (Burgos)	Тамарон
San Mamés de Burgos (Burgos)	Сан-Мамес-де-Бургос
Santa María del Campo (Burgos)	Санта-Мария-дель-Кампо
San Vicente del Valle (Burgos)	Сан-Висенте-дель-Валье
Sarracín (Burgos)	Саррасин
Salinillas de Bureba (Burgos)	Салинильяс-де-Буреба
Villazopeque (Burgos)	Вильясопеке
Vilviestre del Pinar (Burgos)	Вильвьестре-дель-Пинар
Saldaña de Burgos (Burgos)	Сальданья-де-Бургос
Tejada (Burgos)	Техада
Tobar (Burgos)	Тобар
Santa Olalla de Bureba (Burgos)	Санта-Олалья-де-Буреба
San Adrián de Juarros (Burgos)	Сан-Адриан-де-Хуаррос
Santa María del Invierno (Burgos)	Санта-Мария-дель-Инвьерно
Tinieblas de la Sierra (Burgos)	Тиньеблас-де-ла-Сьерра
Villaquirán de la Puebla (Burgos)	Вильякиран-де-ла-Пуэбла
Villalbilla de Gumiel (Burgos)	Вильяльбилья-де-Гумьель
Villanueva de Gumiel (Burgos)	Вильянуэва-де-Гумьель
Villaverde del Monte (Burgos)	Вильяверде-дель-Монте
Villaescusa la Sombría (Burgos)	Вильяэскуса-ла-Сомбрия
Villayerno Morquillas (Burgos)	Вильяйерно-Моркильяс
Villegas (Burgos)	Вильегас
Vileña (Burgos)	Виленья
Rezmondo (Burgos)	Ресмондо
Villafruela (Burgos)	Вильяфруэла
Villariezo (Burgos)	Вильярьесо
Villagalijo (Burgos)	Вильягалихо
Rublacedo de Abajo (Burgos)	Рубласедо-де-Абахо
Villamayor de Treviño (Burgos)	Вильямайор-де-Тревиньо
Royuela de Río Franco (Burgos)	Роюэла-де-Рио-Франко
Retuerta (Burgos)	Ретуэрта
Villaldemiro (Burgos)	Вильяльдемиро
Villaverde-Mogina (Burgos)	Вильяверде-Мохина
Revillarruz (Burgos)	Ревильяррус
Villamayor de los Montes (Burgos)	Вильямайор-де-лос-Монтес
Villamedianilla (Burgos)	Вильямедьянилья
Villalmanzo (Burgos)	Вильяльмансо
Villaespasa (Burgos)	Вильяэспаса
Valles de Palenzuela (Burgos)	Вальес-де-Паленсуэла
Quintanaélez (Burgos)	Кинтанаэлес
Vallejera (Burgos)	Вальехера
Vallarta de Bureba (Burgos)	Вальярта-де-Буреба
Redecilla del Campo (Burgos)	Редесилья-дель-Кампо
Quintanabureba (Burgos)	Кинтанабуреба
Quintanaortuño (Burgos)	Кинтанаортуньо
Quintanapalla (Burgos)	Кинтанапалья
Valle de Losa (Burgos)	Валье-де-Лоса
Regumiel de la Sierra (Burgos)	Регумьель-де-ла-Сьерра
Quintanilla Vivar (Burgos)	Кинтанилья-Вивар
Poza de la Sal (Burgos)	Поса-де-ла-Саль
Quintanilla del Agua y Tordueles (Burgos)	Кинтанилья-дель-Агуа-и-Тордуэлес
Quintanilla de la Mata (Burgos)	Кинтанилья-де-ла-Мата
Fuentenebro (Burgos)	Фуэнтенебро
La Revilla y Ahedo (Burgos)	Ла-Ревилья-и-Аедо
Hacinas (Burgos)	Асинас
Prádanos de Bureba (Burgos)	Праданос-де-Буреба
Fresno de Rodilla (Burgos)	Фресно-де-Родилья
La Vid	Ла-Вид
Junta de Villalba de Losa (Burgos)	Хунта-де-Вильяльба-де-Лоса
Hortigüela (Burgos)	Ортигуэла
Villangómez (Burgos)	Вильянгомес
Madrigalejo del Monte (Burgos)	Мадригалехо-дель-Монте
Mahamud (Burgos)	Маамуд
Presencio (Burgos)	Пресенсио
Cilleruelo de Abajo	Сильеруэло-де-Абахо
Madrigal del Monte (Burgos)	Мадригаль-дель-Монте
Manciles (Burgos)	Мансилес
Fuentebureba (Burgos)	Фуэнтебуреба
Padrones de Bureba (Burgos)	Падронес-де-Буреба
Melgar de Fernamental (Burgos)	Мельгар-де-Фернаменталь
Ibrillos (Burgos)	Ибрильос
La Vid de Bureba (Burgos)	Ла-Вид-де-Буреба
Palazuelos de la Sierra (Burgos)	Паласуэлос-де-ла-Сьерра
Merindad de Sotoscueva (Burgos)	Мериндад-де-Сотоскуэва
Castrillo del Val	Кастрильо-дель-Валь
Valdorros (Burgos)	Вальдоррос
Los Ausines (Burgos)	Лос-Аусинес
Merindad de Cuesta-Urria (Burgos)	Мериндад-де-Куэста-Уррия
Los Barrios de Bureba (Burgos)	Лос-Барриос-де-Буреба
Valle de Manzanedo (Burgos)	Валье-де-Мансанедо
Hontoria de Valdearados (Burgos)	Онтория-де-Вальдеарадос
Fuentecén (Burgos)	Фуэнтесен
Miraveche (Burgos)	Миравече
Fresnillo de las Dueñas (Burgos)	Фреснильо-де-лас-Дуэньяс
Piérnigas (Burgos)	Пьернигас
Ciruelos de Cervera	Сируэлос-де-Сервера
Pinilla Trasmonte (Burgos)	Пинилья-Трасмонте
Valdezate (Burgos)	Вальдесате
Trespaderne (Burgos)	Треспадерне
Pineda Trasmonte (Burgos)	Пинеда-Трасмонте
Peral de Arlanza (Burgos)	Пераль-де-Арланса
Puentedura (Burgos)	Пуэнтедура
Cogollos	Когольос
Cerratón de Juarros	Серратон-де-Хуаррос
Mambrillas de Lara (Burgos)	Мамбрильяс-де-Лара
Castrillo de la Reina	Кастрильо-де-ла-Рейна
Merindad de Valdivielso (Burgos)	Мериндад-де-Вальдивьельсо
Modúbar de la Emparedada (Burgos)	Модубар-де-ла-Эмпаредада
Huerta de Rey	Уэрта-де-Рей
Cascajares de Bureba	Каскахарес-де-Буреба
Cayuela	Каюэла
Villalonso	Вильялонсо
Moraleja del Vino	Моралеха-дель-Вино
Castrogonzalo	Кастрогонсало
El Perdigón	Эль-Пердигон
Santa Cristina de la Polvorosa	Санта-Кристина-де-ла-Польвороса
Lubián	Лубьян
Valdefinjas	Вальдефинхас
Morales del Vino	Моралес-дель-Вино
Matilla la Seca	Матилья-ла-Сека
Navasfrías	Навасфриас
Coreses	Коресес
Villalpando	Вильяльпандо
Hermisende	Эрмисенде
Pobladura de Valderaduey	Побладура-де-Вальдерадуэй
Villaralbo	Вильяральбо
Galende	Галенде
Puebla de Sanabria	Пуэбла-де-Санабрия
Roales	Роалес
Mayalde	Маяльде
Robleda	Робледа
Granucillo	Гранусильо
Bogajo	Богахо
Tarazona de Guareña	Тарасона-де-Гуаренья
Gejuelo del Barro	Хехуэло-дель-Барро
Nava de Francia	Нава-де-Франсия
Tardáguila	Тардагила
Encinasola de los Comendadores	Энсинасола-де-лос-Комендадорес
Tordillos	Тордильос
Nava de Sotrobal	Нава-де-Сотробаль
Yecla de Yeltes	Екла-де-Ельтес
Navalmoral de Béjar	Навальмораль-де-Бехар
Trabanca	Трабанка
Garcirrey	Гарсиррей
Navarredonda de la Rinconada	Наварредонда-де-ла-Ринконада
Tejeda y Segoyuela	Техеда-и-Сегоюэла
Escurial de la Sierra	Эскурьяль-де-ла-Сьерра
El Tejado	Эль-Техадо
Barbadillo	Барбадильо
Carrascal de Barregas	Карраскаль-де-Баррегас
Campillo de Azaba	Кампильо-де-Асаба
Aldeacipreste	Альдеасипресте
Ejeme	Эхеме
Calzada de Don Diego	Кальсада-де-Дон-Дьего
Alconada	Альконада
Añover de Tormes	Аньовер-де-Тормес
Aldeavieja de Tormes	Альдеавьеха-де-Тормес
Torresmenudas	Торресменудас
Espino de la Orbada	Эспино-де-ла-Орбада
La Redonda	Ла-Редонда
Moncalvillo (Burgos)	Монкальвильо
Pedralba de la Pradería	Педральба-де-ла-Прадерия
Dios le Guarde	Диос-ле-Гуарде
Galisancho	Галисанчо
Terradillos	Террадильос
Fuenterroble de Salvatierra	Фуэнтерробле-де-Сальватьерра
Almendra (Salamanca)	Альмендра
Estépar (Burgos)	Эстепар
Carrizo	Каррисо
Vallecillo	Вальесильо
Espinosa de Cervera (Burgos)	Эспиноса-де-Сервера
Úrbel del Castillo (Burgos)	Урбель-дель-Кастильо
Grijalba (Burgos)	Грихальба
Benegiles	Бенехилес
Almaraz de Duero	Альмарас-де-Дуэро
Arcenillas	Арсенильяс
Carbajales de Alba	Карбахалес-де-Альба
Argañín	Арганьин
Arrabalde	Аррабальде
Algodre	Альгодре
Bermillo de Sayago	Бермильо-де-Саяго
Arcos de la Polvorosa	Аркос-де-ла-Польвороса
Alcubilla de Nogales	Алькубилья-де-Ногалес
Andavías	Андавиас
Aldeatejada	Альдеатехада
Balboa (León)	Бальбоа (Леон)
Buenamadre	Буэнамадре
Alba de Yeltes	Альба-де-Ельтес
Coca de Alba	Кока-де-Альба
Aldehuela de la Bóveda	Альдеуэла-де-ла-Боведа
Olmedo de Camaces	Ольмедо-де-Камасес
Gomecello	Гомесельо
Cordovilla (Salamanca)	Кордовилья
Herguijuela del Campo	Эргихуэла-дель-Кампо
Fuenteliante	Фуэнтельянте
Herguijuela de Ciudad Rodrigo	Эргихуэла-де-Сьюдад-Родриго
Herguijuela de la Sierra	Эргихуэла-де-ла-Сьерра
Armenteros	Арментерос
Encinas de Arriba	Энсинас-де-Арриба
Hinojosa de Duero	Инохоса-де-Дуэро
Encinas de Abajo	Энсинас-де-Абахо
Cabezabellosa de la Calzada	Кабесабельоса-де-ла-Кальсада
Cristóbal de la Sierra (Salamanca)	Кристобаль-де-ла-Сьерра
La Orbada	Ла-Орбада
La Rinconada de la Sierra	Ла-Ринконада-де-ла-Сьерра
Chagarcía Medianero	Чагарсия-Медьянеро
Berrocal de Salvatierra	Беррокаль-де-Сальватьерра
Manganeses de la Polvorosa	Манганесес-де-ла-Польвороса
Villavendimio	Вильявендимио
Muelas del Pan	Муэлас-дель-Пан
Fuentes de Ropel	Фуэнтес-де-Ропель
Videmala	Видемала
Vezdemarbán	Весдемарбан
Maire de Castroponce	Майре-де-Кастропонсе
Cerecinos del Carrizal	Сересинос-дель-Каррисаль
Villanueva de Campeán	Вильянуэва-де-Кампеан
Brime de Urz	Бриме-де-Урс
Cabañas de Sayago	Кабаньяс-де-Саяго
Pozoantiguo	Посоантигуо
Fresno de la Ribera	Фресно-де-ла-Рибера
Bustillo del Oro	Бустильо-дель-Оро
El Piñero	Эль-Пиньеро
Melgar de Tera	Мельгар-де-Тера
Pinilla de Toro	Пинилья-де-Торо
Sanzoles	Сансолес
Madridanos	Мадриданос
Monfarracinos	Монфаррасинос
Fresno de la Polvorosa	Фресно-де-ла-Польвороса
Entrala	Энтрала
Jambrina	Хамбрина
Villaseco del Pan	Вильясеко-дель-Пан
Castronuevo	Кастронуэво
Fuente Encalada	Фуэнте-Энкалада
Torres del Carrizal	Торрес-дель-Каррисаль
Villardondiego	Вильярдондьего
Calzadilla de Tera	Кальсадилья-де-Тера
Cubo de Benavente	Кубо-де-Бенавенте
Molezuelas de la Carballeda	Молесуэлас-де-ла-Карбальеда
Santibáñez de Vidriales	Сантибаньес-де-Видриалес
Fonfría (Zamora)	Фонфрия (Самора)
San Cristóbal de Entreviñas	Сан-Кристобаль-де-Энтревиньяс
Villar de Fallaves	Вильяр-де-Фальявес
Santa María de Valverde	Санта-Мария-де-Вальверде
Riofrío de Aliste	Риофрио-де-Алисте
Kekaha	Кекаха
Revilla del Campo (Burgos)	Ревилья-дель-Кампо
Humada (Burgos)	Умада
Pampliega (Burgos)	Пампльега
Padilla de Abajo (Burgos)	Падилья-де-Абахо
Valle de las Navas (Burgos)	Валье-де-лас-Навас
Valle de Santibáñez (Burgos)	Валье-де-Сантибаньес
Santa María Rivarredonda (Burgos)	Санта-Мария-Риварредонда
Valle de Oca (Burgos)	Валье-де-Ока
Villaquirán de los Infantes (Burgos)	Вильякиран-де-лос-Инфантес
Valle de Valdelucio (Burgos)	Валье-де-Вальделусио
Rebolledo de la Torre (Burgos)	Ребольедо-де-ла-Торре
Villoruebo (Burgos)	Вильоруэбо
Cubo de Bureba	Кубо-де-Буреба
Cubillos	Кубильос
Viñas	Виньяс
Frías (Burgos)	Фриас
Villasur de Herreros (Burgos)	Вильясур-де-Эррерос
Villasandino (Burgos)	Вильясандино
Santa Cruz del Valle Urbión (Burgos)	Санта-Крус-дель-Валье-Урбион
Revilla Vallejera (Burgos)	Ревилья-Вальехера
Rábanos (Burgos)	Рабанос
Quintanilla San García (Burgos)	Кинтанилья-Сан-Гарсия
Torregalindo (Burgos)	Торрегалиндо
Pineda de la Sierra (Burgos)	Пинеда-де-ла-Сьерра
Pedrosa de Río Úrbel (Burgos)	Педроса-де-Рио-Урбель
Quintanavides (Burgos)	Кинтанилья
Pedrosa del Páramo (Burgos)	Педроса-дель-Парамо
Salas de Bureba (Burgos)	Салас-де-Буреба
Reinoso (Burgos)	Рейносо
Fresno de Río Tirón (Burgos)	Фресно-де-Рио-Тирон
Hontoria de la Cantera (Burgos)	Онтория-де-ла-Кантера
Las Hormazas (Burgos)	Лас-Ормасас
Las Quintanillas (Burgos)	Лас-Кинтанильяс
Frandovínez (Burgos)	Франдовинес
Horcajo de Montemayor	Оркахо-де-Монтемайор
Rosinos de la Requejada	Росинос-де-ла-Рекехада
Villalcampo	Вильялькампо
Quintanilla del Olmo	Кинтанилья-дель-Ольмо
Trefacio	Трефасио
Palacios del Pan	Паласьос-дель-Пан
Venialbo	Вениальбо
Bretó	Брето
Santa Clara de Avedillo	Санта-Клара-де-Аведильо
Otero de Bodas	Отеро-де-Бодас
Ferreras de Arriba	Феррерас-де-Арриба
Peleagonzalo	Пелеагонсало
Pías	Пиас
Tábara	Табара
Fuentespreadas	Фуэнтеспреадас
Villanueva del Campo	Вильянуэва-дель-Кампо
Robleda-Cervantes	Робледа-Сервантес
Valcabado	Валькабадо
Friera de Valverde	Фриера-де-Вальверде
Olmillos de Castro	Ольмильос-де-Кастро
Villadecanes	Вильядеканес
Matilla de Arzón	Матилья-де-Арсон
La Torre del Valle	Ла-Торре-дель-Валье
Aldehuela de Yeltes	Альдеуэла-де-Ельтес
Mombuey	Момбуэй
Fresneña (Burgos)	Фресненья
Monasterio de Rodilla (Burgos)	Монастерио-де-Родилья
Cuelgamures	Куэльгамурес
Coomonte	Коомонте
Huerta de Arriba	Уэрта-де-Арриба
La Hiniesta	Ла-Иньеста
Fuentesaúco	Фуэнтесауко
Arquillinos	Аркильинос
Alfaraz de Sayago	Альфарас-де-Саяго
Almeida de Sayago	Альмейда-де-Саяго
Ayoó de Vidriales	Айоо-де-Видриалес
Molacillos	Моласильос
Huérmeces (Burgos)	Уэрмесес
Brime de Sog	Бриме-де-Сог
Anaya de Alba	Аная-де-Альба
Bretocino	Бретосино
Cubillo del Campo	Кубильо-дель-Кампо
Montamarta	Монтамарта
Micereces de Tera	Мисересес-де-Тера
Moreruela de los Infanzones	Мореруэла-де-лос-Инфансонес
Casaseca de las Chanas	Касасека-де-лас-Чанас
Luelmo	Луэльмо
Santo Domingo de Silos (Burgos)	Санто-Доминго-де-Силос
San Vicente de la Cabeza	Сан-Висенте-де-ла-Кабеса
San Miguel de la Ribera	Сан-Мигель-де-ла-Рибера
Barcial del Barco	Барсьяль-дель-Барко
Santa María de la Vega	Санта-Мария-де-ла-Вега
Torregamones	Торрегамонес
San Pedro de la Nave-Almendra	Сан-Педро-де-ла-Наве-Альмендра
San Pedro de Ceque	Сан-Педро-де-Секе
Santibáñez de Tera	Сантибаньес-де-Тера
Aspariegos	Аспарьегос
Porto (Zamora)	Порто (Самора)
San Vitero	Сан-Витеро
Quintanilla de Urz	Кинтанилья-де-Урс
Salce	Сальсе
Quiruelas de Vidriales	Кируэлас-де-Видриалес
Pueblica de Valverde	Пуэблика-де-Вальверде
San Agustín del Pozo	Сан-Агустин-дель-Посо
Villabuena del Puente	Вильябуэна-дель-Пуэнте
San Cebrián de Castro	Сан-Себриан-де-Кастро
Tabera de Abajo	Табера-де-Абахо
Samir de los Caños	Самир-де-лос-Каньос
Tenebrón	Тенеброн
Villamayor de Campos	Вильямайор-де-Кампос
Vadillo de la Guareña	Вадильо-де-ла-Гуаренья
Tapioles	Тапиолес
Santa Colomba de las Monjas	Санта-Коломба-де-лас-Монхас
Vega de Tera	Вега-де-Тера
Valdescorriel	Вальдескоррьель
Santa Croya de Tera	Санта-Кроя-де-Тера
Pobladura del Valle	Побладура-дель-Валье
Villadepera	Вильядепера
Villarrín de Campos	Вильяррин-де-Кампос
Zamarra	Самарра (Саламанка)
San Esteban del Molar	Сан-Эстебан-дель-Молар
Revellinos	Ревельинос
Villárdiga	Вильярдига
Vallesa de la Guareña	Вальеса-де-ла-Гуаренья
San Miguel del Valle	Сан-Мигель-дель-Валье
Robliza de Cojos	Роблиса-де-Кохос
Rucandio (Burgos)	Рукандио
Fresnedoso	Фреснедосо
Nava de Béjar	Нава-де-Бехар
Narros de Matalayegua	Наррос-де-Маталайегуа
Fresno Alhándiga	Фресно-Альхандига
Florida de Liébana	Флорида-де-Льебана
Navales	Навалес
Navacarros	Навакаррос
La Bastida	Ла-Бастида
La Fregeneda	Ла-Фрехенеда
Muga de Sayago	Муга-де-Саяго
Cobreros	Кобрерос
Villar del Buey	Вильяр-дель-Буэй
El Pego	Эль-Пего
Moraleja de Sayago	Моралеха-де-Саяго
Villageriz	Вильяхерис
Perilla de Castro	Перилья-де-Кастро
Mahide	Маиде
Moralina	Моралина
Pajares de la Lampreana	Пахарес-де-ла-Лампреана
Cerecinos de Campos	Сересинос-де-Кампос
Morales de Valverde	Моралес-де-Вальверде
Fresno de Sayago	Фресно-де-Саяго
Villalba de la Lampreana	Вильяльба-де-ла-Лампреана
Villamor de los Escuderos	Вильямор-де-лос-Эскудерос
Vega de Villalobos	Вега-де-Вильялобос
Moral de Sayago	Мораль-де-Саяго
Rionegro del Puente	Рионегро-дель-Пуэнте
Pereruela	Переруэла
Muelas de los Caballeros	Муэлас-де-лос-Кабальерос
Morales de Rey	Моралес-де-Рей
Fuentelapeña	Фуэнтелапенья
Piedrahita de Castro	Пьедраита-де-Кастро
Roelos	Роэлос
Espadañedo	Эспаданьедо
Villabrázaro	Вильябрасаро
Villardeciervos	Вильярдесьервос
Uña de Quintana	Унья-де-Кинтана
Prado (Zamora)	Прадо (Самора)
Cotanes del Monte	Котанес-дель-Монте
Navianos de Valverde	Навьянос-де-Вальверде
Palacios de Sanabria	Паласьос-де-Санабрия
Cernadilla	Сернадилья
Santa Cecilia (Burgos)	Санта-Сесилия (Бургос)
Larrodrigo	Ларродриго
La Bóveda de Toro	Ла-Боведа-де-Торо
Manganeses de la Lampreana	Манганесес-де-ла-Лампреана
Endrinal (Salamanca)	Эндриналь
Espeja	Эспеха
Rágama	Рагама (Испания)
El Cerro (Salamanca)	Эль-Серро
El Cubo del Vino	Эль-Кубо-дель-Вино
Villanueva de Azoague	Вильянуэва-де-Асоаге
La Alameda de Gardón	Ла-Аламеда-де-Гардон
La Alamedilla	Ла-Аламедилья
Galindo y Perahuy	Галиндо-и-Перауй
La Cabeza de Béjar	Ла-Кабеса-де-Бехар
Galinduste	Галиндусте
Arcos (Burgos)	Аркос-де-ла-Льяна
Justel	Хустель
Ledrada	Ледрада
La Hoya (Salamanca)	Ла-Ойя
Guarrate	Гуаррате
Gallegos de Argañán	Гальегос-де-Арганьян
La Alberguería de Argañán	Ла-Альбергерия-де-Арганьян
Horcajo Medianero	Оркахо-Медьянеро
Arcediano	Арседьяно
Candelario	Канделарио
Guadramiro	Гуадрамиро
Boada	Боада
Manzanal de Arriba	Мансаналь-де-Арриба
Gallegos de Solmirón	Гальегос-де-Сольмирон
Juzbado	Хусбадо
Golpejas	Гольпехас
La Tala	Ла-Тала
Gamones	Гамонес
Granja de Moreruela	Гранха-де-Мореруэла
Asturianos	Астурьянос
Argujillo	Аргухильо
Castroverde de Campos	Кастроверде-де-Кампос
Castrillo de la Guareña	Кастрильо-де-ла-Гуаренья
Carbellino	Карбельино
Los Altos (Burgos)	Лос-Альтос (Испания)
Lehua	Лехуа
Hanamāʻulu	Ханамаулу
ʻŌmaʻo	Омао
Kīlauea (Kauaʻi)	Килауеа
Māʻalaea	Маалаеа
Retortillo (Salamanca)	Ретортильо
El Arco	Эль-Арко
Villalobos	Вильялобос (муниципалитет)
Villaveza de Valverde	Вильявеса-де-Вальверде
Quintanilla del Monte	Кинтанилья-дель-Монте
Rábano de Aliste	Рабано-де-Алисте
Ferreruela	Ферреруэла
Villanueva de las Peras	Вильянуэва-де-лас-Перас
San Justo (Zamora)	Сан-Хусто
Villaferrueña	Вильяферруэнья
Fariza	Фариса
Villaescusa (Zamora)	Вильяэскуса
Malva (Zamora)	Мальва (Самора)
Cantagallo	Кантагальо
Kaumakani	Каумакани
Pukalani	Пукалани
Puhi	Пухи
Páginas da Vida	Страницы жизни
Māhele:Disambig	Категория:Многозначные термины
Valle de Valdelaguna (Burgos)	Валье-де-Вальделагуна
San Juan del Monte (Burgos)	Сан-Хуан-дель-Монте
Haza (Burgos)	Аса (Бургос)
Beleña	Беленья
Cavia (Burgos)	Кавия
Lagunilla	Лагунилья
Gajates	Гахатес
Rojas (Burgos)	Рохас (Бургос)
Fuentes de Béjar	Фуэнтес-де-Бехар
Santa Inés (Burgos)	Санта-Инес (Испания)
Guijo de Ávila	Гихо-де-Авила
Contreras	Контрерас (Бургос)
Buenavista	Буэнависта (Саламанка)
Isar (Burgos)	Исар
Kualapuʻu	Куалапуу
Afega	Афега
Huerta (Salamanca)	Уэрта (Саламанка)
Albert Küchler	Кюхлер, Альберт
Waikapū	Ваикапу
Wailua	Ваилуа (поселение)
Māʻili	Маили (Гавайи)
Maraghar lukua	Резня в Мараге
Hāliʻimaile	Халиимаиле
Pāʻia	Паиа
Bochotnica	Бохотница
Sanna Nielsen	Нильсен, Санна
Makawao	Макавао
Hanapēpē	Ханапепе
Kōloa	Колоа
Kalihiwai	Калихиваи
Mākaha	Макаха
ʻEleʻele (Kauaʻi)	Еле-еле
Anahola	Анахола
Maunaloa	Мауналоа
Kahaluʻu	Кахалуу
Lāwaʻi	Лаваи
Hanalei	Ханалеи (поселение)
Kalāheo	Калахео
Conrad Bain	Бэйн, Конрад
Māhele:Nā ‘āinapuni‘ole	Категория:Континенты
Waimea (Kauaʻi)	Ваимеа (округ Кауаи)
Zoboomafoo	Zoboomafoo
Anakuhi:Nā hōkū hele o ke kahua o nā hōkū	Шаблон:Солнечная система
Anakuhi:WikipediaLang	Шаблон:Wikipedialang
Wikipedia:Nā kahu	Википедия:Администраторы
Wikipedia:Nā noi e ho‘oki‘eki‘e	Википедия:Заявки на статус администратора
Wikipedia:Lopako	Википедия:Бот
‘Aikupika	Египет
Anakuhi:Lopako	Шаблон:Bot
Kanakā	Канада
Māhele:Hunakalia	Категория:Венгрия
Māhele:Helene	Категория:Греция
Māhele:Solowakia	Категория:Словакия
Māhele:ʻEulopa	Категория:Европа
Māhele:Wikipedians by language	Категория:Википедия:Участники по языкам
Wikipedia:‘Ōmuku	Википедия:Заготовка статьи
Sung Jae-gi	Сон Джэги
Anakuhi:Softredirect	Шаблон:Soft redirect
Anakuhi:Kāpae	Шаблон:К быстрому удалению
Māhele:‘Ōlelo	Категория:Языки
Māhele:Wikipikia	Категория:Википедия
Wikipedia:Nā a‘o ‘ana laulā	Википедия:Отказ от ответственности
Wikipedia:Manuale Kaila	Википедия:Оформление статей
Anakuhi:Navbox	Шаблон:Navbox
Don Keefer	Кифер, Дон
Nina Andrycz	Андрыч, Нина
Anakuhi:Tnavbar	Шаблон:Tnavbar
Māhele:ʻApelika	Категория:Африка
Anakuhi:Papela	Шаблон:Babel
Anakuhi:Commons	Шаблон:Commons
Anakuhi:ʻŌmuku	Шаблон:Заготовка
Anakuhi:User de	Шаблон:User de
Anakuhi:User en	Шаблон:User en
Anakuhi:User fr	Шаблон:User fr
Māhele:ʻĀkia	Категория:Азия
Māhele:21st century	Категория:XXI век
Māhele:Castille a Leon	Категория:Кастилия и Леон
Anakuhi:Mod	Шаблон:Mod
Anakuhi:Aloha	Шаблон:Приветствие
Anakuhi:Wikipediasister	Шаблон:Сообщество Википедии
Anakuhi:Wide image	Шаблон:Панорама
Māhele:Palika	Категория:Париж
Māhele:User en	Категория:User en
Anakuhi:Navbox/core	Шаблон:Navbox/core
Anakuhi:User ru	Шаблон:User ru
Māhele:Nā hōkū hele o ke kahua o nā hōkū	Категория:Планеты Солнечной системы
Anakuhi:Ho‘okele nā makahiki	Шаблон:Навигация для года
Anakuhi:Pule	Шаблон:Неделя
Anakuhi:Huaʻōlelo puana like	Шаблон:Неоднозначность
Māhele:Aliʻi o Hawai‘i	Категория:Гавайские короли
Anakuhi:UsersSpeak	Шаблон:UsersSpeak
Anakuhi:Nā ‘āinapuni‘ole	Шаблон:Континенты
Māhele:User fr	Категория:User fr
Māhele:Panalāʻau o Quảng Binh	Категория:Куангбинь
Māhele:User de	Категория:User de
Māhele:User de-N	Категория:User de-N
Māhele:User en-N	Категория:User en-N
Anakuhi:ʻŌnaehana helu	Шаблон:Числа
Anakuhi:Pinares	Шаблон:Муниципалитеты района Пинарес (комарка)
Māhele:Huli kanaka	Категория:Общественные науки
Māhele:Kahawai o Palani	Категория:Реки Франции
Māhele:User ru	Категория:User ru
Anakuhi:Sepania	Шаблон:Автономные сообщества Испании на карте
Māhele:Kahaki‘i	Категория:Художники
Māhele:Hawai‘i	Категория:Гавайи
Māhele:Kanaka o Hawaiʻi	Категория:Персоналии:Гавайи
Māhele:Panalā‘au o Granada	Категория:Муниципалитеты Гранады
Māhele:Kelewikiona	Категория:Телевидение
Māhele:Nolewai	Категория:Норвегия
Māhele:Nā moana	Категория:Океаны
Māhele:Kapikala	Категория:Столицы государств
Māhele:Honolulu	Категория:Гонолулу
Māhele:Panalā‘au o Burgos	Категория:Муниципалитеты Бургоса
Māhele:Panalā‘au o Zamora	Категория:Муниципалитеты Саморы
Trojany	Трояны (Мазовецкое воеводство)
Māhele:Panalā‘au o Salamanca	Категория:Саламанка
Māhele:Haku mele (ho‘okani)	Категория:Композиторы
Māhele:ʻĀpana o Hawaiʻi	Категория:Статистически обособленные местности Гавайев
Anakuhi:Nā kapikala o nā moku‘āina o ‘Amelika Hui	Шаблон:Административные центры штатов США
Anakuhi:Puke o Molemona	Шаблон:Состав Книги Мормона
Module:Arguments	Модуль:Arguments
Papa nui:NāLoliHou	Служебная:Свежие правки
Module:HtmlBuilder	Модуль:HtmlBuilder
Module:Navbox	Модуль:Navbox
