អាហ្វ្រិក	Африка
ជប៉ុន	Япония
អង់គ្លេស	Англия
ស្កុតឡែន	Шотландия
វ៉ែល	Уэльс
អៀរឡង់ខាងជើង	Северная Ирландия
សាធារណរដ្ឋអៀរឡង់	Ирландия
ប្រទេសហុងគ្រី	Венгрия
អេស្ប៉ាញ	Испания
សហរដ្ឋអាមេរិក	Соединённые Штаты Америки
ផែនដី	Земля
ប៊ឺណឺស លី	Бернерс-Ли, Тим
ស៊ុយអែត	Швеция
ប្រទេសប៉ូឡូញ	Польша
អ៊ីតាលី	Италия
ព័រទុយហ្គាល់	Португалия
អឺរ៉ុប	Европа
អាស៊ី	Азия
វិគីភីឌា	Википедия
ភីអេចភី	PHP
ទីក្រុងញូវយ៉ក	Нью-Йорк
កុំព្យូទ័រ	Компьютер
អ៊ីនធើណេត	Интернет
បារ៉ាក់ អូបាម៉ា	Обама, Барак
ប៉ារីស	Париж
អាប្រាហាម លីនខូន	Линкольн, Авраам
ប្រព័ន្ធប្រតិបត្តការ Android	Android
Google ស្វែងរក	Google (компания)
ម៉ិកស៊ិក	Мексика
មហាសមុទ្រអាត្លង់ទិក	Атлантический океан
មហាសមុទ្រប៉ាស៊ីហ្វិក	Тихий океан
ថ្ងៃច័ន្ទ	Понедельник
ខែមករា	Январь
ខែកុម្ភៈ	Февраль
ខែមីនា	Март
ភពអង្គារ	Марс
ខែមេសា	Апрель
ខែឧសភា	Май
ខែមិថុនា	Июнь
ខែកក្កដា	Июль
ខែសីហា	Август
ខែកញ្ញា	Сентябрь
ខែតុលា	Октябрь
ខែវិច្ឆិកា	Ноябрь
ខែធ្នូ	Декабрь
អង្គារ	Вторник
ថ្ងៃពុធ	Среда
ថ្ងៃព្រហស្បតិ៍	Четверг
ថ្ងៃសុក្រ	Пятница
ថ្ងៃសៅរ៍	Суббота
ថ្ងៃអាទិត្យ	Воскресенье
សេះ (​អុក​)	Конь (шахматы)
បារាំង	Франция
សត្វឆ្កែ	Собака
រាជាណាចក្ររួម	Великобритания
ឆ្មា	Кошка
ភាសាបារាំង	Французский язык
ប្រេស៊ីល	Бразилия
រុស្ស៊ី	Россия
ការ៉េ	Квадрат
សមុទ្រ	Море
អាល្លឺម៉ង់	Германия
ភាសាអាល្លឺម៉ង់	Немецкий язык
ប្រទេសអាយឡែន	Исландия
ភពសៅរ៍	Сатурн
១ (លេខ)	1 (число)
២ (លេខ)	2 (число)
៣ (លេខ)	3 (число)
៥	5 (число)
ចតុកោណកែង	Прямоугольник
មុំកែង	Прямой угол
អ៊ុយក្រែន	Украина
ទីក្រុងរ៉ូម	Рим
អាល់បានី	Албания
អាស៊ែបៃហ្សង់	Азербайджан
អង់ដូរ៉ា	Андорра
សាធារណរដ្ឋកាហ្សាក់ស្ថាន	Казахстан
បុរីវ៉ាទីកង់	Ватикан
គុយបា	Куба
ឥណ្ឌូនេស៊ី	Индонезия
អាហ្វ្រិកខាងត្បូង	Южно-Африканская Республика
ប្រវត្តិសង្ខេប ក្រុមតន្រ្តី រ៉ុក linkin park	Linkin Park
ប្រទេសអាល់ហ្សេរី	Алжир
ស្រា	Вино
ទឹក	Вода
ទូរទស្សន៏	Телевидение
ភាសាអាយឡែន	Исландский язык
ឈីលី	Чили
ព្រះយេស៊ូវ គ្រីស្ទ	Иисус Христос
ភពពុធ	Меркурий
ប្រវត្តិសាស្ត្រ	История
ភពសុក្រ	Венера
ភាសា	Язык
ភពព្រហស្បតិ៍	Юпитер
ភពអ៊ុយរ៉ានុស	Уран (планета)
វិគីភីឌាភាសាអង់គ្លេស	Английская Википедия
ភពណិបទូន	Нептун
សិង្ហបុរី	Сингапур
ភ្លុយតុង	Плутон
ហ្វេសប៊ុក	Facebook
សង្គ្រាមលោកលើកទីមួយ	Первая мировая война
សង្គ្រាមលោកលើកទី២	Вторая мировая война
ទំព័រគំរូ:Corruption	Коррупция
Ubuntu	Ubuntu
លីនុច	Linux
គណិតវិទ្យា	Математика
បារ៉ែន	Бахрейн
ព្រះចន្ទ	Луна
អូស្ត្រាលី	Австралия
រូបវិទ្យា	Физика
ជីវវិទ្យា	Биология
កូរ៉េខាងជើង	Корейская Народно-Демократическая Республика
ព្រះរាជាណាចក្រកម្ពុជា	Камбоджа
ឌីណូស័រ	Динозавры
សាសនាឥស្លាម	Ислам
សេរីភាព	Мир (отсутствие войны)
សហភាពអឺរ៉ុប	Европейский союз
ចេក	Банан
ណាប៉ូលេអុងបូណាប៉ារត៍	Наполеон I
ព្រះអាទិត្យ	Солнце
ឆ្នាំពន្លឺ	Световой год
អូសេអានី	Океания
ប្រព័ន្ធព្រះអាទិត្យ	Солнечная система
អុីដ្រូសែន	Водород
ទីម័រខាងកើត	Восточный Тимор
ម៉ុង ប្លុង	Монблан
សឺរេស	Церера
អៀរីស	Эрида
ភព	Планета
តន្ត្រី	Музыка
ភាសាអ៊ីតាលី	Итальянский язык
អាលុយមីញ៉ូម	Алюминий
នូវែលសេឡង់	Новая Зеландия
ឥណ្ឌា	Индия
អង់ដ្រេ ម៉ារី អំពែរ	Ампер, Андре-Мари
វីលីម ហ្សេកស្ពែរ	Шекспир, Уильям
ប៉ាឡាវ	Палау
ម៉ុងហ្គោលី	Монголия
ជេនហ្គិស ខាន់	Чингисхан
កូឡុំប៊ី	Колумбия
ព្រះពុទ្ធសាសនា	Буддизм
ហ្គាតេម៉ាឡា	Гватемала
មហាសមុទ្រអាកទិក	Северный Ледовитый океан
អ៊ីរ៉ង់	Иран
ភាសាប៉ូឡូញ	Польский язык
ហ្សកដង់	Иордания
កៀហ៊្សីស៊ីស្ថាន	Киргизия
គុយវ៉ែត	Кувейт
ឡាវ	Лаос
លីបង់	Ливан
ទ្វីបអាមេរិក	Америка
ម៉ាឡេស៊ី	Малайзия
មីយ៉ាន់ម៉ា	Мьянма
នេប៉ាល់	Непал
ប៉ាគីស្ថាន	Пакистан
MySQL	MySQL
អារ៉ាប៊ីសាអូឌីត	Саудовская Аравия
ស្រីលង្កា	Шри-Ланка
ផ្លាតូ	Платон
តាជីគីស្ថាន	Таджикистан
YouTube	YouTube
អារីស្តូត	Аристотель
ថៃ	Таиланд
វិទ្យុ	Радио
តួរមិនីស្ថាន	Туркмения
វៀតណាម	Вьетнам
កូរ៉េខាងត្បូង	Республика Корея
សាធារណរដ្ឋឥស្លាមអាហ្វហ្កានីស្ថាន	Афганистан
ព្រែកជីកស៊ុយអែស	Суэцкий канал
បង់ក្លាដែស្ស	Бангладеш
សូក្រាត	Сократ
ធ្វិតថឺរ	Твиттер
ប៊្រុយណេ	Бруней
ហ្វីលីពីន	Филиппины
អ៊ីសាក់ ញូតុន	Ньютон, Исаак
OpenStreetMap	OpenStreetMap
អាល់បឺត អែងស្តែង	Эйнштейн, Альберт
ប្រទេសហ្សំប៊ី	Замбия
ប៉េកាំង	Пекин
មហាត្មះគន្ធី	Махатма Ганди
ឆាលែស ដាវីន	Дарвин, Чарлз
ជូលីស៍ សេសារ	Гай Юлий Цезарь
ឥន្ទធនូ	Радуга
អង្គការសហប្រជាជាតិ	Организация Объединённых Наций
ភូមិវិទ្យា	География
ទីក្រុងប្រាក	Прага
បន្ទុកអគ្គីសនី	Электрический заряд
ខេត្តជើងភ្នំ (ប្រទេសអ៊ីតាលី)	Пьемонт
មហាសមុទ្រឥណ្ឌា	Индийский океан
អូសាម៉ា ប៊ីន ឡាឌែន	Усама бен Ладен
ភាសាអេស្ប៉ាញ	Испанский язык
ភីឡាដេលផ្យា	Филадельфия
ញូវយ៉ក	Нью-Йорк (штат)
វ្លាឌីមៀរ អ៊ីលីច លេនីន	Ленин, Владимир Ильич
អូហ្គុសទុស	Октавиан Август
លោកកៃយុសសេសារ	Калигула
ត្រាហ្សាន	Траян
Kde	KDE
កូរ៉ាស៊ូន អាគីណូ	Акино, Корасон
ទីក្រុងតូខ្យូ	Токио
ហ្វឺឌីណាន់ដ៏ ម៉ាហ្សេឡង់	Магеллан, Фернан
ស៊ីសេរ៉ូ	Марк Туллий Цицерон
ភ្នំពេញ	Пномпень
ទីក្រុងព្រៃនគរ	Хошимин
ទីក្រុងហានូយ	Ханой
គ្រិស្តសាសនា	Церковь истинного Иисуса
ភាសាអង់គ្លេស	Английский язык
គូឡាឡាំពួ	Куала-Лумпур
២០០១	2001 год
JavaScript	JavaScript
HTML5	HTML5
ល្បឿនពន្លឺ	Скорость света
JPEG	JPEG
អេឡិចត្រុង	Электрон
ចក្រភព រ៉ូម	Римская империя
Microsoft	Microsoft
គីមីវិទ្យា	Химия
ស៊ីទ្រុងជ្រូក	C Sharp
បេណេឌីកទី១៦	Бенедикт XVI
៧ កក្កដា	7 июля
បាល់ទាត់	Футбол
ទីក្រុងបូកូតា	Богота
ថ្ងៃទី៣១ខែធ្នូ	31 декабря
រិសថា	(4) Веста
ស៊ីដនីយ៏	Сидней
ភ្លើង	Огонь
ខ្យល់	Атмосфера Земли
កោះស៊ូម៉ាត្រា	Суматра
ចាការតា	Джакарта
ចំណាត់ថ្នាក់ក្រុម:Wikipedia templates	Категория:Википедия:Шаблоны
កោះជ្វា	Ява
ចំណាត់ថ្នាក់ក្រុម:ចំណាត់ថ្នាក់ក្រុមនៃទំព័រគំរូវិគីភីឌា	Категория:Шаблоны по темам
កាលីម៉ាន់តាន់	Индонезийский Калимантан
ខេត្តបន្ទាយមានជ័យ	Бантеаймеантьей
វិគីភីឌា:ប្រអប់ខ្សាច់	Википедия:Песочница
អាកាសយានដ្ឋាន ដុង ហ៊យ	Донгхой (аэропорт)
អាន់ ហ្វ្រែង	Франк, Анна
ខុង ជឺ	Конфуций
ម៉ារីលីន ម៉ុនរ៉ូ	Мэрилин Монро
ចំណាត់ថ្នាក់ក្រុម:គណិតវិទ្យា	Категория:Математика
ទំព័រគំរូ:ទិន្នន័យប្រទេស អ៊ីរ៉ង់	Шаблон:Флагификация/Иран
ចំណាត់ថ្នាក់ក្រុម:ប្រវត្តិសាស្ត្រខ្មែរ	Категория:История Камбоджи
ចំណាត់ថ្នាក់ក្រុម:ប្រវត្តិសាស្រ្តសិង្ហបុរី	Категория:История Сингапура
សមុទ្រ មេឌីទែរ៉ានេ	Средиземное море
វីនដូអេច	Windows 8
ទំព័រគំរូ:ប្រទេសនៅទ្វីបអាស៊ី	Шаблон:Страны Азии
ទំព័រគំរូ:Agree	Шаблон:За
ទន្លេហ្គារ៉ូន	Гаронна
ស៊ីតថល	Сиэтл
ជញ្ជាំង ប៊ែរឡាំង	Берлинская стена
ស្រូវ	Рис (продукт питания)
ទំព័រគំរូ:Lang-tr	Шаблон:Lang-tr
ទំព័រគំរូ:ផតថល	Шаблон:Портал
ទំព័រគំរូ:តំបន់នៃពិភពលោក	Шаблон:Регионы мира
ប៊ីល ហ្គេត	Гейтс, Билл
ភាសាជប៉ុន	Японский язык
ប្រជុំវីជ្ជា	Энциклопедия
ឌីវីឌី	DVD
ទំព័រដើម	Заглавная страница
Central processing unit	Процессор
រេស៊ីស្ទ័រ	Резистор
កីឡាអូឡាំពិក	Олимпийские игры
សមុទ្រ កាសព្យែន	Каспийское море
ឈី ហ្គីវ៉ារ៉ា	Че Гевара, Эрнесто
ទីក្រុងកាបូល	Кабул
ហ្គ្រាប្រីអ៊ែល ហ្រ្គារ៉ាស្សៀ ម៉ារ៉ាហ្គេស	Гарсиа Маркес, Габриэль
ទស្សនវិជ្ជា	Философия
ចំណាត់ថ្នាក់ក្រុម:លុប	Категория:Википедия:К быстрому удалению
លិទ្ធិកុម្មុយនិស្ត	Коммунизм
ហ៊ីលឡារី រូដហេម គ្លីនតុន	Клинтон, Хиллари
Boeing 737	Boeing 737
អាហារនៅប្រទេសបារំាង និង របៀបធ្វើ	Французская кухня
មណ្ឌលម៉ាញេតូ	Магнитосфера
UTC+7	UTC+07:00
ភាសាកាតាឡាន	Каталанский язык
បណ្ណាល័យ	Библиотека
នីល ហេនរីក ដេវីដ ប៊័រ	Бор, Нильс
និវេសនវិទ្យា	Экология
ក្លឹបបាល់ទាត់បារសេឡូណា	Барселона (футбольный клуб)
នយោបាយ	Политика
ធនាគារពិភពលោក	Всемирный банк
ប្រជាធិបតេយ្យ	Демократия
អង្គការសន្ធិសញ្ញាអាត្លង់ទិកខាងជើង	Организация Североатлантического договора
ម៉ារី ស្កូដូស្កា គុយរី	Склодовская-Кюри, Мария
រង្វាន់ណូបែល	Нобелевская премия
មជ្ឈិមបូព៌ា	Средний Восток
រាជវង្សហាន	Хань (династия)
ប្រទេស	Государство
គ្រឹស្តុបផើ កូឡំបូស (Christopher Columbus)	Колумб, Христофор
ព្រែកជីកប៉ាណាម៉ា	Панамский канал
មហាសមុទ្រខាងត្បូង	Южный океан
ត្រីផ្សោតនៅកម្ពុជា	Дельфины
ក្មេង	Ребёнок
លេអុនហាដ អយល័រ	Эйлер, Леонард
ណាប៉ូលេអុងទី៣	Наполеон III
ភាសារុស្ស៊ី	Русский язык
ល្វី ដ៏អស្ចារ្យ	Людовик XIV
សមាគមប្រជាជាតិអាស៊ីអាគ្នេយ៍	Ассоциация государств Юго-Восточной Азии
ប្រវត្តិសាស្ត្របារាំង	История Франции
តុលាការយុត្តិធម៌អន្តរជាតិ	Международный суд ООН
យូណេស្កូ	ЮНЕСКО
អង្គការសុខភាពពិភពលោក	Всемирная организация здравоохранения
អង្គការពាណិជ្ជកម្មពិភពលោក	Всемирная торговая организация
ភាសាចិន	Китайский язык
ធម្មជាតិ	Природа
ឈាម	Кровь
រញ្ជួយផែនដី	Землетрясение
សមុទ្រឡាប់តែវ	Море Лаптевых
ភ្លើងចរាចរ	Светофор
ម៉ាទីន ឡូតធឺរ ឃីង	Кинг, Мартин Лютер
ត្រីកោណមាត្រ	Тригонометрия
ធរណីមាត្រ	Геометрия
វេយ្យាករណ៍	Грамматика
សេដ្ឋកិច្ច	Экономика (наука)
អក្សរក្រិច	Греческий алфавит
អក្សរឡាតាំង	Латинский алфавит
រឿងមហាភារតយុទ្ធ	Махабхарата
ការិយាល័យសហព័ន្ធស៊ើបអង្កេត	Федеральное бюро расследований
វីយោឡុង	Скрипка
ឃឹម	Цимбалы
អេឡិចសាន់ដឺ ដឹ ហ្គារ៉ែត	Александр Македонский
សង្គម	Общество
ការអប់រំ	Образование
មនុស្សប្រុស	Мужчина
វិគីភីឌាភាសាអេស៉្បាញ	Испанская Википедия
សិទ្ធិមនុស្ស	Права человека
ទាសភាព	Рабство
សង្គ្រាមស៊ីវិល	Гражданская война
ភ្នំ	Гора
ហុងកុង	Гонконг
សង្គ្រាមត្រជាក់	Холодная война
សេអ៊ូល	Сеул
សង្គ្រាមវៀតណាម	Война во Вьетнаме
ម៉ៃឃើល ហ្វារ៉ាដេយ	Фарадей, Майкл
អង់រីកូ ហ្វែរមី	Ферми, Энрико
ភាសាអ៊ុយក្រែន	Украинский язык
HTML	HTML
ច្យូហានេស គូទេនបឺគ	Гутенберг, Иоганн
ភាសាដាណឺម៉ាក	Датский язык
ភាសាអេស្តូនី	Эстонский язык
ហិណ្ឌូសាសនា	Индуизм
ភាសាពែក	Персидский язык
សាសនា	Религия
ភាសាកូរ៉េ	Корейский язык
ភាសាខ្មែរ	Кхмерский язык
ហ្រ្គេតស៊ីងមួន	Фрейд, Зигмунд
ភាសាថៃ	Тайский язык
ភាសាម៉ាឡេ	Малайский язык
ភាសាឥណ្ឌូនេស៊ី	Индонезийский язык
ភាសាហេប្រ៊ូ	Иврит
ចន ឡុក	Локк, Джон
ថ្លើម	Печень
ចិត្តវិទ្យា	Психология
មហាសមុទ្រ	Океан
ពុទ្ធប្រវត្តិសង្ខេប	Будда Шакьямуни
ចរិយាមារយាទ	Этика
សារជីវកម្មផ្សព្វផ្សាយព័ត៌មានរបស់ចក្រភពអង់គ្លេស(BBC)	Би-би-си
ក្លិបបាល់ទាត់ឆេលស៊ី	Челси (футбольный клуб)
គ្រោងឆ្អឹងមនុស្ស	Скелет человека
ក (អវយវៈ)	Шея
រាជវង្សថាង	Тан (династия)
John F. Kennedy	Кеннеди, Джон Фицджеральд
LibreOffice	LibreOffice
ផ្លូវរូងដីក្រោមសមុទ្រ	Евротоннель
តារាងខួបនៃធាតុគីមី	Периодическая система химических элементов
ប្រូម៉ាស	Сыр
ទំពាំងបាយជូរ	Виноград (ягода)
បន្លែ	Овощи
បច្ចេកវិទ្យា	Технология
វិស្វកម្ម	Инженерное дело
ទំនាក់ទំនង	Общение
វិជ្ជាជីវៈខាងសារព័ត៌មាន	Журналистика
កាសែត	Газета
ទូរស័ព្ទ	Телефон
វប្បធម៌	Культура
សំស្ក្រឹត	Санскрит
ប្រដាប់របត់ឈាម	Кровообращение
The Guardian	The Guardian
សមីការឌីផេរ៉ង់ស្យែល	Дифференциальное уравнение
មៃក្រូសូហ្វអ៊ិសេល	Microsoft Excel
មុំ	Угол
សំទុះ	Ускорение
ព្រះសិវៈ	Шива
ព្រះវិស្ណុ	Вишну
Local Area Network	Локальная вычислительная сеть
Wide Area Network	Глобальная компьютерная сеть
ព្រះព្រហ្ម	Брахма
កម្លាំង	Сила
កសិកម្ម	Сельское хозяйство
សំលៀកបំពាក់	Одежда
ល្បឿន	Скорость
ក្រដាស	Бумага
សុញ្ញកាស	Вакуум
ស៊ីនេម៉ាទិច	Кинематика точки
ក្រលាផ្ទៃ	Площадь
ទ្រឹស្តីបទពីតាករ	Теорема Пифагора
ចំនួនកុំផ្លិច	Комплексное число
Cristiano Ronaldo	Криштиану Роналду
អ្នកថតរូប	Фотография
ល្ខោន	Театр
គ្រឿងអេឡិចត្រូនិច	Электронные компоненты
ព័ត៌មានវិទ្យា	Информационные технологии
អាស៊ីអាគ្នេយ៍	Юго-Восточная Азия
ក្រុងសៀមរាប	Сиемреап (город)
បញ្ជីរាយនាម ប្រទេស	Алфавитный список стран и территорий
វិគីភីឌាភាសាព័រទុយហ្គាល់	Португальская Википедия
ប្រដាប់រំលាយអាហារ	Пищеварение
កីឡាចាក់សាប	Фехтование
រោគផ្ដាសាយធម្មតា	Назофарингит
រោគសរសៃប្រសាទ	Психическое расстройство
ប្រតិទិន ក្រេកូរី	Григорианский календарь
សុខភាព	Здоровье
ជម្ងឺរលាកទងសួត	Пневмония
ជំងឺអេដស៍	ВИЧ-инфекция
កូដ QR	QR-код
ជំងឺទឹកនោមផ្អែម	Сахарный диабет
ទំព័រគំរូ:Location map Belgium	Шаблон:ПозКарта Бельгия
ទំព័រគំរូ:Location map Croatia	Шаблон:ПозКарта Хорватия
ទំព័រគំរូ:Location map Ukraine	Шаблон:ПозКарта Украина
ទំព័រគំរូ:Location map Burma	Шаблон:ПозКарта Мьянма
ទំព័រគំរូ:Location map Philippines	Шаблон:ПозКарта Филиппины
ទំព័រគំរូ:Location map Vietnam	Шаблон:ПозКарта Вьетнам
ទំព័រគំរូ:Location map Cambodia	Шаблон:ПозКарта Камбоджа
ទំព័រគំរូ:Location map Thailand	Шаблон:ПозКарта Таиланд
ទំព័រគំរូ:Location map Indonesia	Шаблон:ПозКарта Индонезия
ទំព័រគំរូ:Location map Australia	Шаблон:ПозКарта Австралия
ញូតុន	Ньютон (единица измерения)
ចក្រភព អូតូម៉ង់	Османская империя
ម៉ាស៊ីនចំហេះក្នុង	Двигатель внутреннего сгорания
ក្បាច់គិតលេខ	Абак
វឺតប្រែស	WordPress
Joomla!	Joomla!
ដើមដូង	Кокосовая пальма
ភាសាណាវ៉ាថ្ល៍	Астекские языки
ភាសាម៉ាយ៉ាយូកាតិក	Юкатекский язык
អែនជេលីណា ចូលី	Джоли, Анджелина
អ៊ីលដឺហ្រ្វែន	Иль-де-Франс
ភាសាអារ៉ាប់	Арабский язык
Thanksgiving	День благодарения
តំបន់ឃ្ជឺស្សឺ	Кюсю
តំបន់ស៊ីកុគឹ	Сикоку
នាយករដ្ឋមន្ត្រី	Премьер-министр
ទង់ជាតិ	Флаг
ខ្មៅដៃ	Карандаш
សហភាពសូវៀត	Союз Советских Социалистических Республик
ចំណុចរលាយ	Температура плавления
កាមេរ៉ា	Фотоаппарат
កម្មវិធីទូរទស្សន៍	Телевизионная программа
ខេត្តខាហ្គុស៊ីម៉ា	Кагосима (префектура)
ភាសាស៊ី	Си (язык программирования)
ម៉ង់តេរីយើ	Монтескьё, Шарль-Луи де Секонда
វិគីភីឌា:អត្ថបទពិសេស	Википедия:Избранные статьи
ពិភពលោក	Мир (Земля)
ឈូក	Лотос орехоносный
ឡងប៊ិច (កាលីផ្វនញ៉ា)	Лонг-Бич
រង្វង់	Окружность
ប្លង់	Плоскость (геометрия)
វិគីភីឌាភាសាកូរ៉េ	Корейская Википедия
ទៀបកោះម៉ាឡេ	Малакка (полуостров)
អេប៉ុងហ្ស៍ (ពពុះទឹក)	Губки
មធ្យមនព្វន្ធ	Среднее арифметическое
World Cup	Чемпионат мира по футболу
សម្ដេចប៉ាប	Папство
IATA	Международная ассоциация воздушного транспорта
បុណ្យណូអែល	Рождество Христово
ត្រីកោណ	Треугольник
លោកអេលីសេ រីខ្លាស	Реклю, Элизе
អ្នកប្រើប្រាស់:អេង ឡុង/សង្គមវិទ្យាមូលដ្ឋាន	Социология
សញ្ញាសំលេងអន្តរជាតិ	Международный фонетический алфавит
តៃវ៉ាន់	Тайвань
Friedrich Schiller	Шиллер, Фридрих
ជំនឿបាហៃ	Бахаи
១	1 год
អាប្រាហាម ម៉ាស្លូ	Маслоу, Абрахам Харольд
ខ្ទឹមស	Чеснок
អ៊ូលេនបាធរ	Улан-Батор
កោះ	Остров
ភាសាផ្លូវការ	Официальный язык
ខ្សែអេក្វាទ័រ	Экватор
ទិស	Стороны света
លេខអាតូម	Зарядовое число
អាល់ហ្វ្រិដ ណូបែល	Нобель, Альфред
សម្ដេចប៉ាប យូហាន ទី២៣	Иоанн XXIII
រមណីយដ្ឋានទឹកធ្លាក់ក្បាលឆាយ	Кбал Чхай
កិរិយាសព្ទ	Глагол
ទីតានិច	Титаник
សត្វឆ្អឹងកង	Позвоночные
បាគូ	Удод
អំពែរ	Ампер
ISO 3166-1	ISO 3166-1
១ មុនគ.ស	1 год до н. э.
ម៉ែត្រការ៉េ	Квадратный метр
ជំនួយ:Interlanguage links	Планктон
សហស្សវត្សរ៍ទី២	2-е тысячелетие
ខេត្តកំពង់គោ	Лонган
ទ្រឹស្តីបទទ្វេធា	Бином Ньютона
សមុទ្រជប៉ុន	Японское море
អាស៊ីខាងកើត	Восточная Азия
អាមេរិក កណ្ដាល	Центральная Америка
គ្រីស្ទអឌែលហ្វៀន	Христадельфиане
បរិមាត្រ	Периметр
ចក្រភព អូទ្រីស-ហុងគ្រី	Австро-Венгрия
ផាយថុន	Python
អានន្ទ	Ананда
អាស៊ីហ្គេមឆ្នាំ១៩៥១	Летние Азиатские игры 1951
បាកាន	Паган
ចិន	Китайская цивилизация
សំទុះទំនាញដី	Ускорение свободного падения
ច្បាប់ធម្មតា	Общее право
អ្នកម្តាយ តេរេសា​ (Mother Teresa)	Мать Тереза
ប្លូក	Блог
រោគគ្រុនចាញ់	Лихорадка денге
ដុល្លារហុងកុង	Гонконгский доллар
Xian JH-7	Xian JH-7
ខ្សែបណ្ដោយ	Меридиан
ខេត្តឃ្លាំង	Шокчанг (провинция)
ខេត្តទឹកខ្មៅ	Камау (провинция)
សមុទ្រខារ៉ា	Карское море
ផ្លេតបន្ទោរ	Молния
កំរងកោះ	Архипелаг
តួប្រុស	Актёр
អំបូរភាសាយូតូអាហ្សតិក	Юто-ацтекские языки
ចាស្ទីន ពីពេ្រ	Бибер, Джастин
ក្រុម​ភាសា​ថៃកៈដៃ	Тай-кадайские языки
ចក្រភព រុស្ស៊ី	Российская империя
មឞវជ	Мошовце
បេណាហ្សៀរ ប៊ូតូ	Бхутто, Беназир
ស៊ីឌី	Компакт-диск
ឧទ្ធម្ភាគចក្រ	Вертолёт
គុណនាម	Имя прилагательное
វីតាមីន	Витамины
វែបសាយ	Сайт
តំបន់ហុកកៃដូ	Хоккайдо
រូបមន្តសមមូលម៉ាស់-ថាមពល	Эквивалентность массы и энергии
សមុទ្រ អារ៉ាល់	Аральское море
ហូ ជីមិញ	Хо Ши Мин
ម៉ាក ហ្សុកឃឺបឺក	Цукерберг, Марк
ប្រតិកម្មគីមី	Химическая реакция
ខេត្តក្រមួនស	Кьензянг
ខេត្តមាត់ជ្រូក	Анзянг
ខេត្តរោងដំរី	Тэйнинь (провинция)
ខេត្តព្រះត្រពាំង	Чавинь
Binomial nomenclature	Биноминальная номенклатура
ខេត្តពលលាវ	Бакльеу (провинция)
ខេត្តផ្សារដែក	Донгтхап
វ៉ែសបែង	Западный берег реки Иордан
ភាសាបាលី	Пали
គេហទំព័រ	Веб-страница
ចតុកោណ	Четырёхугольник
ឈិន ឡុង	Чан, Джеки
ទិវាកុមារអន្តរជាតិ	Всемирный день ребёнка
Yahoo!	Yahoo!
បន្ទាត់	Прямая
ហ្មរិឩពឡ	Мариуполь
G8	Большая восьмёрка
អង្កត់ផ្ចិត	Диаметр
គ្រូបង្រៀន	Учитель
ស្នាដៃនៃបុព្វបុរសខ្មែរ	Письмо (письменность)
ស្ដេចប៉ាប យ៉ូហាន ប៉ូលទី១	Иоанн Павел I
ណៃពិដោ	Нейпьидо
ISO 4217	ISO 4217
ព្យែរ គុយរី	Кюри, Пьер
ក្រុមប្រឹក្សាសន្តិសុខ អង្គការសហប្រជាជាតិ	Совет Безопасности ООН
ពហុកោណ	Многоугольник
ទិវានៃក្ដីស្រលាញ់	День святого Валентина
ហ្គូហ្គល	Рынок
សមុទ្រចិនខាងត្បូង	Южно-Китайское море
និវេសនប្រព័ន្ធ	Экосистема
សមុទ្រលឿង	Жёлтое море
យ៉ាំងហ្គូន	Янгон
សូរព្យញ្ជនៈ	Согласные
ច្បាប់ចលនារបស់ញូតុន	Законы Ньютона
ឈូងសមុទ្របេងហ្គាល់	Бенгальский залив
ទិវានារីអន្តរជាតិ	Международный женский день
.jp	.jp
ភ្នំហ្វឹជី	Фудзияма
ប៉ុលពត	Пол Пот
Xian H-6	Xian H-6
Chengdu J-7	Chengdu J-7
Shenyang J-8	Shenyang J-8
ភ្នំភ្លើង អ៊ីស៊ាឡឺក	Эйяфьядлайёкюдль
ម៉ាក្រូសេដ្ឋកិច្ច	Макроэкономика
Harbin SH-5	Harbin SH-5
ដីជ្រោយហ្គាស្សា	Сектор Газа
អេលីប	Эллипс
វិទ្យុអាស៊ីសេរី	Свободная Азия
សមាគមន៍សារព័ត៌មាន	Ассошиэйтед Пресс
អធិដ្ឋាន	Молитва
គណៈកម្មាធិការអូឡាំពិកអន្តរជាតិ	Международный олимпийский комитет
Skype	Skype
ចតុកោណស្មើ	Ромб
ទន្លេមេគង្គ	Меконг
មេកានិច	Механика
វិចិត្រសាលវលញ្ឆករប្រទេស	Список государственных гербов
ហែងរីហ ហឺត	Герц, Генрих Рудольф
អង់រី បិកកឺរ៉ែល	Беккерель, Антуан Анри
ទស្សនាវដ្ដី	Журнал
សមីការដឺក្រេទី២	Квадратное уравнение
រូពីឥណ្ឌូនេស៊ី	Индонезийская рупия
សមុទ្រអុកហុតស្គ៍	Охотское море
ចិត្តវិភាគ	Психоанализ
ខ្មែរម៉ាស្ទើ	Веб-мастер
URL	URL
ក្រុមបាល់ទាត់ជម្រើសជាតិ អេស្ប៉ាញ	Сборная Испании по футболу
Google Earth	Google Планета Земля
ប៊ែនហាដ រីម៉ាន	Риман, Бернхард
កោន	Конус
អាតុល	Атолл
ទិន្នន័យ	Данные
ខ្លែង	Воздушный змей
ស្ថាបត្យករ	Архитектор
មហាអំណាច អាប់ស៊ីស	Страны «оси» и их союзники
វិគីភីឌា:FAQ	Википедия:ЧАВО
.th	.th
ចក្រភព អាល្លឺម៉ង់	Германская империя
ក្រុមបាល់ទាត់ជម្រើសជាតិ អាល្លឺម៉ង់	Сборная Германии по футболу
ហេរី ផោតធ័រ និង សិលាទេព	Гарри Поттер и философский камень
អង្គការ Creative Commons	Creative Commons
ឥណ្ឌូចិន	Индокитай
ប្រាសាទអង្គរវត្ត	Ангкор-Ват
ទ្រឹស្ដីរ៉ឺឡាទីវីតេ	Теория относительности
ប្រុស	Самец
Toulon	Тулон
ប៉ាស្កាល់	Паскаль (единица измерения)
ទ្រឹស្ដីល្បែង	Теория игр
នីតិរដ្ឋ	Верховенство права
សមុទ្រចិនខាងកើត	Восточно-Китайское море
ខ្នុរ	Джекфрут
ប្រលេឡូក្រាម	Параллелограмм
ប្រាសាទព្រះវិហារ	Прэахвихеа
ចតុកោណព្នាយ	Трапеция
ស៊ូស៊ី	Суши
រូប៊ិក ខ្យូប	Кубик Рубика
កាល	Плавт
ចង្រិត	Настоящие сверчки
ទិវាពលកម្មអន្ដរជាតិ	Первое мая (праздник)
ស្ទឹង	Ручей
សមុទ្រអង់ដាម៉ង់	Андаманское море
ប៉ិបស៊ី	Пепси
ក្រុមបាល់ទាត់ជម្រើសជាតិ អង់គ្លេស	Сборная Англии по футболу
ក្រុមបាល់ទាត់ជម្រើសជាតិ បារាំង	Сборная Франции по футболу
ទំព័រគំរូ:Commonscat	Шаблон:Commonscat
វិគីភីឌាភាសាអាល្លឺម៉ង់	Немецкая Википедия
អាស៊ីខាងលិច	Ближний Восток
យេនឌ័រ	Гендерная идентичность
អង្គការសហភាពអន្តរជាតិដើម្បីអភិរក្សធម្មជាតិ	Международный союз охраны природы
ទីក្រុងមេឌេយីណ	Медельин
ប៉ារ៉ាបូល	Парабола
ខេត្តអ៊ីវ៉ាតិ	Иватэ (префектура)
ទ្វារសមុទ្រមលក្កា	Малаккский пролив
មហាយាន	Махаяна
ប្រព័ន្ធប្រតិបត្តការ iOS	IOS
ចំនួនបឋម	Простое число
សង្គ្រាម ប្រាំមួយ ថ្ងៃ	Шестидневная война
ក្រុងឡូវែល រដ្ឋម៉ាស្សាឈូស៊ែត	Лоуэлл (Массачусетс)
សមុទ្រជ្វា	Яванское море
សិប្បកម្មខ្ញុំ	Minecraft
ច្រកសមុទ្រធ្ងន់ធ្ងរ	Dire Straits
វីហ្សួលបេហ៊្សិក.ណេត	Visual Basic .NET
បំណែងចែករដ្ឋបាលនៃកម្ពុជា	Административное деление Камбоджи
អនុគមន៍ដឺក្រេទី២	Квадратичная функция
ច្បាប់អំពែរ	Теорема о циркуляции магнитного поля
ជំងឺអ៊ីបូឡា	Геморрагическая лихорадка Эбола
ច្រកកូរ៉េ	Корейский пролив
ឆកសមុទ្រកូរ៉េ	Западно-Корейский залив
កង្កែប	Бесхвостые
ខ្សែទឹកឃឹរ៉ុស៊ីអុ	Куросио
ចំណាត់ថ្នាក់ក្រុម:ព្រះមហាក្សត្រ	Категория:Монархи
ចំណាត់ថ្នាក់ក្រុម:រដ្ឋាភិបាល	Категория:Правительство
ទំព័រគំរូ:Infobox legislature	Шаблон:Орган законодательной власти
ទន្លេយ៉ាលូ	Ялуцзян
ទំព័រគំរូ:ប្រវត្តិសាស្ត្រថៃ	Шаблон:История Таиланда
ទំព័រគំរូ:ប្រវត្តិសាស្ត្រចិន	Шаблон:История Китая
មីហ្គេល អ៊ីដាលហ្គោ អ៊ី កុស្ទីយ៉ា	Идальго-и-Костилья, Мигель
នរោត្តម សីហមុនី	Нородом Сиамони
ហ៊ុន សែន	Хун Сен
តូក្យូស្កាយទ្រី	Tokyo Skytree
ភាសាប៉ាស្តូ	Пушту
កំណែទម្រង់រូបិយវត្ថុ	Денежная реформа
ធនាគារកណ្ដាល	Центральный банк
Pidgin	Pidgin
​វិលហែម វុឌ	Вундт, Вильгельм
យិដា តាដូ	Таро, Герда
មនុស្សពីងពាង	Человек-паук
សារធាតុគីមី	Вещество
ចលនានៅក្នុងរូបវិទ្យា	Механическое движение
ជម្ងឺកញ្ជ្រឹល	Корь
ក្រុមបាល់ទាត់ជម្រើសជាតិ អាហ្សង់ទីន	Сборная Аргентины по футболу
ខ្យល់ព្រះអាទិត្យ	Солнечный ветер
បាល់ទាត់ពិភពលោក ២០១៤	Чемпионат мира по футболу 2014
ម៉ូបាល (អាល់ឡាបាម៉ា)	Мобил (Алабама)
កុំព្យូទ័រផ្រូក្រាមមីង(Computer programming)	Программирование
ខេត្តឈីបា	Тиба (префектура)
អាំងតេក្រាល	Интеграл
ខេត្តអៃឈិ	Айти
វិបត្តិសេដ្ឋកិច្ចឆ្នាំ ១៩៩៧	Азиатский финансовый кризис
ខ្មែរ	Взрослый
សិល្បៈប្រើវោហារបង្ហូរគំនិត	Риторика
ឃីមីហ្គាយ៉ុ	Гимн Японии
សាល អូហ្គុស្ទីន ដឺ គូឡុំ	Кулон, Шарль Огюстен де
ខេត្តអាគីតា	Акита (префектура)
ថ្នាក់ពាក្យ	Часть речи
ស្ថានភាពអភិរក្ស	Охранный статус
កាន់ជិ	Кандзи
នាម	Имя
ប្រវត្តិសាស្ត្រចិន	История Китая
អវតារ	Аватара
ច្បាប់គូឡុំ	Закон Кулона
រឿង រ៉ូមេអូ និង ហ្ស៊ុយលីយេ	Ромео и Джульетта
សាលីណា កូមាស់	Гомес, Селена
ក្រុម (តារាងខួបនៃធាតុគីមី)	Группа периодической системы
ក្រុមបាល់ទាត់ជម្រើសជាតិ ប្រេស៊ីល	Сборная Бразилии по футболу
កាល ឡែមស្ដែនណឺ	Ландштейнер, Карл
បាល់ប៉ូឡូញ	Polandball
ឯកសារភាពយន្ត	Документальное кино
អនុគមន៍ត្រីកោណមាត្រ	Тригонометрические функции
ហ្រាន្ដកូស ហ្វីឡុន	Фийон, Франсуа
ខួប (តារាងខួបនៃធាតុគីមី)	Период периодической системы
ល្បែងទាញព្រ័ត្រ	Перетягивание каната
Article (grammar)	Артикль
មេដ្យានទ័រ	Циркуль
Rfid	RFID
អ៊ីប៉ូតេនុស	Гипотенуза
ហិចហ្វាន់	Хедж-фонд
ISO 3166	ISO 3166
សញ្ញាជាតិកូរ៉េខាងជើង	Герб Корейской Народно-Демократической Республики
មេហ្គា	Мега-
គីឡូ	Кило-
ការតាំងសមាធិ	Медитация
ប៉េតា	Пета-
យ៉ុតតា	Иотта-
សង់ទី	Санти-
ហ្គីហ្គា	Гига-
តេរ៉ា	Тера-
ហ្វង់តូ	Фемто-
ហ្សិតតា	Зетта-
ច្រកតារតារី	Татарский пролив
ហ្សិបតូ	Зепто-
កាតែត	Катет
អាត់តូ	Атто-
យ៉ុកតូ	Иокто-
ដេស៊ី	Деци-
ចំណែករដ្ឋបាលនៃម៉ិចស៊ិក	Административное деление Мексики
ម៉ាស៊ីនស្វែងរក	Метапоисковая система
អាំងតេក្រាលមិនកំនត់	Первообразная
Shenyang J-15	Shenyang J-15
ខេត្តក្យូតុ	Киото (префектура)
តំលៃដាច់ខាត	Абсолютная величина
ហេដ្ឋារចនាសម្ព័ន្ធ	Инфраструктура
សាស្ត្រាចារ្យ	Профессор
តេគីឡា	Текила
សន្ធិសញ្ញាប្រេស្ត-លីតូវស្ក	Брестский мир
William Thomson, 1st Baron Kelvin	Томсон, Уильям (лорд Кельвин)
អាណាខេត្តអូសាកា	Осака (префектура)
ខេត្តអិហ៊ីមិ	Эхимэ
វាំងននដែក	Железный занавес
Kara (band)	Kara
វីលៀម ជែម	Джемс, Уильям
ខេត្តយ៉ាម៉ាកាតា	Ямагата (префектура)
ច្រកតៃវ៉ាន់	Тайваньский пролив
គំរោងម៉ាន់ហាត់ថាន់	Манхэттенский проект
ខេត្តយ៉ាម៉ាហ្គឹឈិ	Ямагути (префектура)
ខេត្តខាន់ណាហ្គាវ៉ា	Канагава
បញ្ចកោណ	Пятиугольник
តំបន់ជឺហ្គុកឹ	Тюгоку
ខេត្តណាហ្គាណុ	Нагано (префектура)
ខេត្តសៃតាម៉ា	Сайтама (префектура)
ខេត្តមីអិ	Миэ
ណុត	Узел (единица измерения)
តំបន់តុហុកកឹ	Тохоку
ខេត្តហ្គឺនម៉ា	Гумма (префектура)
ជ្រូកទឹក	Дюгонь
ខ្សែទឹកមហាសមុទ្រ	Морские течения
ខេត្តមីយ៉ាសាគី	Миядзаки (префектура)
ខេត្តឃឹម៉ាម៉ុតុ	Кумамото (префектура)
មូលដ្ឋានូបនីយកម្មភាសា	Языковая локализация
Mikoyan MiG-29	МиГ-29
សប្ដាហ៏ពិសិដ្ឋ	Страстная седмица
ឈូងសមុទ្រថៃ	Сиамский залив
អ៊ីមម៉ាជីន និងផូស៊ី	Живопись и поэзия
លី ក្វាន់យូ	Ли Куан Ю
កម្មសិទ្ធិបញ្ញា	Интеллектуальная собственность
អាណាខេត្តណារ៉ា	Нара (префектура)
បុព្វបទនៅក្នុងប្រព័ន្ធខ្នាតអន្តរជាតិ	Приставки СИ
យន្តហោះប៉ូឡូញកំទេចឆ្នាំ២០១០	Катастрофа Ту-154 в Смоленске
ជនភៀសខ្លួន	Беженцы
ហង់រី កាវិនឌីស	Кавендиш, Генри
បុណ្យចូលឆ្នាំចិន	Китайский Новый год
ថេរវាទ	Тхеравада
តំបន់ខាន់តូ	Канто (регион)
ខេត្តនីហ្គាតាក់	Ниигата (префектура)
ខេត្តយ៉ាម៉ាណាស៊ី	Яманаси (префектура)
ខេត្តស៊ីម៉ាណិ	Симанэ
ខេត្តតុយ៉ាម៉ា	Тояма (префектура)
ខេត្តអូកាយ៉ាម៉ា	Окаяма (префектура)
ISO 3166-2	ISO 3166-2
ខេត្តអយតាក់	Оита (префектура)
ខេត្តខូឈិ	Коти (префектура)
អង្គការអន្តរជាតិនៃនយោបាយរបស់បារាំង	Франкофония
ភ្នំមេរ៉ាពី	Мерапи (Ява)
ព្រះធម៌	Дхарма
តំបន់ឈឺប៊ឹ	Тюбу
វ៉ាក់សាំង	Вакцина
រោគក្អកមាន់	Коклюш
គន្ថនិទ្ទេស	Библиография
កម្ពុជា នៅកីឡាអូឡាំពិករដូវក្ដៅ ២០០៨	Камбоджа на летних Олимпийских играх 2008
គីមឈី	Кимчхи
ខេត្តកំពង់ចាម	Кампонгтям
ខ្សែទឹកហ្គ្រីនលែនខាងកើត	Восточно-Гренландское течение
ខ្សែទឹកប៉ាស៊ីហ្វិកខាងជើង	Северное Тихоокеанское течение
ខ្សែទឹកហាំបុល	Перуанское течение
ខ្សែទឹកអូស្ត្រាលីខាងកើត	Восточно-Австралийское течение
ជ័រទឹក	Смола
ដុនបូស្កូ	Боско, Иоанн
ធ្នូរង្វង់	Дуга окружности
អប្សរា	Апсара
ស្រុក	Дистрикт
រាជវង្សចោឡា	Чола (государство)
ខ្លារខិន ២ (រថក្រោះ)	Леопард 2
មហាអំណាច កណ្ដាល	Центральные державы
អិចសា	Экса-
ហិកតូ	Гекто-
ដេកា	Дека-
រ៉ូបឺតកាប៉ា	Капа, Роберт
មីល្លី	Милли-
មីក្រូ	Микро-
ពីកូ	Пико-
ណាណូ	Нано-
លីប៉ូល ស៊ីដាស៊ាងហ័រ	Сенгор, Леопольд Седар
វិគីភីឌាភាសាឥណ្ឌូនេស៊ី	Индонезийская Википедия
ទន្ដគោម	Агава
ប្រវតិ្តBoney M	Boney M.
វីមេអូ	Vimeo
អំពើអនិត្យានុកូល	Домашнее насилие
ហង់រី ការចេរ ប្រេស្សុង	Картье-Брессон, Анри
ត្រីកោណសម័ង្ស	Правильный треугольник
ម៉ាក់ណូលា	Магнолия
ចូសេហ្វ ហិនរី	Генри, Джозеф
មន ស	Шелковица белая
ពិធីបញ្ជាប់ពាក្យ	Обручение
ត្រីកោណកែង	Прямоугольный треугольник
សមុទ្រហ្វីលីពីន	Филиппинское море
ប្រព័ន្ធកូអ័រដោណេភូមិសាស្ត្រ	Геополитика
Eurocopter Tiger	Eurocopter Tiger
តេត្រាអែត	Тетраэдр
សឺន សាន	Сон Санн
ម៉ោងផែនដី	Час Земли
នរោត្ដម សីហនុ	Нородом Сианук
ទន្លេរីយ៉ូហ្គ្រែនដេ	Рио-Гранде (река, впадает в Мексиканский залив)
សំព័រ	Артокарпус
កម្មវិធីអភិវឌ្ឍន៍សហប្រជាជាតិ	Программа развития ООН
ម៉ាស៊ីនថត លេកា	Leica Camera
មេគុណជីនី	Коэффициент Джини
នីត្រូគ្លីសេរីន	Нитроглицерин
វណ្ណយុត្តិ	Диакритические знаки
ទង់ជាតិកម្ពុជា	Флаг Камбоджи
ក្រុងអង្គរ	Ангкор
ក្រពេញទីមុស	Тимус
ទ្រឹស្តីបទកូស៊ីនុស	Теорема косинусов
ទក្សិណ ជិនវ័ត្រ	Чиннават, Таксин
ប្រធាន	Подлежащее
ហិនរី រ៉េម៉ុន	Реймонд, Генри Джарвис
អ៊ែង​ហ្គ្រី បឺដ	Angry Birds
អ៊ីពែបូល	Гипербола (математика)
វិសមភាពស្វ័យគុណ	Неравенство
ប៊ិច	Ручка (канцелярия)
ចេក​	Плантан
XHTML	XHTML
ចម្ប៉ាក្រហម	Магнолия чампака
គ្រោះទុរ្ភិក្ស	Массовый голод
អរិយសច្ច៤	Четыре благородные истины
ស្តាទិច	Статика
ខេត្តណាហ្គាសាគី	Нагасаки (префектура)
វិគីភីឌាភាសាស្វីស	Шведская Википедия
ភ្លើងឆេះព្រៃ	Лесной пожар
ទ្រឹស្តីបទស៊ីនុស	Теорема синусов
ច្បាប់ហ៊ូក	Закон Гука
ក្រុមបាល់ទាត់ជម្រើសជាតិ ជប៉ុន	Сборная Японии по футболу
រោគឈឺចាប់ក្នុងសន្លាក់ឆ្អឹង	Артрит
ប្លុកហ្គឺ (Blogger)	Blogger
ធម្មនុញ្ញនៃអង្គការសហប្រជាជាតិ	Устав ООН
Boeing AH-64 Apache	McDonnell Douglas AH-64 Apache
រោគហើមសួត	Бронхит
អេមីល្យូ ហ្គីណូ សេហ្គ្រែ	Сегре, Эмилио Джино
Sukhoi Su-27	Су-27
ម៉ាស៊ីនត្រជាក់	Кондиционирование воздуха
កាំ	Радиус
អភិសិទ្ធិ វេជ្ជាជីវៈ	Ветчачива, Апхисит
HAL Tejas	HAL Tejas
លីមីត	Предел (математика)
អ៊ីដ្រូស្តាទិច	Гидростатика
វិគីភីឌាភាសាជប៉ុន	Японская Википедия
គោលនយោបាយរូបិយវត្ថុ	Денежно-кредитная политика государства
យានដឹកជញ្ជូនសាធារណៈ	Общественный транспорт
ការសំភាសន៏	Интервью
ពាណិជ្ជកម្មអន្តរជាតិ	Международная торговля
ចក្រភពអាណានិគមបារាំង	Колонии Франции
ពន្ធលើប្រាក់ចំណូល	Подоходный налог
HTML tag	Элементы HTML
រូបចំលាក់	Статуя
នាឡិកាខ្សាច់	Песочные часы
ពុយមីស	Пемза
FM	Частотная модуляция
សង្គមស៊ីវិល	Гражданское общество
សមុទ្របូហៃ	Бохайский залив
ការិយាល័យ	Офис
ការបង្រៀនដែនដីបរិសុទ្ធ	Электронное обучение
ម៉ែត្រក្នុងមួយវិនាទី	Метр в секунду
រូបមន្តហេរុង	Формула Герона
ទន្សោង	Бантенг
វីតាមីន B	Витамины группы B
គណៈកម្មាធិការជាតិអូឡាំពិក	Национальный олимпийский комитет
ប៉មតូក្យូ	Телевизионная башня Токио
ទិវាទឹកអន្តរជាតិ	Всемирный день водных ресурсов
រូបមន្តអយល័រ	Формула Эйлера
ស៊ីយ៉ាញួរ	Цианиды
អរិយដ្ឋង្គិកមគ្គ	Восьмеричный Путь
សហភាពឥណ្ឌូចិន	Французский Индокитай
ចន្ទគតិ	Лунный календарь
ការវិភាគតាមអ៊ីនធើណែត	Уникальный посетитель
សំទុះមុំ	Угловое ускорение
កាលប្បវត្តិព្រះពុទ្ធសាសនា	Буддийская хронология
គោលនយោបាយសារពើពន្ធ	Фискальная политика
ឡាហ្គូន	Лагуна
Mathew Brady	Брэди, Мэттью
អប់សិន (ហិរញ្ញវត្ថុ)	Опцион
អង្កត់ធ្នូ	Хорда (геометрия)
អាយុសង្ឃឹម	Ожидаемая продолжительность жизни
ជំនួយ:Using colours	Википедия:Таблица цветов
ខុទ្ទកាល័យ	Совет директоров
សីដក់	Сепактакрау
ធនាគារអភិវឌ្ឍន៍អាស៊ី	Азиатский банк развития
បញ្ជីរដ្ឋមានអាវុធនុយក្លេអ៊ែរ	Ядерный клуб
ទីផ្សារអ៊ីធើណែត	Интернет-маркетинг
សៀវភៅ	Книга джунглей
បារីអេឡិចត្រូនិច	Электронная сигарета
Eagles (ក្រុមភ្លេង)	Eagles
កំណើនសេដ្ឋកិច្ច	Экономический рост
យន្តសាស្រ្តរថយន្ត	Автомобильная промышленность
អាឌាម លេមបឺត	Ламберт, Адам
រូបមន្តដឺម័រ	Формула Муавра
អនុគមន៍ហ្គាំម៉ា	Гамма-функция
ច្បាប់ប៉ាស្កាល់	Закон Паскаля
សញ្ញាជាតិបង់ក្លាដែស្ស	Герб Бангладеш
នាង​សីតា	Сита
សូរ (​ភាសាសាស្ត្រ​)	Тон (лингвистика)
ខ្មែរក្រហម	Красные кхмеры
ម៉ូឌុល​យ៉ាំង	Модуль Юнга
យុន ជីមិ-ហូ	Юн Чхи Хо
កែវម៉ាស៊ីនថត	Объектив
ទីភ្នាក់ងារសារព័ត៌មាន	Информационное агентство
វិគីភីឌាភាសាស្លូវ៉ាគី	Словацкая Википедия
ថេរហ្វារ៉ាដេយ	Постоянная Фарадея
ប្រវត្តិអ៊ីនធើណេត	История Интернета
សមភាពគួរកត់សំគាល់	Бином
ខូប្រា	Копра
ទ្រឹស្តីបទមេនេឡូស	Теорема Менелая
អត្ថបទ(ប្រើបា្រស់ភាសា)	Контекст
ជូគ័រលាង	Чжугэ Лян
បំលែងឡាប្លាស	Преобразование Лапласа
សញ្ញាជាតិតួរគី	Эмблемы Турции
បឹងទន្លេសាប	Тонлесап (озеро)
Dassault Mirage 2000	Dassault Mirage 2000
ចំនួនអវិជ្ជមាន	Отрицательное число
វិសុទ្ធិមគ្គ	Висуддхимагга
សញ្ញាជាតិវៀតណាម	Герб Вьетнама
ខ្មែរ (ជនជាតិ)	Кхмеры
សញ្ញាជាតិកូរ៉េខាងត្បូង	Эмблема Республики Корея
សញ្ញាជាតិឡាវ	Герб Лаоса
សញ្ញាជាតិប៉ាគីស្ថាន	Эмблема Пакистана
Tigranes the Great	Тигран II
អាណាចក្រខ្មែរ	Камбуджадеша
ត្រីពណ៌	Триколор
សញ្ញាជាតិប៊្រុយណេ	Эмблема Брунея
រង្វង់ត្រីកោណមាត្រ	Единичная окружность
ចំរៀករង្វង់	Сектор (геометрия)
អនុគមន៍ដឺក្រេទី៣	Кубическое уравнение
អនុគមន៍អ៊ីពែបូលីក	Гиперболические функции
ឆាវ ឆាវ	Цао Цао
Sukhoi Su-30	Су-30
កម្មវិធីស្បៀងអាហារពិភពលោក	Всемирная продовольственная программа
រៀល	Камбоджийский риель
សមុទ្រស្ទើរបិទ	Окраинное море
ច្រកសិង្ហបុរី	Сингапурский пролив
វិគីភីឌាភាសារុស្ស៊ី	Русская Википедия
សញ្ញាជាតិអូម៉ង់	Эмблема Омана
ភាសាកម្មវិធី Lua	Lua
សញ្ញាជាតិប៊ូតាន	Эмблема Бутана
ភ្លេងជាតិថៃ	Гимн Таиланда
ព្រះរតនត្រ័យ	Триратна
អាហារនៅប្រទេសម៉ិចស៊ិក	Мексиканская кухня
ច្រកឡាប៉េរូស	Пролив Лаперуза
ខ្នាតកំលាយនៅក្នុងប្រព័ន្ធខ្នាតអន្តរជាតិ	Производные единицы СИ
ផ្សារហិរញ្ញវត្ថុ	Финансовый рынок
ញ៉ែ	Флирт
ព្រះឆាយាល័ក្ខកម្ពុជា	Герб Камбоджи
ទិវាអង្គការសហប្រជាជាតិ	День Организации Объединённых Наций
ខ្សែទឹកអាត្លង់ទិកខាងជើង	Северо-Атлантическое течение
ប្រវត្តិសាស្ត្រវៀតណាម	История Вьетнама
ខ្សែទឹកខាណារី	Канарское течение
ទ្រឹស្តីបទឆិវ៉ា	Теорема Чевы
LinkedIn	LinkedIn
ព្រះត្រៃបិដក	Палийский канон
បុណ្យវិសាខបូជា	Весак
ទីក្រុងព្រែកឫស្សី	Кантхо
ជនជាតិចាម	Тямпа
រីស្ស៉ាត កាពុសស៊ីនស្គី	Капущинский, Рышард
ប្រវត្តិសាស្ត្រភូមា	История Мьянмы
ស៊ាន ឃីងស្តន	Шон Кингстон
កងទ័ពជើងទឹកបារាំង	Военно-морские силы Франции
ចំប៉ី	Плюмерия
ពហុកីឡាដ្ឋានសុផាចាឡាសៃ	Супхачаласай
អនុគមន៍បេសែ្សល	Функции Бесселя
លោក អាប់ឌូ ឌីអោហ្វ	Диуф, Абду
វិធីហ្វៃណៃថ៍អ៊េលម៉ិន	Метод конечных элементов
ច្បាប់អគ្គីសនីវិភាគរបស់ហ្វារ៉ាដេយ	Законы электролиза Фарадея
ខេត្តព្រះសីហនុ	Кампонгсаом
មានប្រ	Анггун
និកាយនៃព្រះពុទ្ធសាសនា	Школы буддизма
ដុនបូស្កូសាឡេស៊ាន្ត	Салезианцы Дона Боско
ខ្នាតគោលនៅក្នុងប្រព័ន្ធខ្នាតអន្តរជាតិ	Основные единицы СИ
អង្គរធំ	Ангкор-Тхом
Kara	Кара (значения)
១៤១	141 (число)
ប្រទេសនៅអឺរ៉ុប	Список государств и зависимых территорий Европы
វិទ្យុសម្លេងសហរដ្ឋអាមេរិក	Голос Америки
ជេឃ្វីរី	JQuery
ទិវាពិភពលោកគ្មានថ្នាំជក់	Всемирный день без табака
គម្ពីរបញ្ចតន្ត្រ	Панчатантра
មេដ្យាន	Медиана треугольника
T-80	Т-80
សញ្ញាជាតិកាតារ	Герб Катара
សញ្ញាយ៉ាកូប៊ី	Символ Якоби
ភាសាចាម	Чамский язык
មីហ៊្គោ	MeeGo
វិភាគចិត្តវិទ្យា	Аналитическая психология
លីវ ប៉ី	Лю Бэй
ម៉ាត្សឹស៊ីតា ខូណុស្កិ	Мацусита, Коносукэ
សង្គ្រាមគ្រីមៀ	Крымская война
ក្ងោកបៃតង	Зелёный павлин
នាវាចរណ៏	Штурман
Pinterest	Pinterest
អាស៊ីហ្គេមឆ្នាំ១៩៦២	Летние Азиатские игры 1962
ទ្រឹស្តីបទទ្វេធាអាបែល	Биномиальная теорема Абеля
អៀង ធីរិទ្ធ	Иенг Тирит
ភ្នំសេមេរូ	Семеру
កោះសមុយ	Самуй
ថវិការដ្ឋាភិបាល	Государственный бюджет
អាំងតេក្រាលដោយផ្នែក	Интегрирование по частям
ផ្សោតក្បាលត្រឡោក	Иравадийский дельфин
Near Field Communication	Near Field Communication
ខៀវ ពណ្ណារី	Кхиеу Поннари
ហិរញ្ញវត្ថុសាធារណៈ	Публичные финансы
កប៉ាល់ ជួង	Рында (колокол)
សាលាសំណាក់	Павильон
ជយវម៌្មទី១	Джаяварман I
ខ្សែទឹកកាលីហ្វរនៀ	Калифорнийское течение
រូបមន្តអយល័រ-ម៉ាក្លូរីន	Формула Эйлера — Маклорена
១៤៨	148 (число)
ធនាគារជាតិនៃកម្ពុជា	Национальный банк Камбоджи
នគរឆាវ	Цао (царство)
AIDC F-CK-1 Ching-kuo	AIDC F-CK-1
ខេត្តសាឡៈវ៉ាន់	Сараван (провинция)
ទិន្នន័យបើកចំហ	Открытые данные
ទិន ហ្វី	Чоу, Стивен
ចម្ប៉ាខែក	Магнолия буроватая
ហាំង ង៉ោ	Хенг Сомнанг Нгор
ព្រះបាទសូរ្យវរ្ម័នទី២	Сурьяварман II
ហ្គោស ចុកតុង	Го Чок Тонг
ហិនរី វីលសុន	Уилсон, Генри
ហុងដា សូអ៊ិជិរ៉ូ	Хонда, Соитиро
ស៊ុន ឈាន	Сунь Цюань
ឆាវ ភី	Цао Пэй
ម៉ាស៊ីនថតវីឌីអូ	Видеокамера
សមុទ្រកូរ៉ូ	Море Коро
ពិម្ពិសារ	Бимбисара
ដូមីនិក សាវីយ៉ូ	Савио, Доминик
ក្រុមបាល់ទាត់ជម្រើសជាតិកម្ពុជា	Сборная Камбоджи по футболу
Seo Jae-pil	Со Джэпхиль
ព្រះសារីបុត្រ	Шарипутра
ទ្រឹស្តីបទគ្រីន	Теорема Грина
ប្រាសាទអូសាកា	Замок в Осаке
ការប្រើប្រាស់ភាសា	Прикладная лингвистика
គោព្រៃ	Купрей
VCD	Video CD
ថ្ងៃបាស់ស្ទីល	День взятия Бастилии
កម្ពុជាប្រជាធិបតេយ្យ	Демократическая Кампучия
សាលាក្ដីខ្មែរក្រហម	Чрезвычайные палаты в судах Камбоджи
ណាសសែរ អាល់ មូហាមមេដ អាល់ អាហ៍មេដ អាល់ អាបាហ៍	Насер аль-Мухаммед аль-Ахмед ас-Сабах
ស៊ុនធិ បុណ្យ រ័តក្លិន	Буньяратглин, Сонтхи
ខេត្តផុងសាលី	Пхонгсали (провинция)
ខេត្តបកែវ	Бокэу
ខេត្តចំប៉ាសក្តិ	Тямпасак (провинция)
កិលេស	Страсть (чувство)
ព្រះបាទជ័យវរ្ម័នទី៧	Джаяварман VII
កស្សបៈ	Махакашьяпа
កាំង ហ្កិច អ៊ាវ	Канг Кек Иеу
កំពស់ត្រីកោណ	Высота треугольника
អាយតនៈ	Двенадцать Аятана
ស៊ឺ ម៉ាអ៉ី	Сыма И
ចំនុចហ្គែរហ្គោន	Вписанная окружность
សឺង ង៉ុកថាញ់	Сон Нгок Тхань
ក្រុមហ៊ុនអាកាសចរណ៍ជាតិ កម្ពុជាអង្គរអ៊ែរ	Cambodia Angkor Air
កីឡាឧបទ្វីបអាស៊ីអាគ្នេយ៍លើកទី៥	Игры полуострова Юго-Восточной Азии 1969
ទ្រឹស្តីបទមេអំបៅ	Теорема о бабочке
កន្ថឹក	Малайская тупайя
ហេង សំរិន	Хенг Самрин
ខៀវ សំផន	Кхиеу Сампхан
ជេកខប រីស	Риис, Якоб Август
ព្យែរ វ៉ារីញ៉ុង	Вариньон, Пьер
នួន ជា	Нуон Чеа
អៀង សារី	Иенг Сари
ជយវម៌្មទី៣	Джаяварман II
បន្ទាត់អយល័រ	Прямая Эйлера
ប្រវត្តិសាស្ត្រថៃ	История Таиланда
បុណ្យសែនព្រះខែ	Праздник середины осени
មហាមោគ្គលាន	Маудгальяяна
ប្រេម ទីនសូឡានុន្ទ	Тинсуланон, Прем
គុណកិរិយា	Наречие
ឌីណាមិក HTML	DHTML
នូហាក់ ភូមសៈវ៉ាន់	Пхумсаван, Нухак
សាសនានៅប្រទេសកម្ពុជា	Религия в Камбодже
គោលនយោបាយកសិកម្ម	Аграрная политика
ហង់រី មូហូ	Муо, Анри
ប្រវត្តិសាស្ត្រលាវ	История Лаоса
ព្រះបរមរាជវាំង	Королевский дворец в Пномпене
តារាងអាំងតេក្រាល	Список интегралов элементарных функций
បន្ទាត់សេកង់	Секущая прямая
ពហុកោណស្មើ	Равносторонний многоугольник
ប្រាសាទតាកែវ	Та Кео
សម្ដេចប៉ាបហ្វ្រង់សូ័រ	Франциск (папа римский)
ទ្រឹស្តីបទតូលេមី	Неравенство Птолемея
Regional Internet registry	Региональный интернет-регистратор
ខ្វែងជ័យបុរី	Сайнябули (провинция)
ខ្វែងជើងខ្វែង	Сиангкхуанг
ខេត្តឧត្តមជ័យ	Удомсай
ខេត្តកោះកុង	Кохконг
ខេត្តកណ្ដាល	Кандаль
ម៉ារី ដូមីនិក ម៉ាសារីលូ	Мадзарелло, Мария
ព្រះនាងយសោធរា	Яшодхара
អនុគមន៍បែតា	Бета-функция
ទ្រឹស្តីបទតង់សង់	Теорема тангенсов
លិង្គ	Лингам
កូម៌ៈ	Курма
អាស៊ីហ្គេមឆ្នាំ១៩៧៤	Летние Азиатские игры 1974
អាកាសយានដ្ឋានអន្តរជាតិតានសូនណាត្ត	Таншоннят
KAI T-50 Golden Eagle	KAI T-50 Golden Eagle
ឧបទ្វីបកូរ៉េ	Корейский полуостров
វីគីប្រជុំ	Викимания
អាស៊ីហ្គេម	Азиатские игры
ទង់ជាតិសិង្ហបុរី	Флаг Сингапура
បង្អួចឆ្នាំ 2000	Windows 2000
តារាងអាំងតេក្រាលនៃអនុគមន៍សនិទាន	Список интегралов от рациональных функций
តារាងអាំងតេក្រាលនៃអនុគមន៍អ៊ីពែបូលីក	Список интегралов от гиперболических функций
សមីការដឺក្រេទី១	Линейное уравнение
តារាងអាំងតេក្រាលនៃអនុគមន៍ច្រាស់អ៊ីពែបូលីក	Список интегралов от обратных гиперболических функций
សញ្ញាជាតិអាហ្វហ្គានីស្ថាន	Герб Афганистана
E-commerce	Электронная коммерция
Sukhoi Superjet 100	Sukhoi Superjet 100
អ្នក​មាន​ជាង​គេ​លើ​ពិភពលោក	Список миллиардеров
គណកម្មាធិការអូឡាំពិកកូរ៉េ	Олимпийский комитет Республики Корея
អាស៊ីហ្គេមឆ្នាំ២០០២	Летние Азиатские игры 2002
ឆកសមុទ្រលាវតុង	Ляодунский залив
T-ARA	T-ara
អាស៊ីហ្គេមឆ្នាំ១៩៨៦	Летние Азиатские игры 1986
អាណាស្រុកម៉ូបាល (អាល់ឡាបាម៉ា)	Мобил (округ)
កូរ៉េ	Образование в Республике Корея
ម្កាក់	Амбарелла
បារខែម	BarCamp
ដើមត្នោត	Пальмировая пальма
ព្រះបាទសូរ្យវរ្ម័នទី១	Сурьяварман I
ខេត្តកំពង់ធំ	Кампонгтхом
ខេត្តព្រះវិហារ	Прэахвихеа (провинция)
ខេត្ត ហួ ផាន់	Хуапхан
ខ្វែងអាចម៍ក្រពើ	Аттапы
បញ្ជីទីក្រុងនិងទីប្រជុំជននៅកម្ពុជា	Города Камбоджи
ខេត្តខាំមួន	Кхаммуан
ខេត្តប៉ៃលិន	Пайлин
ឆាយាលក្សសារព័ត៌មាន	Фотожурналистика
ឧទ្យានជាតិភ្នំគូលែន	Пном Кулен (национальный парк)
ស៊ីសុវត្ថិ មុនីវង្ស	Сисоват Монивонг
អង្គឌួង	Анг Дуонг
រូបមន្តប្រេឆ្នៃដឺ	Соотношение Бретшнайдера
ក្រុមបាល់ទាត់ជម្រើសជាតិ កូរ៉េខាងត្បូង	Сборная Республики Корея по футболу
សុញ្ញតា	Шуньята
Xian MA60	Xian MA60
ប្រមា	Малайский дикобраз
ភូមិសាស្រ្ដនៃប្រទេសកម្ពុជា	География Камбоджи
ស្រុកអន្លង់វែង	Анлонгвэнг
នរោត្តម	Нородом I
ម៉ាសែលលីន ចាមប៉ាញេត	Шампаньят, Марселлин
ព្រះបាទយសោវរ្ម័នទី១	Яшоварман I
អេដូអារដូ អាម៉ាល់ឌី	Амальди, Эдоардо
Chengdu J-20	Chengdu J-20
វេយ្យាករណ៍អង់គ្លេស	Морфология английского языка
ព្រះបាទឥន្រ្ទវរ្ម័នទី១	Индраварман I
ស៊ីឡាត	Силат
ទ្រឹស្តីបទវ្យែត	Формулы Виета
តារាងអាំងតេក្រាលនៃអនុគមន៍អិចស្ប៉ូណង់ស្យែល	Список интегралов от экспоненциальных функций
តារាងអាំងតេក្រាលនៃអនុគមន៍អសនិទាន	Список интегралов от иррациональных функций
តារាងអាំងតេក្រាលនៃអនុគមន៍លោការីត	Список интегралов от логарифмических функций
អាំងតេក្រាលហ្វ្រេនែល	Интегралы Френеля
គោលនយោបាយសេដ្ឋកិច្ច	Экономическая политика
ប្រាសាទភិមានអាកាស	Пхимеанакас
Baskin​-Robbins បាន	Baskin-Robbins
ទិវាសេរីភាពសារព័ត៌មានពិភពលោក	Всемирный день свободы печати
ប្រាសាទតាព្រហ្ម	Та Прохм
ប្រាសាទធម្មនន្ទ	Тхомманон
អាំងតេក្រាលផ្ទៃ	Поверхностные интегралы
ប្រាសាទមេបុណ្យខាងលិច	Западный Мебон
ប្រាសាទបន្ទាយក្តី	Бантай Кдей
ក្រុងសំរោង	Самроунг
មជ្ឈិមនិកាយ	Мадджхима-никая
ស្រះស្រង់	Сра Сранг
ខេត្តតាកែវ	Такео (провинция)
បជាបតិគោតមី	Махападжапати Готами
លានស្តេចគំលង់	Терраса Прокажённого короля
ខេត្តហ៊ីរ៉ូស៊ីម៉ា	Хиросима (префектура)
ព្រះសហគមន៏កាតូលិកភូមិភាគភ្នំពេញ	Апостольский викариат Пномпеня
បន្ទប់រៀន	Класс (комната)
សេដ្ឋកិច្ចកម្ពុជា	Экономика Камбоджи
ហ្គូតហ្គោល	Сайты Google
ខេត្តឧត្ដរមានជ័យ	Оддармеантьей
ប្រភេទស្រាទំពាំងបាយជូរពីប្រទេសបារាំង	Виноделие во Франции
អុក	Макрук
បទនគររាជ	Гимн Камбоджи
នគររាជសីមា	Накхонратчасима
ចំនួនអាកស៊ីម៉ែដ	Число Архимеда
សង្គ្រាមកម្ពុជា-វៀតណាម	Кампучийско-вьетнамский конфликт
តំលៃលើការចាប់អារម្មណ៍	CPT (реклама)
អនុគមន៍អ៊ីពែបូលីកច្រាស់	Обратные гиперболические функции
កីឡាចុងបូព៌ាឆ្នាំ១៩២៥	Дальневосточные игры 1925
បញ្ជីរាយនាម ជ័យលាភីរង្វាន់ណូបែលសន្តិភាព	Список лауреатов Нобелевской премии мира
១៥០	150 (число)
ស្ទឹងស៊ីលីវូង	Чиливунг
ISO 3166-2:KH	ISO 3166-2:KH
ទ្រឹស្តីបទពីក	Формула Пика
ខេត្តសៀមរាប	Сиемреап
ខេត្តមណ្ឌលគិរី	Мондолькири
ខេត្តកំពង់ស្ពឺ	Кампонгспы
ប្រាសាទបាយ័ន	Байон
អុនសេន	Онсэн
ឧត្តមស្នងការអង្គការសហប្រជាជាតិទទួលបន្ទុកសិទ្ធិមនុស្ស	Управление Верховного комиссара ООН по правам человека
សម រង្ស៊ី	Сам Раинси
ជាតក	Джатаки
ក្រុងហាកុណិ (ខេត្តកាណាហ្គាវ៉ា)	Хаконе (посёлок)
អនុគមន៍ត្រីកោណមាត្រច្រាស់	Обратные тригонометрические функции
ប្រវត្តិសាស្ត្រខ្មែរ	История Камбоджи
ម៉ាជូ ពីជូ	Мачу-Пикчу
គណនីធនាគារ	Банковский счёт
ខ្សែទឹកប្រេស៊ីល	Бразильское течение
ក្រុមអសនិក (អាកាសចរណ៍)	Эскадрилья
ត្រកៀតប៉ោង	Эйхорния отличная
ជ្រោយណុតុ	Ното (полуостров)
១៣៨	138 (число)
គីឡូម៉ែត្រការ៉េ	Квадратный километр
ចេននី រីវឺរ៉ា	Ривера, Дженни
ពហុកោណនិយ័ត	Правильный многоугольник
ប្រទេសនៅអាស៊ី	Список государств и зависимых территорий Азии
១៤៤	144 (число)
ឆកសមុទ្រឡៃចូ	Лайчжоувань
១៤០	140 (число)
១៤៣	143 (число)
១៤៧	147 (число)
១៤៦	146 (число)
១៤៩	149 (число)
១៤២	142 (число)
១៣៩	139 (число)
១៤៥	145 (число)
ប្រទេសមួយ ប្រព័ន្ធពីរ	Одна страна, две системы
ត្រកៀត	Понтедериевые
បណ្តាញផ្លូវហាយវេអាស៊ី	Международная азиатская сеть
អាស៊ីហ្គេមឆ្នាំ១៩៥៤	Летние Азиатские игры 1954
អាស៊ីហ្គេមឆ្នាំ១៩៥៨	Летние Азиатские игры 1958
អាស៊ីហ្គេមឆ្នាំ១៩៧៨	Летние Азиатские игры 1978
អាស៊ីហ្គេមឆ្នាំ១៩៨២	Летние Азиатские игры 1982
អាស៊ីហ្គេមឆ្នាំ១៩៩០	Летние Азиатские игры 1990
អាស៊ីហ្គេមឆ្នាំ១៩៩៤	Летние Азиатские игры 1994
អាស៊ីហ្គេមឆ្នាំ១៩៩៨	Летние Азиатские игры 1998
Hongdu JL-8	Hongdu JL-8
ច្រកចូហរ	Джохорский пролив
ព្រះសង្ឃ	Монах
នគរលូ	Лу (княжество)
ត្រីរាជ	Гигантский шильбовый сом
ទ្រឹស្តីបទស្តេអាត	Теорема Стюарта
Yeghishe Charents	Егише Чаренц
Hongdu L-15	Hongdu L-15
CAC/PAC JF-17 Thunder	Chengdu FC-1 Xiaolong
ខេត្តរតនគិរី	Ратанакири
បញ្ចក្ខន្ធ	Пять скандх
Gloomy Sunday	Мрачное воскресенье
ខេត្តហ្លួងព្រះបាង	Луангпхабанг (провинция)
ខេត្តកំពត	Кампот
សង្គ្រាមឥណ្ឌូចិនលើកទី១	Индокитайская война
ខេត្តស្វាយរៀង	Свайриенг
សង្គាយនា	Буддийские соборы
ISO 9362	ISO 9362
ប៉ាកាយ៉ា	Пакая
ខ្លែងប្រម៉ង់	Красноногий карликовый сокол
ទិវាអក្ខរកម្មអន្តរជាតិ	Международный день грамотности
ទ្រឹស្ដីបទការ៉េទាំង៤របស់ឡាហ្គ្រង់	Теорема Лагранжа о сумме четырёх квадратов
សុត្តន្តបិដក	Сутта-питака
ខេត្តអូគីណាវ៉ា	Окинава (префектура)
លានជល់ដំរី	Слоновая терраса
អាស៊ីខាងត្បូង	Южная Азия
កំណាត់រង្វង់	Сегмент (геометрия)
ខេត្តក្រចេះ	Кратьэх
ប្រាសាទបាគង	Баконг
ប្រាសាទបន្ទាយស្រី	Бантеайсрей
ប្រាសាទបាពួន	Бапуон
សមីការឌីផេរ៉ង់ស្យែលប៊ែរនូយី	Дифференциальное уравнение Бернулли
ឃុំបន្ទាយឆ្មារ	Бантеайчма
ខេត្តបាត់ដំបង	Баттамбанг
តំបន់ត្រីកោណមាស	Золотой треугольник
ប្រាសាទបឹងមាលា	Бэнгмеалеа
សង្គ្រាមផ្ទៃក្នុងកម្ពុជា	Гражданская война в Камбодже
ESET	ESET
អាស៊ីហ្គេមរដូវរងារ	Зимние Азиатские игры
ក្រុងយ៉ាណៃ	Янаи
កុសិនារា	Кушинагар
KM	Километр
បញ្ជីព្រះមហាក្សត្រកម្ពុជា	Короли Камбоджи
ផ្លូវកណ្ដាល	Срединный путь
ជម្រើសអ្នកប្រើប្រាស់	Теория потребления
ខេត្តពោធិ៍សាត់	Поусат
វិស័យអប់រំនៅប្រទេសជប៉ុន	Образование в Японии
ខេត្តស្ទឹងត្រែង	Стынгтраенг
ក្រុមប្រឹក្សាអូឡាំពិកអាស៊ី	Олимпийский совет Азии
McDonnell Douglas F-15E Strike Eagle	McDonnell Douglas F-15E Strike Eagle
២៤២	242 (число)
តារាងអាំងតេក្រាលនៃអនុគមន៍ត្រីកោណមាត្រ	Список интегралов от тригонометрических функций
ច្រកកាលីម៉ាតា	Каримата
បញ្ជី ប្រទេស មានចំនួនអ្នកអានសៀវភៅ	Список стран по уровню грамотности
សារមន្ទីរទួលស្លែង	Туол Сленг
ខេត្តកែប	Каеп
ទ្រឹស្តីបទវីវីអានី	Теорема Вивиани
បញ្ជីអ្នកទទួលបានជ័យលាភីណូបែលខាងរូបវិទ្យា	Список лауреатов Нобелевской премии по физике
VietJet Air	VietJet Air
ភវវម៌្មទី១	Бхававарман I
ក្រុងសិរីសោភ័ណ	Сисопхон
ក្រុងកំពង់ចាម	Кампонгтям (город)
អនុគមន៍ស៊ីនុសកាឌីណាល់	Sinc
ខេត្តព្រៃវែង	Прейвэнг
បញ្ជីរាយនាម សេដ្ឋវិទូ	Проект:Экономика/Список экономистов
អនុគមន៍ពហុហ្គាំម៉ា	Полигамма-функция
គណៈកម្មាធិការជាតិអូឡាំពិកកម្ពុជា	Олимпийский комитет Камбоджи
កប្ប	Кальпа
ខ្សែទឹកអេក្វាទ័រខាងជើង	Североэкваториальное течение
សាធារណរដ្ឋប្រជាមានិតកម្ពុជា	Народная Республика Кампучия
នគរវ្នំ	Бапном
ក្រុងកំពត	Кампот (город)
ខេត្តកំពង់ឆ្នាំង	Кампонгчнанг
ស៊ីហ្គេម	Игры Юго-Восточной Азии
ទ្រឹស្តីបទមេដ្យាន	Теорема Аполлония
ISO 3166-3	ISO 3166-3
ព្រះបាទជ័យវរ្ម័នទី៣	Джаяварман III
ស៊ីសុវត្ថិ	Сисоват I
បាល់ទាត់កញ្ចុំផ្កាយ	Галактический футбол
វីគីភីឌាភាសាខ្មែរ	Летучие органические вещества
ប្រទេសនៅអាមេរិកខាងត្បូង	Список государств и зависимых территорий Южной Америки
ចំប៉ីសៀម	Адениум
ជំនួយ:មាតិកា	Википедия:Справка
ទ្រឹស្តីបទកន្លះបន្ទាត់ពុះមុំ	Теорема о биссектрисе
ភ្នំភ្លើងអ៊ីស៊ាឡឺកធ្វើអោយខកខានការហោះហើរនៅអឺរ៉ុប	Влияние извержения вулкана Эйяфьядлайёкюдль на международное авиасообщение
ព្រៃវែង	Прейвэнг (город)
ខ្សែទឹកអៀមីងហ្គើរ	Течение Ирмингера
ជួរភ្នំដងរែក	Дангрэк
កបិលវត្ថុ	Капилавасту
ភ្នំគូលេន	Кулен (плато)
ស្វាកន្ទុយស	Черноногий тонкотел
ប្រាសាទភ្នំក្រោម	Пном Краом
Nanchang Q-5	Nanchang Q-5
រាត្រីមួយក្រោយសង្គ្រាម	Однажды вечером, после войны
ពិធីបុណ្យមាឃបូជា	Макха Буча
សុន សេន	Сон Сен
គណកម្មាធិការអូឡាំពិកជប៉ុន	Олимпийский комитет Японии
ចំនួនតេត្រាអែក	Тетраэдрические числа
ក្រុងកំពង់ធំ	Кампонгтхом (город)
អង់រីកូ ពែរស៊ីកូ	Персико, Энрико
ឧបាលិ	Упали
ព្រះពុទ្ធសាសនា​នៅ​ស្រីលង្កា	Буддизм в Шри-Ланке
ចំណុចរំពុះ	Температура кипения
ក្រុងប៉ោយប៉ែត	Пойпет
តារាងលីមីត	Список пределов
វិសមភាពភីដូ	Неравенство Пидо
ក្រុងកំពង់ឆ្នាំង	Кампонгчнанг (город)
តារាងអាំងតេក្រាលនៃអនុគមន៍ច្រាស់ត្រីកោណមាត្រ	Список интегралов от обратных тригонометрических функций
គណកម្មាធិការអូឡាំពិកជាតិសិង្ហបុរី	Олимпийский комитет Сингапура
អាកាសយានដ្ឋានអន្តរជាតិភ្នំពេញ	Пномпень (аэропорт)
ព្រះនិព្វាន៤ថ្នាក់	Четыре стадии просветления
សាធារណរដ្ឋខ្មែរ	Кхмерская Республика
អក្សរខ្មែរ	Кхмерское письмо
អាកាសយានដ្ឋានអន្តរជាតិសៀមរាបអង្គរ	Сиемреап (аэропорт)
បច្ចេកវិទ្យាសារពត៌មាន	Интернет-журналистика
ក្មេងទំនើង	Ювенальный суд
ចេនឡា	Ченла
ស្ដេចចក្រពត្តិ	Чакравартин
តថាគត	Татхагата
វិភង្គ	Вибханга
បុគ្គលបញ្ញត្តិ	Пуггалапаннатти
ប្រាសាទនាគព័ន្ធ	Неакпеан
នគរឆឹន	Чэнь (царство)
ប្រព័ន្ធផ្សព្វផ្សាយសុក្រិត្យ	Оптимизация сайта под социальные сети
កម្មវីធីសូនីវីហ្គាស	Sony Vegas
ស៊ីហ្គេមលើកទី២៥	Игры Юго-Восточной Азии 2009
ខ្សែទឹកអេក្វាទ័រខាងត្បូង	Южное Пассатное течение
សិក្ខាបទ៥	Пять священных заповедей
ការប្រកួតកីឡាជើងឯកចុងបូព៌ា	Дальневосточные игры-чемпионат
កងទ័ពអេហ្ស៊ីប	Египетские вооружённые силы
ប្រាសាទប្រែរូប	Пре Руп
តារាងដេរីវេ	Таблица производных
មេកានិច​សូលីដ	Механика твёрдого деформируемого тела
ការប្រកួតកីឡា កម្ពុជា	Чемпионат Камбоджи по футболу
ប្រាសាទលលៃ	Лолей
ក្បាលស្ពាន	Кбальспеан
ប្រាសាទតាសោម	Та Сом
អនុគមន៍ស្ករ៉ឺ	Функции Скорера
CAIC Z-10	CAIC WZ-10
អាំងតេក្រាលត្រីកោណមាត្រ	Интегральный косинус
សមីការឌីផេរ៉ងស្យែលក្លែរ៉ូ	Дифференциальные уравнения Лагранжа и Клеро
សាសនា សកល	Религиозные символы
រូបមន្តបេយ៉ា	Формула Беллара
វិមានឯករាជ្យ	Монумент независимости (Пномпень)
ប្រតិទិនឈប់សំរាកប្រចាំឆ្នាំ២០០៨	Праздники Камбоджи
ខ្សែទឹកណរវេយ	Норвежское течение
ទង់ព្រះពុទ្ធសាសនា	Буддийский флаг
មករ	Макара
តំបន់អឌ្ឍច័ន្ទមាស	Золотой полумесяц
អាស៊ីហ្គេមលើឆ្នេរខ្សាច់	Пляжные Азиатские игры
បណ្ឌិត្យ​សភា​នីតិ​អន្តរជាតិ​នៃ​ទីក្រុង​ឡាអេ	Академия международного права
ស៊ីហ្គេមលើកទី២៦	Игры Юго-Восточной Азии 2011
ប្រពលវប្បកម្ម	Интенсивное сельское хозяйство
សមភាពការ៉េទាំង៤របស់អឺលែរ	Тождество четырёх квадратов
ស៊េរីត្រីកោណមាត្រ	Тригонометрический ряд
រូបមន្តប្រាម៉ាហ្គឹបតា	Формула Брахмагупты
មហាភូតរូប	Махабхута
Shenyang J-11	Shenyang J-11
ផលបូក រីម៉ាន	Сумма Римана
សមីការហ៊ីល	Уравнение Хилла
កីឡាអាស៊ីខាងកើតឆ្នាំ១៩៩៣	Восточноазиатские игры 1993
កីឡាចុងបូព៌ាឆ្នាំ១៩៣៨	Дальневосточные игры 1938
សមភាពការ៉េទាំង៨របស់ដេហ្គេន	Тождество восьми квадратов
រូប	Рупа (философия)
Kawasaki OH-1	Kawasaki OH-1 Ninja
កីឡាអាស៊ីខាងកើត	Восточноазиатские игры
ស៊ីហ្គេមលើកទី២០	Игры Юго-Восточной Азии 1999
បុណ្យ តារា	Танабата
ស្ពានឃីងតៃ	Кинтай
សមីការកូស៊ី-អយល័រ	Уравнение Коши — Эйлера
ស្ពានខាន់ម៉ុងក្យូ	Каммон (мост)
កីឡាអាស៊ីខាងត្បូង	Южноазиатские игры
វិគីភីឌា:ស្ថានទូតខ្មែរ	Википедия:Посольство
Bottleneck	Узкое место
ប្រៃសណីយ៍ភ័ណ្ឌ	Посылка
ស៊ីហ្គេមលើកទី១៩	Игры Юго-Восточной Азии 1997
ស៊ីហ្គេមលើកទី២៧	Игры Юго-Восточной Азии 2013
ស៊ីហ្គេមលើកទី១៧	Игры Юго-Восточной Азии 1993
ស៊ីហ្គេមលើកទី១០	Игры Юго-Восточной Азии 1979
រាជវង្សហុងបាង	Династия Хонг-банг
ស៊ីហ្គេមលើកទី១៤	Игры Юго-Восточной Азии 1987
កីឡាចុងបូព៌ាឆ្នាំ១៩១៧	Дальневосточные игры 1917
ទីឃនិកាយ	Дигха-никая
អនុគមន៍ទ្រីហ្គាំម៉ា	Тригамма-функция
ខ្សែទឹករង្វល់របស់មហាសមុទ្រ	Общая циркуляция океана
វ៉ន វេត	Ворн Вет
បញ្ជីរាយនាម កោះនៅកម្ពុជា	Список островов Камбоджи
ខ្សែទឹកហ្គ្រីនលែនខាងលិច	Западно-Гренландское течение
អាន ដ្យឿង វឿង	Ан Зыонг-выонг
ខ្មែរលើ	Горные кхмеры
គមនាគមន៍កម្ពុជា	Транспорт в Камбодже
អនុគមន៍ហ្គុឌែរម៉ាន់	Функция Гудермана
អភិបាលកិច្ចល្អ	Качество государственного управления
ឃុនបរម	Кхун Бором
មួយម៉ូនីកា	Агнес Моника
Candies	Candies
កីឡាអាស៊ីកណ្ដាល	Центральноазиатские игры
កីឡាឧបទ្វីបអាស៊ីអាគ្នេយ៍លើកទី២	Игры полуострова Юго-Восточной Азии 1961
កីឡាឧបទ្វីបអាស៊ីអាគ្នេយ៍លើកទី៧	Игры полуострова Юго-Восточной Азии 1973
កីឡាអាស៊ីខាងកើតឆ្នាំ២០០១	Восточноазиатские игры 2001
ខ្មែរក្រោម	Кхмер-кром
ស៊ីហ្គេមលើកទី១២	Игры Юго-Восточной Азии 1983
សមាគមអូឡាំពិកឥណ្ឌា	Олимпийский комитет Индии
កីឡាចុងបូព៌ាឆ្នាំ១៩១៥	Дальневосточные игры 1915
កីឡាចុងបូព៌ាឆ្នាំ១៩១៣	Дальневосточные игры 1913
ប្រាសាទព្រះប៉ាលីឡៃ	Преах Палилай
ESET NOD32 Antivirus	ESET NOD32
វិគីភីឌា:Glossary	Википедия:Глоссарий
បុណ្យ	Пунья
ចំណាត់ថ្នាក់ក្រុម:ប្រទេសជប៉ុន	Категория:Япония
ចំណាត់ថ្នាក់ក្រុម:ម៉ិកសិច	Категория:Мексика
ទ្រឹស្តីបទប្រាម៉ាហ្គឹបតា	Теорема Брахмагупты
ចេមនិងផ្លែប៉ែសយក្ស	Джеймс и гигантский персик
បន្ទប់សារពត៌មាន	Ньюсрум
ចំណាត់ថ្នាក់ក្រុម:ឥណ្ឌូនេស៊ី	Категория:Индонезия
ចំណាត់ថ្នាក់ក្រុម:សិង្ហបុរី	Категория:Сингапур
ចំណាត់ថ្នាក់ក្រុម:រូបវិទ្យា	Категория:Физика
ចំណាត់ថ្នាក់ក្រុម:វិទ្យាសាស្រ្តធម្មជាតិ	Категория:Естественные науки
ចំណាត់ថ្នាក់ក្រុម:ជីវវិទ្យា	Категория:Биология
ចំណាត់ថ្នាក់ក្រុម:សាសនា	Категория:Религия
ចំណាត់ថ្នាក់ក្រុម:កីឡា	Категория:Спорт
ចំណាត់ថ្នាក់ក្រុម:វិទ្យាសាស្ត្រ	Категория:Наука
ប្រជាមតិទាក់ទងនឹងឯករាជភាពរបស់ស្កុតឡែនឆ្នំា២០១៤	Референдум о независимости Шотландии
សំយុត្តនិកាយ	Самъютта-никая
ចំនួនហ្គាលីលេ	Число Галилея
ត្រីគល់រាំង	Гигантский усач
ប្រវត្តិច្បាប់រក្សាសិទ្ធ	История авторского права
Honda HA-420 HondaJet	Honda HA-420 HondaJet
នើនដូ	Steinberg Nuendo
Guizhou JL-9	Guizhou JL-9
ប្រាសាទភ្នំជីសូរ	Пном Тьисор
កោះរុង	Кох Ронг
ខុទ្ទកនិកាយ	Кхуддака-никая
ប៉ាន់ រិទ្ធី	Ритхи Пань
ទំព័រគំរូ:Dts	Шаблон:Dts
វិសមភាព កុលហ្គោម៉ូរ៉ូវ	Неравенство Колмогорова
ទីក្រុងរ៉ូមបុរាណ	Древний Рим
ទំព័រគំរូ:Box-footer	Шаблон:Box-footer
រឹសគូប	Кубический корень
ប្រាសាទកោះកេរ	Кох Кер
នរោត្ដម សុរាម្រិត	Нородом Сурамарит
អាស៊ីហ្គេមអ៊ីនដរ	Азиатские игры в помещениях
Airbus A318	Airbus A318
ការវាយប្រហារដែនអាកាសនៅទីក្រុងបេកដាត ថ្ងៃទី ១២ កក្តដា ២០០៧	Багдадский авиаудар 12 июля 2007 года
ក្លឹបបាល់ទាត់ ភ្នំពេញក្រោន	Пномпень Краун
វត្តភ្នំ	Ват Пном
ប្រាសាទសំបូរព្រៃគុក	Самборпрейкук
កោះត្រឡាច	Пуло-Кондор
អាគីតា	Акита
ទ្រឹស្ដីបទវ៉ារីញ៉ុង	Теорема Вариньона (геометрия)
ចំណាយរដ្ឋាភិបាល	Государственные расходы
ប្រវត្តិសាស្ត្រខ្មែរដំបូង	Древняя история Камбоджи
ឧទ្យានជាតិព្រះសុរាម្រិតកុសុមៈគិរីរម្យ	Национальный парк Кириром
ប៉ែន សុវណ្ណ	Пен Сован
ក្រុងតាខ្មៅ	Такмау
ចំណាត់ថ្នាក់ក្រុម:អូឡាំពិក	Категория:Олимпийские игры
ចំណាត់ថ្នាក់ក្រុម:ព្រះពុទ្ធសាសនា	Категория:Буддизм
វប្បធម៍បារាំង	Культура Франции
ប្រទេសនៅអាមេរិកខាងជើង	Список государств и зависимых территорий Северной Америки
បញ្ជីឈ្មោះអនុគមន៍គណិតវិទ្យា	Проект:Математика/Списки/Список математических функций
ស្ថានីយទូរទស្សន៍	Телевизионный канал
ព្រះពុទ្ធសាសនានៅប្រទេសបារាំង	Буддизм во Франции
ឈិង	Чинг (музыкальный инструмент)
ជំងឺរលាកបំពង់ក	Фарингит
ទេសចរបារាំង	Туризм во Франции
អាកាសយានដ្ឋានអន្តរជាតិក្រុងព្រះសីហនុ	Сиануквиль (аэропорт)
ការដឹងគ្រប់គ្រាន់នៃវិធីដកដង្ហើម១៦យ៉ាង	Анапанасати
ស្រុកមេមត់	Мемот
ទំព័រគំរូ:Lang-ta	Шаблон:Lang-ta
ចំនួនអូតូម៉ហ្វីស	Автоморфное число
ពហុធាប៊ែរនូយី	Многочлены Бернулли
ច្បាប់កំលាំងរបស់អំពែរ	Закон Ампера
ព្រះធម្មចក្កប្បវត្តនសូត្រ	Дхармачакра-правартана-сутра
សមីការឌីផេរ៉ង់ស្យែល -អាំងតេក្រាល	Интегро-дифференциальные уравнения
ការផ្សាយពាណិជ្ជកម្ម	Медийная реклама
ឃុំរលួស (ស្រុកស្វាយចេក)	Ролуох
ខេត្តបលិខាំសៃ	Боликхамсай
ខណ្ឌរដ្ឋបាលសាលាភីឡាដេលផ្យា	Филадельфийский школьный округ
ភ្នំឧដុង្គ	Удонг
ទ្រឹស្តីបទមីកេល	Точка Микеля
វិសាខា	Вишакха
ជនជាតិចារាយ(ខ្មែរលើ)	Зярай
អនុស័យ​	Анасуя
ធម្មសង្គណី	Дхаммасангани
ចៅ​សែន​ កុសល​ឈុំ	Чау Сен Коксал Чхум
ចំណូលរដ្ឋាភិបាល	Государственные доходы
បដ្ឋាន	Паттхана
កថាវត្ថុ	Катхаваттху
ធាតុកថា	Дхатукатха
ម៉ោងនៅឥណ្ឌូនេស៊ី	Время в Индонезии
យមក	Ямака
ជញ្ជាំងក្រហម	Воин Рэдволла
វត្តព្រះកែវមរកត	Серебряная пагода
រូបមន្តតង់សង់កន្លះមុំ	Формула тангенса половинного угла
ដប់ប្រាំពីរមេសាជោគជ័យ	17 апреля (гимн)
មហេន្ទ្រវម៌្មទី១	Махендраварман
សមីការតូរីចេល្លី	Формула Торричелли (кинематика)
កីឡាចុងបូព៌ាឆ្នាំ១៩១៩	Дальневосточные игры 1919
បណ្តុំកន្សោមរ៉ាឌីកាល់	Вложенные радикалы
កីឡាចុងបូព៌ាឆ្នាំ១៩២១	Дальневосточные игры 1921
កីឡាចុងបូព៌ាឆ្នាំ១៩៣០	Дальневосточные игры 1930
កីឡាចុងបូព៌ាឆ្នាំ១៩២៧	Дальневосточные игры 1927
កីឡាចុងបូព៌ាឆ្នាំ១៩២៣	Дальневосточные игры 1923
កីឡាចុងបូព៌ាឆ្នាំ១៩៣៤	Дальневосточные игры 1934
ស៊ីនុសអាំងតេក្រាល	Интегральный синус
អ្នកស្រែ	Рисовые люди
ទំព័រគំរូ:Location map USA2	Шаблон:ПозКарта США
ចំណាត់ថ្នាក់ក្រុម:អត្ថបទខ្លីមិនពេញលេញ	Категория:Незавершённые статьи
ចំណាត់ថ្នាក់ក្រុម:ទ្វីប	Категория:Континенты
ចំណាត់ថ្នាក់ក្រុម:ភូមិវិទ្យា	Категория:Геология
ចំណាត់ថ្នាក់ក្រុម:យន្តហោះ	Категория:Воздушные суда
ពិធីបុណ្យចូលឆ្នាំខ្មែរ	Новый год в Камбодже
កីឡាឧបទ្វីបអាស៊ីអាគ្នេយ៍ដែលគ្រងនឹងធ្វើនៅឆ្នាំ១៩៦៣	Игры полуострова Юго-Восточной Азии 1963
រស់ សេរីសុទ្ធា	Рос Серейсотея
យុទ្ធនាការកម្ពុជា	Камбоджийская кампания
អនុគមន៍ដសុន	Функция Доусона
ជយទេវីទី១	Джаядеви
ទំព័រគំរូ:ប្រព័ន្ធព្រះអាទិត្យ	Шаблон:Солнечная система
ទុង សៀន	Дун Сянь
ពីរ៉ាមីត	Пирамида (геометрия)
ពន្ធតែមប្រិ៍	Гербовая марка
ខុជ្ជុត្តរា	Кхудджуттара
ជំនួយ:ការកត់ឈ្មោះចូល	Википедия:Представление системе
ការបោះឆ្នោតជ្រើសតាំងតំណាងរាស្ត្រ នីតិកាលទី៥ ឆ្នាំ២០១៣	Парламентские выборы в Камбодже (2013)
គ្រោះមហន្តរាយ	Катастрофа
វិគីភីឌា:Reference desk	Википедия:Форум/Вопросы
ទំព័រគំរូ:Authority control	Шаблон:Внешние ссылки
ទំព័រគំរូ:Quote	Шаблон:Цитата
ទំព័រគំរូ:Wikipedia languages	Шаблон:Wikipedialang
ទំព័រគំរូ:Location map Scotland	Шаблон:ПозКарта Великобритания Шотландия
ទំព័រគំរូ:Location map England	Шаблон:ПозКарта Великобритания Англия
ចំណាត់ថ្នាក់ក្រុម:សេដ្ឋកិច្ច	Категория:Экономика
វិគីភីឌា:សុំប្តូរអត្តនាម	Википедия:Запросы на переименование учётных записей
ចំណាត់ថ្នាក់ក្រុម:ជនជាតិ ភាគតិច ក្នុង ប្រទេស កម្ពុជា	Категория:Народы Камбоджи
វិគីភីឌា:Oversight	Википедия:Ревизоры
វិគីភីឌា:IP block exemption	Википедия:Исключение из IP-блокировок
វិគីភីឌា:រូបយន្ត	Википедия:Бот
ចំណាត់ថ្នាក់ក្រុម:Hidden categories	Категория:Скрытые категории
សមីការឌីផេរ៉ង់ស្យែលទ្វេធា	Биномиальное дифференциальное уравнение
ទេវតា	Дэва (буддизм)
ក្រលាផ្ទៃរង្វង់	Площадь круга
អេហ៊្សីប	Египет
វេយ្យាករណ៍ភាសាខ្មែរ	Грамматика кхмерского языка
ជំនួយ:ទំព័រគំរូ	Википедия:Механизм шаблонов
ឦសានវម៌្មទី១	Ишанаварман I
វិគីភីឌា:វិគីគម្រោង	Википедия:Проекты
ខុទ្ទកបាឋ	Кхуддакапатха
យីហ៊ុប	Магнолия коко
ក្រសួងការបរទេស និងសហប្រតិបត្តិការអន្តរជាតិ	Министерство иностранных дел и международного сотрудничества Камбоджи
ទំព័រគំរូ:Bot	Шаблон:Bot
វិគីភីឌា:អ្វីៗដែលវិគីភីឌាមិនអនុញ្ញាត	Википедия:Чем не является Википедия
កាណាដា	Канада
ចំណាត់ថ្នាក់ក្រុម:ប្រទេសអាយឡែន	Категория:Исландия
វិគីភីឌា:អំពីវិគីភីឌា	Википедия:Описание
ចំណាត់ថ្នាក់ក្រុម:ខ្នាតក្រលាផ្ទៃ	Категория:Единицы измерения площади
វិគីភីឌា:Database reports	Википедия:Отчёты базы данных
ទំព័រគំរូ:Flagicon	Шаблон:Флаг
ចំណាត់ថ្នាក់ក្រុម:អឺរ៉ុប	Категория:Европа
ចំណាត់ថ្នាក់ក្រុម:បច្ចេកវិទ្យា	Категория:Классификация по главным темам
ចំណាត់ថ្នាក់ក្រុម:ជំនួយក្នុងវិគីភីឌា	Категория:Википедия:Справка
វិគីភីឌា:ទំព័រអ្នកប្រើប្រាស់	Википедия:Личная страница участника
វិគីភីឌា:ព្រឹត្តិការណ៍​ថ្មីៗ	Портал:Текущие события
ទំព័រគំរូ:Documentation	Шаблон:Doc
វិគីភីឌា:អ្នកប្រើប្រាស់	Википедия:Права участников
វិគីភីឌា:Protection policy	Википедия:Правила защиты страниц
វិគីភីឌា:Userboxes	Википедия:Юзербоксы
វិគីភីឌា:ហត្ថលេខា	Википедия:Подписывайтесь на страницах обсуждения
វិគីភីឌា:អត្ថបទខ្លីមិនពេញលេញ	Википедия:Заготовка статьи
វិគីភីឌា:លក្ខណៈវិនិច្ឆ័យនៃលុបជាបន្ទាន់	Википедия:Критерии быстрого удаления
វិគីភីឌា:Most wanted articles	Википедия:К созданию
ចំណាត់ថ្នាក់ក្រុម:ទំព័រអសង្ស័យកម្ម អំពីឈ្មោះទីកន្លែង	Категория:Страницы разрешения неоднозначностей:Географические объекты
្ឞ្ញ ហ្សអិ-អិអៀ	Сон Джэги
ទំព័រគំរូ:Facebook navbox	Шаблон:Facebook navbox
វិគីភីឌា:Huggle	Википедия:Huggle
ទំព័រគំរូ:Softredirect	Шаблон:Soft redirect
ទំព័រគំរូ:លុបជាបន្ទាន់	Шаблон:К быстрому удалению
ក្លោងទ្វារ:ចិន	Портал:Китай
វិគីភីឌា:វិគីគម្រោង ជីវប្រវត្តិ	Проект:Персоналии
ការត្រួតត្រារបស់ជប៉ុននៅកម្ពុជា	Японская оккупация Камбоджи
កូក្លេអូអ៊ីត	Кохлеоида
ចំណាត់ថ្នាក់ក្រុម:ភាសា	Категория:Языки
ចំណាត់ថ្នាក់ក្រុម:វេយ្យាករណ៍	Категория:Грамматика
ចំណាត់ថ្នាក់ក្រុម:វិគីភីឌា	Категория:Википедия
វិគីភីឌា:ការបដិសេធ ទូទៅ	Википедия:Отказ от ответственности
ជំនួយ:ចំណាត់ថ្នាក់ក្រុម	Википедия:Категория
វិគីភីឌា:អសង្ស័យកម្ម	Википедия:Оформление статей
Portal:Contents/Portals	Портал:Обзор
ទំព័រគំរូ:Navbox	Шаблон:Navbox
ជំនួយ:រូបមន្ត	Википедия:Формулы
ជំនួយ:តំណភ្ជាប់	Википедия:Ссылка на раздел
ទំព័រគំរូ:Citation needed	Шаблон:Нет источника
តំបន់ពាណិជ្ជកម្មសេរី	Зона свободной торговли
ទំព័រគំរូ:Error	Шаблон:Error
ចំណាត់ថ្នាក់ក្រុម:Flag templates	Категория:Шаблоны:Флаги
ទំព័រគំរូ:((	Шаблон:((
ទំព័រគំរូ:))	Шаблон:))
ទំព័រគំរូ:=	Шаблон:=
ទំព័រគំរូ:Navbar	Шаблон:Tnavbar
ទំព័រគំរូ:Void	Шаблон:Пустой шаблон
ទំព័រគំរូ:Key press	Шаблон:Клавиша
ទំព័រគំរូ:Sc	Шаблон:Smallcaps
ទំព័រគំរូ:Small	Шаблон:Small
ទំព័រគំរូ:Clear	Шаблон:Clear
ទំព័រគំរូ:Col-break	Шаблон:Столбец
ទំព័រគំរូ:Col-begin	Шаблон:Столбцы
ទំព័រគំរូ:Col-end	Шаблон:Столбцы/конец
ទំព័រគំរូ:Trim	Шаблон:Trim
ទំព័រគំរូ:Color	Шаблон:Color
ទំព័រគំរូ:Nowrap	Шаблон:Nobr
ទំព័រគំរូ:Bots	Шаблон:Bots
ទំព័រគំរូ:Abbr	Шаблон:Abbr
វិគីភីឌា:វិគីគម្រោង ទំព័រគំរូ	Проект:Шаблоны
ចំណាត់ថ្នាក់ក្រុម:ខ្សែកោង	Категория:Кривые
ទំព័រគំរូ:Babel	Шаблон:Babel
ទំព័រគំរូ:Commons	Шаблон:Commons
ទំព័រគំរូ:Reflist	Шаблон:Примечания
វិគីភីឌា:Citing sources	Википедия:Ссылки на источники
ទំព័រគំរូ:អត្ថបទខ្លីមិនពេញលេញ	Шаблон:Заготовка
ទំព័រគំរូ:User af-1	Шаблон:User af-1
ទំព័រគំរូ:User als-1	Шаблон:User als-1
ទំព័រគំរូ:User az	Шаблон:User az
ទំព័រគំរូ:See also	Шаблон:См. также
ទំព័រគំរូ:User de	Шаблон:User de
ទំព័រគំរូ:User de-1	Шаблон:User de-1
ទំព័រគំរូ:User et-1	Шаблон:User et-1
ទំព័រគំរូ:User el	Шаблон:User el
ទំព័រគំរូ:User es	Шаблон:User es
ទំព័រគំរូ:User de-3	Шаблон:User de-3
ទំព័រគំរូ:User en-3	Шаблон:User en-3
ទំព័រគំរូ:User en-1	Шаблон:User en-1
ទំព័រគំរូ:User en-2	Шаблон:User en-2
ទំព័រគំរូ:User en-4	Шаблон:User en-4
ទំព័រគំរូ:User fi	Шаблон:User fi
ទំព័រគំរូ:User en-0	Шаблон:User en-0
ទំព័រគំរូ:User es-4	Шаблон:User es-4
ទំព័រគំរូ:User en	Шаблон:User en
ទំព័រគំរូ:User de-2	Шаблон:User de-2
ទំព័រគំរូ:User es-1	Шаблон:User es-1
ទំព័រគំរូ:User fa	Шаблон:User fa
ទំព័រគំរូ:User fr-1	Шаблон:User fr-1
ទំព័រគំរូ:User id-3	Шаблон:User id-3
ទំព័រគំរូ:User it-3	Шаблон:User it-3
ទំព័រគំរូ:User tr-2	Шаблон:User tr-2
ទំព័រគំរូ:User fr-2	Шаблон:User fr-2
ទំព័រគំរូ:User tr	Шаблон:User tr
ទំព័រគំរូ:User ja	Шаблон:User ja
ទំព័រគំរូ:User ja-1	Шаблон:User ja-1
ទំព័រគំរូ:User it-1	Шаблон:User it-1
ទំព័រគំរូ:User fr	Шаблон:User fr
ទំព័រគំរូ:Location map/Info	Шаблон:ПозКарта/Инфо
ចំណាត់ថ្នាក់ក្រុម:Navigational boxes	Категория:Википедия:Навигационные шаблоны
ទំព័រគំរូ:ទិន្នន័យ នៃប្រទេសតាជីគីស្ថាន	Шаблон:Флагификация/Таджикистан
ចំណាត់ថ្នាក់ក្រុម:អាស៊ី	Категория:Азия
ចំណាត់ថ្នាក់ក្រុម:User uk-N	Категория:User uk-N
ទំព័រគំរូ:Intricate template	Шаблон:Эзотерика
ទំព័រគំរូ:Lang-ja	Шаблон:Lang-ja
ទំព័រគំរូ:ទិន្នន័យប្រទេស គុយវ៉ែត	Шаблон:Флагификация/Кувейт
ទំព័រគំរូ:Mod	Шаблон:Mod
ទំព័រគំរូ:Now Commons	Шаблон:Перенесено на Викисклад
ទំព័រគំរូ:User it	Шаблон:User it
ទំព័រគំរូ:User uk	Шаблон:User uk
ទំព័រគំរូ:User es-2	Шаблон:User es-2
ទំព័រគំរូ:ស្វាគមន៍	Шаблон:Приветствие
ទំព័រគំរូ:គម្រោងវិគីជាបងប្អូន	Шаблон:Сообщество Википедии
ចំណាត់ថ្នាក់ក្រុម:External link templates	Категория:Шаблоны:Внешние ссылки
ទំព័រគំរូ:Month header	Шаблон:Месяцы
ទំព័រគំរូ:ទិន្នន័យប្រទេស ស្លូវ៉ាគី	Шаблон:Флагификация/Словакия
ចំណាត់ថ្នាក់ក្រុម:ទំព័រគំរូសំរាប់កូអរដោនេ	Категория:Шаблоны с географическими координатами
ទំព័រគំរូ:USA	Шаблон:USA
ទំព័រគំរូ:ទិន្នន័យប្រទេស អេត្យូពី	Шаблон:Флагификация/Эфиопия
ទំព័រគំរូ:ទិន្នន័យប្រទេស ឆេក	Шаблон:Флагификация/Чехия
ទំព័រគំរូ:ទិន្នន័យ នៃប្រទេសថៃ	Шаблон:Флагификация/Таиланд
ទំព័រគំរូ:ទិន្នន័យប្រទេស គុយបា	Шаблон:Флагификация/Куба
ទំព័រគំរូ:Lang-km	Шаблон:Lang-km
ទំព័រគំរូ:ទិន្នន័យប្រទេស អាល់បានី	Шаблон:Флагификация/Албания
ទំព័រគំរូ:ទិន្នន័យ នៃប្រទេសប៉េរូ	Шаблон:Флагификация/Перу
ទំព័រគំរូ:ទិន្នន័យ នៃប្រទេសម៉ាកាវ	Шаблон:Флагификация/Макао
ទំព័រគំរូ:ទិន្នន័យប្រទេស សាធារណរដ្ឋចិន	Шаблон:Флагификация/Китайская Республика
ទំព័រគំរូ:ទិន្នន័យ នៃប្រទេសអ៊ូបេគីស្ថាន	Шаблон:Флагификация/Узбекистан
ចំណាត់ថ្នាក់ក្រុម:User ms	Категория:User ms
ទំព័រគំរូ:ទិន្នន័យ នៃប្រទេសឡាតវី	Шаблон:Флагификация/Латвия
ទំព័រគំរូ:Football kit	Шаблон:Футбольная форма
ទំព័រគំរូ:ទិន្នន័យ នៃប្រទេសម៉ាល់តា	Шаблон:Флагификация/Мальта
ទំព័រគំរូ:ទិន្នន័យ នៃប្រទេសម៉ូណាកូ	Шаблон:Флагификация/Монако
ទំព័រគំរូ:ទិន្នន័យ នៃប្រទេសដាណឺម៉ាក	Шаблон:Флагификация/Дания
ទំព័រគំរូ:Wikiatlas	Шаблон:Wikiatlas
ទំព័រគំរូ:ទិន្នន័យ នៃប្រទេសប៉ូឡូញ	Шаблон:Флагификация/Польша
ចំណាត់ថ្នាក់ក្រុម:User fr-1	Категория:User fr-1
ទំព័រគំរូ:ទិន្នន័យ នៃប្រទេសណ័រវ៉េ	Шаблон:Флагификация/Норвегия
ទំព័រគំរូ:ទិន្នន័យប្រទេស ហ្សកហ៊្សី	Шаблон:Флагификация/Грузия
ទំព័រគំរូ:Navbox suite	Шаблон:Навигационные шаблоны
ទំព័រគំរូ:Wikiquote	Шаблон:Викицитатник
ទំព័រគំរូ:Image label	Шаблон:Метка изображения
ទំព័រគំរូ:ទិន្នន័យប្រទេស ស្រីលង្កា	Шаблон:Флагификация/Шри-Ланка
ទំព័រគំរូ:ទិន្នន័យ នៃប្រទេសមិចសិច	Шаблон:Флагификация/Мексика
ទំព័រគំរូ:ទិន្នន័យប្រទេស ក្រិច	Шаблон:Флагификация/Греция
ទំព័រគំរូ:ទិន្នន័យ នៃប្រទេសអារ៉ាប៊ីសាអូឌីត	Шаблон:Флагификация/Саудовская Аравия
ទំព័រគំរូ:Category tree	Шаблон:Дерево категорий
ទំព័រគំរូ:ទិន្នន័យប្រទេស ក្រូអាត	Шаблон:Флагификация/Хорватия
ទំព័រគំរូ:ប្រអប់ព័ត៌មាន អ្នកនិពន្ធ	Шаблон:Писатель
ទំព័រគំរូ:Stub category	Шаблон:Stub-category
ទំព័រគំរូ:Ja icon	Шаблон:Ref-ja
ទំព័រគំរូ:ទិន្នន័យ នៃប្រទេសសហភាពអារ៉ាប់អេមីរ៉េត	Шаблон:Флагификация/ОАЭ
ទំព័រគំរូ:Infobox television	Шаблон:Телепередача
ទំព័រគំរូ:Infobox musical artist	Шаблон:Музыкант
ទំព័រគំរូ:Finance	Шаблон:Финансы
ទំព័រគំរូ:ទិន្នន័យប្រទេស Serbia	Шаблон:Флагификация/Сербия
ទំព័រគំរូ:Collapsible list	Шаблон:Collapsible list
ទំព័រគំរូ:ទិន្នន័យ នៃប្រទេសអូស្រ្តាលី	Шаблон:Флагификация/Австралия
ទំព័រគំរូ:ទិន្នន័យ​នៃប្រទេសប៉ាឡេស្ទីន	Шаблон:PSE
ទំព័រគំរូ:Subatomic particle	Шаблон:SubatomicParticle
ទំព័រគំរូ:Sidebar	Шаблон:Боковая навигационная таблица
ទំព័រគំរូ:In use	Шаблон:Редактирую
ទំព័រគំរូ:Es icon	Шаблон:Ref-es
ទំព័រគំរូ:ទិន្នន័យ នៃប្រទេសបារាំង	Шаблон:Флагификация/Франция
ទំព័រគំរូ:Ambox	Шаблон:Ambox
ទំព័រគំរូ:Update	Шаблон:Обновить
ទំព័រគំរូ:ប្រអប់ព័ត៌មាន មន្ទីរពេទ្យ	Шаблон:Больница
ទំព័រគំរូ:ប្រអប់ព័ត៌មាន ទស្សនាវដ្ដី	Шаблон:Журнал
ទំព័រគំរូ:Image requested	Шаблон:Нет иллюстрации
ទំព័រគំរូ:ប្រអប់ព័ត៌មាន ភ្លេងជាតិ	Шаблон:Гимн
ទំព័រគំរូ:ទិន្នន័យ​នៃប្រទេសគាហ្គីស្ថាន	Шаблон:KGZ
ទំព័រគំរូ:ប្រអប់ព័ត៌មាន សាលារៀន	Шаблон:Школа
ទំព័រគំរូ:Userboxbottom	Участник:Box/Конец колонки
ទំព័រគំរូ:Copy to Wikimedia Commons	Шаблон:Перенести на Викисклад
ទំព័រគំរូ:ចំណាត់ថ្នាក់ក្រុមនៃទំព័រគំរូ	Шаблон:Категория шаблонов
ទំព័រគំរូ:Font color	Шаблон:Oncolor
ទំព័រគំរូ:ប្រអប់ព័ត៌មាន ប្រទេស	Шаблон:Государство
ទំព័រគំរូ:Max	Шаблон:Max
ទំព័រគំរូ:Infobox software	Шаблон:Карточка программы
ទំព័រគំរូ:Column-count	Шаблон:Column-count
ទំព័រគំរូ:ទិន្នន័យប្រទេស ឡាវ	Шаблон:Флагификация/Лаос
ទំព័រគំរូ:Infobox airline	Шаблон:Карточка авиакомпании
ទំព័រគំរូ:Wide image	Шаблон:Панорама
ទំព័រគំរូ:ទិន្នន័យ នៃប្រទេសអូទ្រីស	Шаблон:Флагификация/Австрия
ទំព័រគំរូ:Collapsible option	Шаблон:Опция скрытия
ទំព័រគំរូ:ប្រអប់ព័ត៌មាន ជម្លោះយោធា	Шаблон:Вооружённый конфликт
ទំព័រគំរូ:Redirect4	Шаблон:Str left
ទំព័រគំរូ:ទិន្នន័យ នៃប្រទេសនេប៉ាល់	Шаблон:Флагификация/Непал
ទំព័រគំរូ:Px	Шаблон:Px
ទំព័រគំរូ:Resolved	Шаблон:Сделано
ទំព័រគំរូ:Str sub long	Шаблон:Str sub
ទំព័រគំរូ:ទិន្នន័យ នៃប្រទេសហ្វាំងឡង់	Шаблон:Флагификация/Финляндия
ទំព័រគំរូ:Selfref	Шаблон:Selfref
ទំព័រគំរូ:Flatlist	Шаблон:Flatlist
ទំព័រគំរូ:ទិន្នន័យ​នៃប្រទេសហ្វីលីពីន	Шаблон:PHL
ទំព័រគំរូ:ទិន្នន័យ នៃប្រទេសអេស៊ីប	Шаблон:Флагификация/Египет
ទំព័រគំរូ:ទិន្នន័យ នៃប្រទេសលីថូនី	Шаблон:Флагификация/Литва
ទំព័រគំរូ:ប្រអប់ព័ត៌មាន គណបក្សនយោបាយ	Шаблон:Партия
ទំព័រគំរូ:ទិន្នន័យប្រទេស ជប៉ុន	Шаблон:Флагификация/Япония
ទំព័រគំរូ:Expand section	Шаблон:Заготовка раздела
ទំព័រគំរូ:ទិន្នន័យ នៃប្រទេសហូឡង់	Шаблон:Флагификация/Нидерланды
ទំព័រគំរូ:Tmbox	Шаблон:Tmbox
ទំព័រគំរូ:Navbox with columns	Шаблон:Навигационная таблица с колонками
ទំព័រគំរូ:ប្រអប់ព័ត៌មាន ល្បែងវីដេអូ	Шаблон:Компьютерная игра
ទំព័រគំរូ:S-start	Шаблон:Start box
ទំព័រគំរូ:Age in years and days	Шаблон:Age in years and days
ទំព័រគំរូ:Nom	Шаблон:Nom
ទំព័រគំរូ:Facebook	Шаблон:Facebook
ទំព័រគំរូ:Cleanup	Шаблон:Чистить
ទំព័រគំរូ:ប្រអប់ព័ត៌មាន សាកលវិទ្យាល័យ	Шаблон:Карточка университета
ទំព័រគំរូ:Cite journal	Шаблон:Cite journal
ទំព័រគំរូ:ទិន្នន័យប្រទេស អាស៊ែបៃហ្សង់	Шаблон:Флагификация/Азербайджан
ទំព័រគំរូ:ទិន្នន័យ​នៃប្រទេសប្រ៊ុយណេ	Шаблон:BRN
ទំព័រគំរូ:វិគីសៀវភៅ	Шаблон:Викиучебник
ទំព័រគំរូ:Hatnote	Шаблон:Другое значение
ទំព័រគំរូ:User browser:Firefox	Участник:Box/Пользователь Firefox
ទំព័រគំរូ:User es-0	Шаблон:User es-0
ទំព័រគំរូ:Time ago	Шаблон:Прошло времени
ទំព័រគំរូ:Familytree	Шаблон:Familytree
ទំព័រគំរូ:ទិន្នន័យប្រទេស វៀតណាម	Шаблон:Флагификация/Вьетнам
ទំព័រគំរូ:S-aft	Шаблон:S-aft
ទំព័រគំរូ:Featured article	Шаблон:Избранная статья
ទំព័រគំរូ:ទិន្នន័យ នៃប្រទេសរុស្ស៊ី	Шаблон:Флагификация/Россия
ចំណាត់ថ្នាក់ក្រុម:User en-4	Категория:User en-4
ចំណាត់ថ្នាក់ក្រុម:User en	Категория:User en
ចំណាត់ថ្នាក់ក្រុម:User zh	Категория:User zh
ចំណាត់ថ្នាក់ក្រុម:User zh-N	Категория:User zh-N
ចំណាត់ថ្នាក់ក្រុម:User en-2	Категория:User en-2
ទំព័រគំរូ:ប្រអប់ព័ត៌មាន	Шаблон:Карточка
ទំព័រគំរូ:Infobox instrument	Шаблон:Музыкальный инструмент
ទំព័រគំរូ:TOC right	Шаблон:TOC right
ទំព័រគំរូ:Main other	Шаблон:Main other
ទំព័រគំរូ:RankedMedalTable	Шаблон:Список медалистов
ទំព័រគំរូ:User zh	Шаблон:User zh
ទំព័រគំរូ:Lang-kk	Шаблон:Lang-kk
ទំព័រគំរូ:Navbox/core	Шаблон:Navbox/core
ទំព័រគំរូ:Template other	Шаблон:Template other
ទំព័រគំរូ:Legend	Шаблон:Легенда
ទំព័រគំរូ:ប្រអប់ព័ត៌មាន បណ្ណាល័យ	Шаблон:Библиотека
ទំព័រគំរូ:Cite web	Шаблон:Cite web
ទំព័រគំរូ:YouTube	Шаблон:YouTube
ទំព័រគំរូ:ទិន្នន័យ នៃប្រទេសអ៊ីតាលី	Шаблон:Флагификация/Италия
ទំព័រគំរូ:Current	Шаблон:Текущие события
ទំព័រគំរូ:Ombox	Шаблон:Ombox
ទំព័រគំរូ:Wikipedia-screenshot	Шаблон:Скриншот Википедии
ទំព័រគំរូ:Won	Шаблон:Награда
ទំព័រគំរូ:Tnavbar-collapsible	Шаблон:Tnavbar-collapsible
ទំព័រគំរូ:Pp-template	MediaWiki:Protectedpagetext
ទំព័រគំរូ:Min	Шаблон:Min
ទំព័រគំរូ:Wiktionary	Шаблон:Викисловарь
ទំព័រគំរូ:Mbox templates	Шаблон:Mbox templates
ទំព័រគំរូ:Multi-listen start	Шаблон:Multi-listen start
ទំព័រគំរូ:ទិន្នន័យ នៃប្រទេសស៊ុយអែត	Шаблон:Флагификация/Швеция
ទំព័រគំរូ:Bar box	Шаблон:Bar box
ទំព័រគំរូ:Chem	Шаблон:Химическая формула
ទំព័រគំរូ:Language icon	Шаблон:Ref-lang
ទំព័រគំរូ:Babel-4	Шаблон:Babel-4
ទំព័រគំរូ:Lang-sr	Шаблон:Lang-sr
ទំព័រគំរូ:Infobox settlement	Шаблон:НП
ទំព័រគំរូ:User ru	Шаблон:User ru
ទំព័រគំរូ:IPA	Шаблон:IPA1
ទំព័រគំរូ:អត្ថន័យដទៃទៀត	Шаблон:Другие значения
ទំព័រគំរូ:SeptemberCalendar	Шаблон:Календарь на сентябрь
ទំព័រគំរូ:ទិន្នន័យប្រទេស សហភាពសូវៀត	Шаблон:Флагификация/СССР
ទំព័រគំរូ:ទិន្នន័យ នៃប្រទេសឥណ្ឌា	Шаблон:Флагификация/Индия
ទំព័រគំរូ:Rellink	Шаблон:Rellink
ទំព័រគំរូ:Navbox subgroup	Шаблон:Navbox subgroups
ទំព័រគំរូ:Birth year and age	Шаблон:Родился
ទំព័រគំរូ:List of African capitals	Шаблон:Столицы Африки
ទំព័រគំរូ:ប្រអប់ព័ត៌មាន ក្រុមជនជាតិ	Шаблон:Народ
ទំព័រគំរូ:Archive box	Шаблон:Архив
ទំព័រគំរូ:MONTHNAME	Шаблон:MONTHNAME
ទំព័រគំរូ:Commons category-inline	Шаблон:Commonscat-inline
ទំព័រគំរូ:Sisterlinks	Шаблон:Навигация
ទំព័រគំរូ:ទិន្នន័យប្រទេស អង់ដូរ៉ា	Шаблон:Флагификация/Андорра
ទំព័រគំរូ:ប្រអប់ព័ត៌មាន តំបន់ការពារ	Шаблон:Заповедная зона
ទំព័រគំរូ:Border	Шаблон:Граница
ទំព័រគំរូ:ទិន្នន័យប្រទេស ព័រទុយហ្គាល់	Шаблон:Флагификация/Португалия
ទំព័រគំរូ:Death date and age	Шаблон:Умер
ទំព័រគំរូ:MONTHNUMBER	Шаблон:MONTHNUMBER
ចំណាត់ថ្នាក់ក្រុម:People stubs	Категория:Незавершённые статьи о людях
ទំព័រគំរូ:ទិន្នន័យប្រទេស បុរីវ៉ាទីកង់	Шаблон:Флагификация/Ватикан
ទំព័រគំរូ:Top icon	Шаблон:Right-uppermost image
ចំណាត់ថ្នាក់ក្រុម:Template:Country data templates	Категория:Шаблоны:Флагификация
ទំព័រគំរូ:Birth category header	Шаблон:Birthyr
ទំព័រគំរូ:Namespace detect	Шаблон:Namespace detect
ចំណាត់ថ្នាក់ក្រុម:ជ័យលាភីរង្វាន់ណូបែល ផ្នែករូបវិទ្យា	Категория:Лауреаты Нобелевской премии по физике
ចំណាត់ថ្នាក់ក្រុម:ជ័យលាភីរង្វាន់ណូបែល ផ្នែកគីមីវិទ្យា	Категория:Лауреаты Нобелевской премии по химии
ទំព័រគំរូ:Fmbox	Шаблон:Fmbox
ទំព័រគំរូ:Navbox with collapsible groups	Шаблон:Навигационная таблица с блоками
ទំព័រគំរូ:GeoGroup	Шаблон:Объекты категории на картах
ទំព័រគំរូ:ទិន្នន័យប្រទេស ចិន	Шаблон:Флагификация/Китай
ទំព័រគំរូ:Wikify	Шаблон:Викифицировать
ទំព័រគំរូ:ទិន្នន័យ នៃ ប្រទេស អង់គ្លេស	Шаблон:Флагификация/Англия
ទំព័រគំរូ:ទិន្នន័យ នៃប្រទេសទួរគី	Шаблон:Флагификация/Турция
ទំព័រគំរូ:ទិន្នន័យ នៃប្រទេសស្វីស	Шаблон:Флагификация/Швейцария
ទំព័រគំរូ:ទិន្នន័យ នៃប្រទេសហ្វីលីពីន	Шаблон:Флагификация/Филиппины
ទំព័រគំរូ:Hidden begin	Шаблон:Начало скрытого блока
ទំព័រគំរូ:ទិន្នន័យ នៃប្រទេសម៉ាឡេស៊ី	Шаблон:Флагификация/Малайзия
ទំព័រគំរូ:ទិន្នន័យប្រទេស អាមេនី	Шаблон:Флагификация/Армения
ទំព័រគំរូ:Infobox OS	Шаблон:Карточка ОС
ទំព័រគំរូ:ទិន្នន័យប្រទេស វៀតណាមខាងត្បូង	Шаблон:Флагификация/Южный Вьетнам
ទំព័រគំរូ:ទិន្នន័យ នៃប្រទេសភូមា	Шаблон:Флагификация/Мьянма
ទំព័រគំរូ:ទិន្នន័យ នៃប្រទេសឈីលី	Шаблон:Флагификация/Чили
ទំព័រគំរូ:ទិន្នន័យប្រទេស លីបង់	Шаблон:Флагификация/Ливан
ទំព័រគំរូ:ប្រអប់ព័ត៌មាន សៀវភៅ	Шаблон:Издание
ទំព័រគំរូ:Tlc	Шаблон:Tlc
ទំព័រគំរូ:ប្រអប់ព័ត៌មាន ភព	Шаблон:Карточка планеты
ទំព័រគំរូ:Compact periodic table	Шаблон:Периодическая система элементов
ទំព័រគំរូ:Lang-fa	Шаблон:Lang-fa
ទំព័រគំរូ:ICD10	Шаблон:ICD10
ទំព័រគំរូ:ទិន្នន័យ​នៃប្រទេសម៉ាឡេស៊ី	Шаблон:MYS
ទំព័រគំរូ:Infobox website	Шаблон:Карточка сайта
ទំព័រគំរូ:Globalize	Шаблон:Глобализировать
ទំព័រគំរូ:Image label end	Шаблон:Image label end
ទំព័រគំរូ:Navboxes	Шаблон:Навигационный блок
ទំព័រគំរូ:Documentation subpage	Шаблон:Docpage
ទំព័រគំរូ:Uncategorized	Шаблон:Нет категорий
ទំព័រគំរូ:ទិន្នន័យ​នៃប្រទេសឥណ្ឌូនេស៊ី	Шаблон:IDN
ទំព័រគំរូ:Talk header for guidelines	Шаблон:Заголовок обсуждения
ទំព័រគំរូ:Quote box	Шаблон:Quote box
ទំព័រគំរូ:Navbox years	Шаблон:NavboxYears
ទំព័រគំរូ:CcTLD	Шаблон:Национальные домены верхнего уровня
ទំព័រគំរូ:Cc-by-2.0	Шаблон:CC-BY-2.0
ទំព័រគំរូ:Rtl-lang	Шаблон:Rtl-lang
ទំព័រគំរូ:List of Asian capitals by region	Шаблон:Столицы Азии
ទំព័រគំរូ:Bquote	Шаблон:Block quote
ទំព័រគំរូ:ប្រអប់ព័ត៌មានទីកន្លែងកេរដំណែលពិភពលោក	Шаблон:Объект Всемирного наследия
ទំព័រគំរូ:Str len	Шаблон:Str len
ទំព័រគំរូ:Purge	Шаблон:Очистить кэш
ទំព័រគំរូ:Lang-de	Шаблон:Lang-de
ទំព័រគំរូ:Empty category	Шаблон:Не удаляйте категорию
ទំព័រគំរូ:Ifempty	Шаблон:Ifempty
ទំព័រគំរូ:Lang-la	Шаблон:Lang-la
ទំព័រគំរូ:Location map USA	Шаблон:ПозКарта США (ортографическая)
ទំព័រគំរូ:Lang-el	Шаблон:Lang-el
ទំព័រគំរូ:Chessgames player	Шаблон:Chessgames
ទំព័រគំរូ:ទិន្នន័យ​នៃប្រទេសអារ៉ាប៊ីសាអូឌីត	Шаблон:SAU
ទំព័រគំរូ:User page	Шаблон:Userpage
ទំព័រគំរូ:DE	Шаблон:DEU
ទំព័រគំរូ:Lang-my	Шаблон:Lang-my
ទំព័រគំរូ:User	Шаблон:User
ទំព័រគំរូ:Spoken Wikipedia	Шаблон:Слушать статью
ទំព័រគំរូ:University-stub	Шаблон:Vuz-stub
ទំព័រគំរូ:វិគីភីឌាភាសា	Шаблон:Крупнейшие Википедии
ទំព័រគំរូ:Clarify	Шаблон:Прояснить
ទំព័រគំរូ:Refimprove	Шаблон:Нет ссылок
ទំព័រគំរូ:Lorem ipsum	Шаблон:Lorem ipsum
ទំព័រគំរូ:ស្នើសុំប្ដូរឈ្មោះ	Шаблон:Renameuser
ទំព័រគំរូ:Image label small	Шаблон:Image label small
ទំព័រគំរូ:Featured article candidates	Шаблон:Кандидат в избранные статьи
ទំព័រគំរូ:AddNewSection	Шаблон:AddNewSection
ទំព័រគំរូ:Nihongo	Шаблон:Нихонго
ទំព័រគំរូ:User fr-3	Шаблон:User fr-3
ទំព័រគំរូ:PD-because	Шаблон:PD-because
ទំព័រគំរូ:Th icon	Шаблон:Ref-th
ទំព័រគំរូ:Cc-by	Шаблон:CC-BY-1.0
ទំព័រគំរូ:Failed verification	Шаблон:Нет в источнике
ទំព័រគំរូ:Notelist	Шаблон:Notelist
ទំព័រគំរូ:S-ttl	Шаблон:S-ttl
ទំព័រគំរូ:Infobox former country	Шаблон:Историческое государство
ទំព័រគំរូ:JPN	Шаблон:JPN
ទំព័រគំរូ:ភូមិភាគទាំង៩របស់ជប៉ុន	Шаблон:Регионы и административное деление Японии
ទំព័រគំរូ:Merge from	Шаблон:Перенести сюда
ទំព័រគំរូ:Cmbox	Шаблон:Cmbox
ជំនួយ:តារាង	Википедия:Таблицы
ទំព័រគំរូ:Precision	Шаблон:Precision
ទំព័រគំរូ:Gbmapping	Шаблон:Gbmappingsmall
ទំព័រគំរូ:User wikipedia/Checkuser	Участник:Box/Чекъюзер
ទំព័រគំរូ:ទិន្នន័យ​នៃប្រទេសប៉ាគីស្ថាន	Шаблон:PAK
ទំព័រគំរូ:Age in days nts	Шаблон:Days between
ទំព័រគំរូ:S-bef	Шаблон:S-bef
ទំព័រគំរូ:Nations at the 2008 Summer Olympics	Шаблон:Страны на летних Олимпийских играх 2008
ទំព័រគំរូ:Guideline	Шаблон:Руководство
ទំព័រគំរូ:JULIANDAY	Шаблон:JULIANDAY
ទំព័រគំរូ:Disagree	Шаблон:Против
ទំព័រគំរូ:DNB portal	Шаблон:Портал DNB
ទំព័រគំរូ:Talkarchive	Шаблон:Архив обсуждения
ទំព័រគំរូ:Lt	Шаблон:Ref-lt
ទំព័រគំរូ:ទិន្នន័យ​នៃប្រទេសអ៊ីរ៉ង់	Шаблон:IRN
ទំព័រគំរូ:ទិន្នន័យ​នៃប្រទេសហ្សកដង់	Шаблон:JOR
ទំព័រគំរូ:Bibleverse	Шаблон:Библия
ទំព័រគំរូ:ទិន្នន័យ​នៃប្រទេសហុងកុង	Шаблон:HKG
ទំព័រគំរូ:ទិន្នន័យ​នៃប្រទេសកូរ៉េខាងជើង	Шаблон:PRK
ទំព័រគំរូ:Infobox continent	Шаблон:Материк
ទំព័រគំរូ:Date	Шаблон:Date
ទំព័រគំរូ:BHU	Шаблон:BTN
ទំព័រគំរូ:ទិន្នន័យ​នៃប្រទេសសិង្ហបុរី	Шаблон:SGP
ទំព័រគំរូ:ទិន្នន័យ​នៃប្រទេសឥណ្ឌា	Шаблон:IND
ទំព័រគំរូ:ទិន្នន័យ​នៃប្រទេសម៉ាកាវ	Шаблон:MAC
ទំព័រគំរូ:សបា្ដហ៍	Шаблон:Неделя
ទំព័រគំរូ:To do	Шаблон:To-do
ទំព័រគំរូ:Colors	Шаблон:Цвета HTML
ទំព័រគំរូ:CURRENTJULIANDAY	Шаблон:CURRENTJULIANDAY
ទំព័រគំរូ:Nobold	Шаблон:Nobold
ទំព័រគំរូ:PageTabsTop	Шаблон:PageTabsTop
ចំណាត់ថ្នាក់ក្រុម:User ja-N	Категория:User ja-N
ទំព័រគំរូ:Multicol-break	Шаблон:Multicol-break
ទំព័រគំរូ:PDFlink	Шаблон:PDFlink
ទំព័រគំរូ:Ca icon	Шаблон:Ref-ca
ទំព័រគំរូ:ទិន្នន័យ នៃប្រទេសអាល្លឺម៉ងខាងកើត	Шаблон:Флагификация/ФРГ
ទំព័រគំរូ:Region history	Шаблон:История страны
ទំព័រគំរូ:Lang-ru	Шаблон:Lang-ru
ទំព័រគំរូ:Br separated entries	Шаблон:Br separated entries
ទំព័រគំរូ:Infobox saint	Шаблон:Святой
ទំព័រគំរូ:FebruaryCalendar	Шаблон:Календарь на февраль
ទំព័រគំរូ:URL	Шаблон:URL
ទំព័រគំរូ:Hidden end	Шаблон:Конец скрытого блока
ទំព័រគំរូ:ណែនាំ	Шаблон:Неоднозначность
ទំព័រគំរូ:ទិន្នន័យ នៃប្រទេសហុងកុង	Шаблон:Флагификация/Гонконг
ទំព័រគំរូ:DEFAULTSORT	Шаблон:Сортировка
ទំព័រគំរូ:No	Шаблон:Не сделано
ទំព័រគំរូ:Tick	Шаблон:Ok
ចំណាត់ថ្នាក់ក្រុម:ទំព័រគំរូ ប្រអប់ព័ត៌មាន	Категория:Шаблоны:Карточки
ចំណាត់ថ្នាក់ក្រុម:Lists of flags	Категория:Списки флагов
ទំព័រគំរូ:ទិន្នន័យប្រទេស Nazi Germany	Шаблон:Флагификация/Третий рейх
ចំណាត់ថ្នាក់ក្រុម:ហិរញ្ញវត្ថុសាធារណៈ	Категория:Государственные финансы
ចំណាត់ថ្នាក់ក្រុម:អ្នកថតរូប	Категория:Фотография
ទំព័រគំរូ:Contains Japanese text	Шаблон:Японский текст
ទំព័រគំរូ:Para	Шаблон:Para
ទំព័រគំរូ:Partial	Шаблон:Частично
ចំណាត់ថ្នាក់ក្រុម:យន្តហោះយោធា	Категория:Военные самолёты
ទំព័រគំរូ:LAO	Шаблон:LAO
ទំព័រគំរូ:User zh-min-nan	Шаблон:User nan
ទំព័រគំរូ:GRC	Шаблон:GRC
ទំព័រគំរូ:PRT	Шаблон:PRT
ទំព័រគំរូ:ទិន្នន័យ​នៃប្រទេសបង់ក្លាដែស្ស	Шаблон:BGD
ទំព័រគំរូ:States of Austria	Шаблон:Земли Австрии
ទំព័រគំរូ:Ifsubst	Шаблон:Ifsubst
ចំណាត់ថ្នាក់ក្រុម:អង្គការមិនរកប្រាក់កំរៃ	Категория:Некоммерческие организации
ទំព័រគំរូ:High-risk	Шаблон:СИШ
ទំព័រគំរូ:Lang-uk	Шаблон:Lang-uk
ទំព័រគំរូ:Contains Chinese text	Шаблон:Китайский текст
ទំព័រគំរូ:KHM	Шаблон:KHM
ទំព័រគំរូ:ប្រអប់ព័ត៌មាន អង្គការ	Шаблон:Организация
ទំព័រគំរូ:MNE	Шаблон:MNE
ទំព័រគំរូ:Category TOC	Шаблон:Индекс категории
ទំព័រគំរូ:Thumbs up	Шаблон:Спасибо
ទំព័រគំរូ:Resize	Шаблон:Resize
ទំព័រគំរូ:Lang-nl	Шаблон:Lang-nl
ទំព័រគំរូ:ទិន្នន័យ​នៃប្រទេសមីយ៉ាន់ម៉ា	Шаблон:MMR
ទំព័រគំរូ:Lang-id	Шаблон:Lang-id
ទំព័រគំរូ:GSE	Шаблон:Из БСЭ
ទំព័រគំរូ:ទិន្នន័យ​នៃប្រទេសកូរ៉េខាងត្បូង	Шаблон:KOR
ទំព័រគំរូ:EMedicine2	Шаблон:EMedicine2
ទំព័រគំរូ:ទិន្នន័យប្រទេស កាតារ	Шаблон:Флагификация/Катар
ទំព័រគំរូ:User it-2	Шаблон:User it-2
ទំព័រគំរូ:Val	Шаблон:Val
ទំព័រគំរូ:Lang-fr	Шаблон:Lang-fr
ទំព័រគំរូ:មេកានិចក្លាស់សិច	Шаблон:Классическая механика
ទំព័រគំរូ:Superimpose	Шаблон:Superimpose
ទំព័រគំរូ:FRA	Шаблон:FRA
ទំព័រគំរូ:Age	Шаблон:Возраст
ទំព័រគំរូ:Wrap	Шаблон:Wrap
ទំព័រគំរូ:International trade	Шаблон:Торговля
ទំព័រគំរូ:Hang on	Шаблон:Hangon
ទំព័រគំរូ:Flagicon image	Шаблон:Flagicon image
ទំព័រគំរូ:Pending	Шаблон:Ожидается
ទំព័រគំរូ:Infobox person	Шаблон:Персона
ទំព័រគំរូ:?	Шаблон:Неизвестно1
ទំព័រគំរូ:Concat	Шаблон:Concat
ទំព័រគំរូ:ទិន្នន័យ នៃប្រទេសអ៊ីស្រាអែល	Шаблон:Флагификация/Израиль
ទំព័រគំរូ:Number table sorting	Шаблон:Nts
ទំព័រគំរូ:List of European capitals by region	Шаблон:Столицы Европы
ទំព័រគំរូ:ទិន្នន័យប្រទេស កូឡុំប៊ី	Шаблон:Флагификация/Колумбия
ទំព័រគំរូ:ទិន្នន័យ នៃប្រទេសប៉ាគីស្ថាន	Шаблон:Флагификация/Пакистан
ទំព័រគំរូ:ទិន្នន័យប្រទេស Ghana	Шаблон:Флагификация/Гана
ទំព័រគំរូ:ទិន្នន័យប្រទេស កូរ៉េខាងត្បូង	Шаблон:Флагификация/Республика Корея
ទំព័រគំរូ:CIA World Factbook	Шаблон:CIA WFB 2006
ទំព័រគំរូ:Legend-line	Шаблон:Легенда-линия
ចំណាត់ថ្នាក់ក្រុម:ព្រះមហាក្សត្រខ្មែរ	Категория:Короли Камбоджи
ទំព័រគំរូ:Election table	Шаблон:Election table
ទំព័រគំរូ:World Trade Organization	Шаблон:Члены ВТО
ទំព័រគំរូ:Coord	Шаблон:Coord
ទំព័រគំរូ:POV	Шаблон:Проверить нейтральность
ចំណាត់ថ្នាក់ក្រុម:20th-century births	Категория:Родившиеся в XX веке
ទំព័រគំរូ:Dmoz	Шаблон:Dmoz
ចំណាត់ថ្នាក់ក្រុម:ពហុកោណ	Категория:Многоугольники
ទំព័រគំរូ:Fide	Шаблон:ФИДЕ
ទំព័រគំរូ:User fr-4	Шаблон:User fr-4
ទំព័រគំរូ:User la-1	Шаблон:User la-1
ទំព័រគំរូ:ទិន្នន័យប្រទេស បារ៉ែន	Шаблон:Флагификация/Бахрейн
ទំព័រគំរូ:ព្រះពុទ្ធសាសនា	Шаблон:Буддизм
ទំព័រគំរូ:Biology-stub	Шаблон:Biosci-stub
ទំព័រគំរូ:អេឡិចត្រូម៉ាញ៉េទិច	Шаблон:Электродинамика
ចំណាត់ថ្នាក់ក្រុម:ឯកសារអំពី ទំព័រគំរូ	Категория:Шаблоны:Документация
ចំណាត់ថ្នាក់ក្រុម:អត្ថបទខ្លីមិនពេញលេញ អំពីកម្ពុជា	Категория:Незавершённые статьи о Камбодже
ចំណាត់ថ្នាក់ក្រុម:User et	Категория:User et
ចំណាត់ថ្នាក់ក្រុម:User fr	Категория:User fr
ចំណាត់ថ្នាក់ក្រុម:User id	Категория:User id
ចំណាត់ថ្នាក់ក្រុម:User ja	Категория:User ja
ចំណាត់ថ្នាក់ក្រុម:User km	Категория:User km
ចំណាត់ថ្នាក់ក្រុម:User la	Категория:User la
ចំណាត់ថ្នាក់ក្រុម:User li	Категория:User li
ចំណាត់ថ្នាក់ក្រុម:User sv	Категория:User sv
ចំណាត់ថ្នាក់ក្រុម:User th	Категория:User th
ចំណាត់ថ្នាក់ក្រុម:User fr-3	Категория:User fr-3
ចំណាត់ថ្នាក់ក្រុម:User it-3	Категория:User it-3
ចំណាត់ថ្នាក់ក្រុម:User ja-3	Категория:User ja-3
ចំណាត់ថ្នាក់ក្រុម:User tr-3	Категория:User tr-3
ចំណាត់ថ្នាក់ក្រុម:User et-1	Категория:User et-1
ចំណាត់ថ្នាក់ក្រុម:User li-1	Категория:User li-1
ចំណាត់ថ្នាក់ក្រុម:User nl-1	Категория:User nl-1
ចំណាត់ថ្នាក់ក្រុម:User tr-1	Категория:User tr-1
ចំណាត់ថ្នាក់ក្រុម:User fr-4	Категория:User fr-4
ចំណាត់ថ្នាក់ក្រុម:User it-4	Категория:User it-4
ចំណាត់ថ្នាក់ក្រុម:User fr-2	Категория:User fr-2
ចំណាត់ថ្នាក់ក្រុម:User it-2	Категория:User it-2
ចំណាត់ថ្នាក់ក្រុម:User ja-2	Категория:User ja-2
ចំណាត់ថ្នាក់ក្រុម:User la-2	Категория:User la-2
ចំណាត់ថ្នាក់ក្រុម:User tr-2	Категория:User tr-2
ចំណាត់ថ្នាក់ក្រុម:User fr-N	Категория:User fr-N
ចំណាត់ថ្នាក់ក្រុម:User it-N	Категория:User it-N
ចំណាត់ថ្នាក់ក្រុម:User nl-N	Категория:User nl-N
ចំណាត់ថ្នាក់ក្រុម:User ru-N	Категория:User ru-N
ចំណាត់ថ្នាក់ក្រុម:កំសាន្ត	Категория:Развлечения
ទំព័រគំរូ:Location map Asia2	Шаблон:ПозКарта Азия2
ទំព័រគំរូ:User Google	Участник:Box/Google
ចំណាត់ថ្នាក់ក្រុម:Image insertion templates	Категория:Шаблоны:Иконки
ទំព័រគំរូ:IncreaseNegative	Шаблон:Негативный рост
ចំណាត់ថ្នាក់ក្រុម:User af	Категория:User af
ចំណាត់ថ្នាក់ក្រុម:User af-1	Категория:User af-1
ចំណាត់ថ្នាក់ក្រុម:User bar	Категория:User bar
ចំណាត់ថ្នាក់ក្រុម:User bar-1	Категория:User bar-1
ចំណាត់ថ្នាក់ក្រុម:កោះ	Категория:Острова
ចំណាត់ថ្នាក់ក្រុម:User de	Категория:User de
ចំណាត់ថ្នាក់ក្រុម:User de-2	Категория:User de-2
ចំណាត់ថ្នាក់ក្រុម:User de-3	Категория:User de-3
ចំណាត់ថ្នាក់ក្រុម:User de-4	Категория:User de-4
ចំណាត់ថ្នាក់ក្រុម:User de-N	Категория:User de-N
ចំណាត់ថ្នាក់ក្រុម:User el	Категория:User el
ចំណាត់ថ្នាក់ក្រុម:User en-3	Категория:User en-3
ចំណាត់ថ្នាក់ក្រុម:User en-N	Категория:User en-N
ចំណាត់ថ្នាក់ក្រុម:User es	Категория:User es
ចំណាត់ថ្នាក់ក្រុម:User es-1	Категория:User es-1
ចំណាត់ថ្នាក់ក្រុម:User es-2	Категория:User es-2
ចំណាត់ថ្នាក់ក្រុម:User es-4	Категория:User es-4
ចំណាត់ថ្នាក់ក្រុម:User es-N	Категория:User es-N
ចំណាត់ថ្នាក់ក្រុម:User fi	Категория:User fi
ចំណាត់ថ្នាក់ក្រុម:User fi-N	Категория:User fi-N
ចំណាត់ថ្នាក់ក្រុម:User gsw	Категория:User gsw
ទំព័រគំរូ:N/a	Шаблон:N/a
ចំណាត់ថ្នាក់ក្រុម:User id-1	Категория:User id-1
ចំណាត់ថ្នាក់ក្រុម:User id-2	Категория:User id-2
ចំណាត់ថ្នាក់ក្រុម:User id-3	Категория:User id-3
ទំព័រគំរូ:ទិន្នន័យ នៃប្រទេសអាល្លឺម៉ង់	Шаблон:Флагификация/Германия
ទំព័រគំរូ:Multiple image	Шаблон:Кратное изображение
ទំព័រគំរូ:ទិន្នន័យប្រទេស ចក្រភពអង់គ្លេស	Шаблон:Флагификация/Великобритания
ចំណាត់ថ្នាក់ក្រុម:ធរណីមាត្រ	Категория:Геометрия
ទំព័រគំរូ:អង្គការសហប្រជាជាតិ	Шаблон:ООН
ទំព័រគំរូ:ប្រអប់ព័ត៌មាន រោគ-ជំងឺ	Шаблон:Болезнь
ទំព័រគំរូ:User wikipedia/Administrator	Участник:Box/Администратор
ទំព័រគំរូ:Weather box	Шаблон:Климат местности
វិគីភីឌា:អត្ថបទ​ប្រចាំ​ថ្ងៃ	Портал:Избранное содержание
ទំព័រគំរូ:E number infobox 930-949	Шаблон:Пищевые добавки
ចំណាត់ថ្នាក់ក្រុម:User it	Категория:User it
ចំណាត់ថ្នាក់ក្រុម:User it-1	Категория:User it-1
ចំណាត់ថ្នាក់ក្រុម:User ja-1	Категория:User ja-1
ចំណាត់ថ្នាក់ក្រុម:User km-1	Категория:User km-1
ចំណាត់ថ្នាក់ក្រុម:User ko	Категория:User ko
ចំណាត់ថ្នាក់ក្រុម:User ko-1	Категория:User ko-1
ចំណាត់ថ្នាក់ក្រុម:User ko-2	Категория:User ko-2
ចំណាត់ថ្នាក់ក្រុម:User ko-3	Категория:User ko-3
ចំណាត់ថ្នាក់ក្រុម:User ksh	Категория:User ksh
ចំណាត់ថ្នាក់ក្រុម:User ksh-N	Категория:User ksh-N
ចំណាត់ថ្នាក់ក្រុម:User la-1	Категория:User la-1
ចំណាត់ថ្នាក់ក្រុម:User lb	Категория:User lb
ចំណាត់ថ្នាក់ក្រុម:User lb-1	Категория:User lb-1
ទំព័រគំរូ:Multiple issues	Шаблон:Rq
ទំព័រគំរូ:Cite doi	Шаблон:Cite doi
ទំព័រគំរូ:ប្រអប់ព័ត៌មាន រូបិយវត្ថុ	Шаблон:Валюта
ទំព័រគំរូ:Lang-vi	Шаблон:Lang-vi
ទំព័រគំរូ:Distinguish	Шаблон:Не путать
ទំព័រគំរូ:Infobox programming language	Шаблон:Язык программирования
ទំព័រគំរូ:He icon	Шаблон:Ref-he
បញ្ជីរាយនាម ជ័យលាភីរង្វាន់ណូបែល ផ្នែកអក្សរសាស្ត្រ	Список лауреатов Нобелевской премии по литературе
ទំព័រគំរូ:Information	Шаблон:Изображение
ចំណាត់ថ្នាក់ក្រុម:អត្ថបទវិគីភីឌាដែលត្រូវការការបកប្រែ	Категория:Википедия:Запросы на перевод
ចំណាត់ថ្នាក់ក្រុម:User ru-1	Категория:User ru-1
ទំព័រគំរូ:TOC limit	Шаблон:TOClimit
វិគីភីឌា:បាបេល	Википедия:Вавилон
ទំព័រគំរូ:Hilite	Шаблон:Highlight
ទំព័រគំរូ:ភាសាជាផ្លូវការប្រើនៅអសប	Шаблон:Официальные языки ООН
ទំព័រគំរូ:Expand list	Шаблон:List-stub
ទំព័រគំរូ:Country IOC alias GBR	Шаблон:СтранаОИ GBR
ទំព័រគំរូ:Tdeprecated	Шаблон:Устаревший шаблон
ទំព័រគំរូ:Infobox particle	Шаблон:Элементарная частица
ចំណាត់ថ្នាក់ក្រុម:1900s births	Категория:Родившиеся в 1900-е годы
ទំព័រគំរូ:UN Security Council	Шаблон:Совет Безопасности ООН
ទំព័រគំរូ:Sidebar with collapsible lists	Шаблон:Sidebar with collapsible lists
ទំព័រគំរូ:NovemberCalendar	Шаблон:Календарь на ноябрь
ចំណាត់ថ្នាក់ក្រុម:User ms-2	Категория:User ms-2
ចំណាត់ថ្នាក់ក្រុម:សមុទ្រ	Категория:Моря
ទំព័រគំរូ:ISO standards	Шаблон:Стандарты ISO
ទំព័រគំរូ:MayCalendar	Шаблон:Календарь на май
ទំព័រគំរូ:Chess diagram 8x10	Шаблон:Шахматная диаграмма 8x10
ទំព័រគំរូ:Lang-ko	Шаблон:Lang-ko
ទំព័រគំរូ:Lang-it	Шаблон:Lang-it
ចំណាត់ថ្នាក់ក្រុម:User nds	Категория:User nds
ទំព័រគំរូ:Sect1911	Шаблон:1911
ចំណាត់ថ្នាក់ក្រុម:User nds-1	Категория:User nds-1
ទំព័រគំរូ:Coord/dms2dec	Шаблон:Coord/dms2dec
ទំព័រគំរូ:ទិន្នន័យ នៃប្រទេសប្រេស៊ីល	Шаблон:Флагификация/Бразилия
វិគីភីឌា:WikiProject Computing	Проект:Информационные технологии/Текущие задачи
ចំណាត់ថ្នាក់ក្រុម:អង្គការអន្តរជាតិ	Категория:Международные организации
ទំព័រគំរូ:មេកានិចកង់ទិច	Шаблон:Квантовая механика
ទំព័រគំរូ:Db-meta	Шаблон:Db-meta
ទំព័រគំរូ:Db-g1	Шаблон:Db-nonsense
ទំព័រគំរូ:Sfn	Шаблон:Sfn
ចំណាត់ថ្នាក់ក្រុម:សមីការឌីផេរ៉ង់ស្យែល	Категория:Дифференциальные уравнения
ចំណាត់ថ្នាក់ក្រុម:ខេត្តក្រុងខ្មែរ	Категория:Провинции Камбоджи
ទំព័រគំរូ:Lang-lo	Шаблон:Lang-lo
ចំណាត់ថ្នាក់ក្រុម:User zh-min-nan	Категория:User nan
ទំព័រគំរូ:Release date and age	Шаблон:Start date and age
ទំព័រគំរូ:Omega Chess diagram	Шаблон:Омега-шахматы диаграмма
ចំណាត់ថ្នាក់ក្រុម:ឧទ្ធម្ភាគចក្រ	Категория:Вертолёты
ចំណាត់ថ្នាក់ក្រុម:នាយករដ្ឋមន្ត្រី	Категория:Премьер-министры
ចំណាត់ថ្នាក់ក្រុម:វិទ្យាសាស្ត្រសង្គម	Категория:Общественные науки
ឈាន	Дхьяна
ទំព័រគំរូ:ទិន្នន័យ នៃប្រទេសហុងគ្រី	Шаблон:Флагификация/Венгрия
ទំព័រគំរូ:User zh-0	Шаблон:User zh-0
ទំព័រគំរូ:JanuaryCalendar	Шаблон:Календарь на январь
ទំព័រគំរូ:Template reference list	Шаблон:Ссылки в шаблоне
ចំណាត់ថ្នាក់ក្រុម:ឆ្នាំកំណើត ១៩៥១	Категория:Родившиеся в 1951 году
ទំព័រគំរូ:Mdash	Шаблон:—
ទំព័រគំរូ:Zh icon	Шаблон:Ref-zh
ទំព័រគំរូ:Advert	Шаблон:Реклама
ទំព័រគំរូ:Infobox government agency	Шаблон:Орган исполнительной власти
ទំព័រគំរូ:Babel-N	Шаблон:Babel-N
វិគីភីឌា:Tools	Википедия:Инструменты
ទំព័រគំរូ:User ru-2	Шаблон:User ru-2
ចំណាត់ថ្នាក់ក្រុម:User ru	Категория:User ru
ចំណាត់ថ្នាក់ក្រុម:User ru-2	Категория:User ru-2
ចំណាត់ថ្នាក់ក្រុម:User ru-3	Категория:User ru-3
ចំណាត់ថ្នាក់ក្រុម:វត្តអារាមព្រះពុទ្ធសាសនា	Категория:Буддийские храмы и монастыри
ទំព័រគំរូ:Apollo program	Шаблон:Запуски по программе «Аполлон»
ចំណាត់ថ្នាក់ក្រុម:User th-N	Категория:User th-N
ចំណាត់ថ្នាក់ក្រុម:User tr	Категория:User tr
ចំណាត់ថ្នាក់ក្រុម:User tr-4	Категория:User tr-4
ចំណាត់ថ្នាក់ក្រុម:User tr-5	Категория:User tr-5
ចំណាត់ថ្នាក់ក្រុម:User tr-N	Категория:User tr-N
បញ្ជីរាយនាម នាយករដ្ឋមន្ត្រីកម្ពុជា	Список премьер-министров Камбоджи
ទំព័រគំរូ:En icon	Шаблон:Ref-en
ទំព័រគំរូ:Nay	Шаблон:N
ទំព័រគំរូ:Spaces	Шаблон:Nbsp
ទំព័រគំរូ:ប្រអប់ភាសា	Шаблон:Lang
ទំព័រគំរូ:FishBase species alt	Шаблон:FishBase
ទំព័រគំរូ:Country flag IOC alias GBR	Шаблон:СтранаОИ флаг GBR
ទំព័រគំរូ:Country IOC alias USA	Шаблон:СтранаОИ USA
ទំព័រគំរូ:ទិន្នន័យប្រទេស Russian SFSR	Шаблон:Флагификация/РСФСР
ទំព័រគំរូ:In-universe	Шаблон:Реальный мир
ទំព័រគំរូ:Infobox Olympics Cambodia	Шаблон:Камбоджа на Олимпийских играх
ទំព័រគំរូ:ទិន្នន័យប្រទេស តួកម៉េនីស្ថាន	Шаблон:Флагификация/Туркмения
ទំព័រគំរូ:Str index	Шаблон:Str index
ទំព័រគំរូ:Self	Шаблон:Self
ទំព័រគំរូ:Alabama	Шаблон:Алабама
ទំព័រគំរូ:Angkorian sites	Шаблон:Памятники Кхмерской империи
ទំព័រគំរូ:កាលពី	Шаблон:На
ទំព័រគំរូ:ប្រធានបទអាស៊ី	Шаблон:Азия по темам
ទំព័រគំរូ:Copyright by Wikimedia	Шаблон:CopyrightByWikimedia
ទំព័រគំរូ:Audio editors	Шаблон:Аудиоредакторы
ទំព័រគំរូ:AugustCalendar	Шаблон:Календарь на август
ចំណាត់ថ្នាក់ក្រុម:ធរណីមាត្រត្រីកោណ	Категория:Геометрия треугольника
ទំព័រគំរូ:BDYearsInDecade	Шаблон:DeathYearsInDecade
ទំព័រគំរូ:BLP	Шаблон:Blp
ទំព័រគំរូ:Bar percent	Шаблон:Bar percent
ទំព័រគំរូ:Str find	Шаблон:Str find
ទំព័រគំរូ:ប្រធានបទ ព្រះពុទ្ធសាសនា	Шаблон:Буддизм в темах
ទំព័រគំរូ:Fr icon	Шаблон:Ref-fr
ទំព័រគំរូ:Twitter	Шаблон:Твиттер
ទំព័រគំរូ:Ko icon	Шаблон:Ref-ko
ទំព័រគំរូ:Lang-hi	Шаблон:Lang-hi
ទំព័រគំរូ:Country flag IOC alias ZZX	Шаблон:СтранаОИ флаг ZZX
ទំព័រគំរូ:EST	Шаблон:EST
ទំព័រគំរូ:ទិន្នន័យ​នៃប្រទេសរុស្ស៊ី	Шаблон:RUS
ទំព័រគំរូ:Five Oceans	Шаблон:Океаны
ទំព័រគំរូ:ICD9	Шаблон:ICD9
ទំព័រគំរូ:ប្រវត្តិសាស្ត្របារាំង	Шаблон:История Франции
ទំព័រគំរូ:MONTH	Шаблон:MONTH
ទំព័រគំរូ:CHL	Шаблон:CHL
ទំព័រគំរូ:Campaign	Шаблон:Конфликт
ទំព័រគំរូ:Category disambiguation	Шаблон:Категория-неоднозначность
ទំព័រគំរូ:Cc-by-sa-3.0,2.5,2.0,1.0	Шаблон:CC-BY-SA-3.0,2.5,2.0,1.0
ទំព័រគំរូ:ទិន្នន័យ​នៃប្រទេសស៊ីរី	Шаблон:SYR
ទំព័រគំរូ:OctoberCalendar	Шаблон:Календарь на октябрь
ទំព័រគំរូ:China-bio-stub	Шаблон:China-bio-stub
ទំព័រគំរូ:Side box	Шаблон:Side box
ទំព័រគំរូ:ENG	Шаблон:ENG
ទំព័រគំរូ:Citation	Шаблон:Citation
ទំព័រគំរូ:Citation/core	Шаблон:Citation/core
ចំណាត់ថ្នាក់ក្រុម:ប្រទេសជាកោះ	Категория:Островные государства
ទំព័រគំរូ:Grey	Шаблон:Gray
ទំព័រគំរូ:User la-2	Шаблон:User la-2
ទំព័រគំរូ:User ru-1	Шаблон:User ru-1
ចំណាត់ថ្នាក់ក្រុម:អាំងតេក្រាល	Категория:Интегралы
ទំព័រគំរូ:User tr-1	Шаблон:User tr-1
ទំព័រគំរូ:User zh-1	Шаблон:User zh-1
ទំព័រគំរូ:User zh-2	Шаблон:User zh-2
ទំព័រគំរូ:User zh-3	Шаблон:User zh-3
ចំណាត់ថ្នាក់ក្រុម:រូបវិទូ	Категория:Физики по странам
ទំព័រគំរូ:User zh-4	Шаблон:User zh-4
ចំណាត់ថ្នាក់ក្រុម:គមនាគមន៍នៅប្រទេសជប៉ុន	Категория:Транспорт в Японии
ចំណាត់ថ្នាក់ក្រុម:ប្រទេសហ្សំប៊ី	Категория:Замбия
ទំព័រគំរូ:ទិន្នន័យប្រទេស យូហ៊្គោស្លាវី	Шаблон:Флагификация/Югославия
ទំព័រគំរូ:Multi-listen end	Шаблон:Multi-listen end
ចំណាត់ថ្នាក់ក្រុម:ការអប់រំនៅប្រទេសជប៉ុន	Категория:Образование в Японии
ចំណាត់ថ្នាក់ក្រុម:User ja-0	Категория:User ja-0
ចំណាត់ថ្នាក់ក្រុម:User nl	Категория:User nl
ទំព័រគំរូ:Unbulleted list	Шаблон:Немаркированный список
ចំណាត់ថ្នាក់ក្រុម:User zh-1	Категория:User zh-1
ចំណាត់ថ្នាក់ក្រុម:User zh-4	Категория:User zh-4
ចំណាត់ថ្នាក់ក្រុម:User zh-3	Категория:User zh-3
ចំណាត់ថ្នាក់ក្រុម:User zh-2	Категория:User zh-2
ចំណាត់ថ្នាក់ក្រុម:មេកានិច	Категория:Механика
ចំណាត់ថ្នាក់ក្រុម:រូបវិទូអាល្លឺម៉ង់	Категория:Физики Германии
ចំណាត់ថ្នាក់ក្រុម:រូបវិទូអ៊ីតាលី	Категория:Физики Италии
ចំណាត់ថ្នាក់ក្រុម:រូបវិទូបារាំង	Категория:Физики Франции
ចំណាត់ថ្នាក់ក្រុម:ព្រឹត្តិការណ៍កីឡាចំរុះ	Категория:Мультиспортивные соревнования
ចំណាត់ថ្នាក់ក្រុម:គណិតវិទូអាល្លឺម៉ង់	Категория:Математики Германии
ទំព័រគំរូ:User wikipedia/autopatrolled	Участник:Box/Автопатрулируемый
ទំព័រគំរូ:ទិន្នន័យប្រទេស វៀតណាមខាងជើង	Шаблон:Флагификация/Северный Вьетнам
ចំណាត់ថ្នាក់ក្រុម:ចំនួនគត់រឺឡាទីប	Категория:Целые числа
ចំណាត់ថ្នាក់ក្រុម:ស៊ីហ្គេម	Категория:Игры Юго-Восточной Азии
ចំណាត់ថ្នាក់ក្រុម:ត្រីកោណមាត្រ	Категория:Тригонометрия
ចំណាត់ថ្នាក់ក្រុម:ទ្រឹស្តីបទ	Категория:Теоремы
ចំណាត់ថ្នាក់ក្រុម:ទ្រឹស្តីបទគណិតវិទ្យា	Категория:Математические теоремы
ចំណាត់ថ្នាក់ក្រុម:អាកាសយានដ្ឋាន	Категория:Аэропорты
ចំណាត់ថ្នាក់ក្រុម:រូបវិទូអាមេរិក	Категория:Физики США
ចំណាត់ថ្នាក់ក្រុម:នាយករដ្ឋមន្ត្រីសិង្ហបុរី	Категория:Премьер-министры Сингапура
ចំណាត់ថ្នាក់ក្រុម:រង្វាន់ណូបែល	Категория:Нобелевские премии
ចំណាត់ថ្នាក់ក្រុម:ប្រទេសកម្ពុជា	Категория:Камбоджа
ចំណាត់ថ្នាក់ក្រុម:អ្នកនយោបាយប៉ាគីស្ថាន	Категория:Политики Пакистана
ទំព័រគំរូ:Lang-hy	Шаблон:Lang-hy
ទំព័រគំរូ:Retrieved	Шаблон:Проверено
ចំណាត់ថ្នាក់ក្រុម:អ្នកនយោបាយខ្មែរ	Категория:Политики Камбоджи
ចំណាត់ថ្នាក់ក្រុម:អ្នករុករកជនជាតិបារាំង	Категория:Путешественники Франции
ចំណាត់ថ្នាក់ក្រុម:ស្រីលង្កា	Категория:Шри-Ланка
ចំណាត់ថ្នាក់ក្រុម:ទំព័រគំរូ រង្វាន់ណូបែល	Категория:Шаблоны:Лауреаты Нобелевских премий
ចំណាត់ថ្នាក់ក្រុម:ទំព័រគំរូឈ្មោះភាសា	Категория:Шаблоны языков
ចំណាត់ថ្នាក់ក្រុម:ទំព័រគំរូក្នុងរូបវិទ្យា	Категория:Шаблоны:Физика
ទំព័រគំរូ:ទិន្នន័យប្រទេស Wales	Шаблон:Флагификация/Уэльс
ចំណាត់ថ្នាក់ក្រុម:ពហុធា	Категория:Многочлены
ចំណាត់ថ្នាក់ក្រុម:អនុគមន៍	Категория:Функции
ចំណាត់ថ្នាក់ក្រុម:ភាសាជប៉ុន	Категория:Японский язык
ចំណាត់ថ្នាក់ក្រុម:មធ្យម	Категория:Средние величины
ចំណាត់ថ្នាក់ក្រុម:សំភារៈ​សំណង់	Категория:Строительные материалы
ទំព័រគំរូ:S-off	Шаблон:S-off
ចំណាត់ថ្នាក់ក្រុម:សមីការ	Категория:Уравнения
ពន្ធលើប្រាក់បៀវត្ស	Налог на заработную плату
ចំណាត់ថ្នាក់ក្រុម:ស្ពាននៅប្រទេសជប៉ុន	Категория:Мосты Японии
ទំព័រគំរូ:Db doc	Шаблон:Db-catempty
ចំណាត់ថ្នាក់ក្រុម:វិភាគគណិតវិទ្យា	Категория:Математический анализ
ទំព័រគំរូ:Contents pages (header bar)	Википедия:Содержание Википедии/Навигация
ចំណាត់ថ្នាក់ក្រុម:វិសមភាព	Категория:Неравенства
ចំណាត់ថ្នាក់ក្រុម:ឧទ្យានជាតិ	Категория:Национальные парки
ចំណាត់ថ្នាក់ក្រុម:កោះស៊ូម៉ាត្រា	Категория:Суматра
ចំណាត់ថ្នាក់ក្រុម:មីក្រូសេដ្ឋកិច្ច	Категория:Микроэкономика
ចំណាត់ថ្នាក់ក្រុម:HTML	Категория:HTML
ចំណាត់ថ្នាក់ក្រុម:អាស៊ីហ្គេម	Категория:Азиатские игры
ចំណាត់ថ្នាក់ក្រុម:អេឡិចត្រូស្តាទិច	Категория:Электростатика
ចំណាត់ថ្នាក់ក្រុម:អាកាសចរណ៍	Категория:Транспорт
ចំណាត់ថ្នាក់ក្រុម:គណិតវិទ្យាថ្នាក់ដំបូង	Категория:Элементарная математика
ចំណាត់ថ្នាក់ក្រុម:ទ្រឹស្តីបទលេខ	Категория:Теория чисел
ទំព័រគំរូ:ប្រអប់ព័ត៌មាន ភាសា	Шаблон:Язык
ទំព័រគំរូ:អត្ថបទខ្លី អំពីកូរ៉េខាងត្បូង	Шаблон:Korea-S-stub
ទំព័រគំរូ:Statistics	Шаблон:Статистика
ចំណាត់ថ្នាក់ក្រុម:ភាសាអ៊ីតាលី	Категория:Итальянский язык
ចំណាត់ថ្នាក់ក្រុម:ភាសាអេស្ប៉ាញ	Категория:Испанский язык
ចំណាត់ថ្នាក់ក្រុម:រថក្រោះ	Категория:Танки
ទំព័រគំរូ:គោលការណ៍មូលដ្ឋានរបស់វិគីភីឌា	Шаблон:Правила Википедии
ទំព័រគំរូ:Lists by country	Шаблон:Списки стран
ទំព័រគំរូ:Infobox polygon	Шаблон:Многоугольник
ចំណាត់ថ្នាក់ក្រុម:កោះរបស់ឥណ្ឌូនេស៊ី	Категория:Острова Индонезии
ទំព័រគំរូ:WPBannerMeta	Шаблон:Статья проекта
ខេត្តលង់ហោរ	Виньлонг (провинция)
ចំណាត់ថ្នាក់ក្រុម:ភ្នំពេញ	Категория:Пномпень
ចំណាត់ថ្នាក់ក្រុម:ទំព័រគំរូសំរាប់ទង់ជាតិ	Категория:Шаблоны:Флаги государств
ចំណាត់ថ្នាក់ក្រុម:ឧទ្យានជាតិនៃព្រះរាជាណាចក្រកម្ពុជា	Категория:Национальные парки Камбоджи
ទំព័រគំរូ:Split	Шаблон:К разделению
ចំណាត់ថ្នាក់ក្រុម:ធរណីមាត្រអ៊ីពែបូលីក	Категория:Геометрия Лобачевского
វិគីភីឌា:ឯកសារកម្មទំព័រគំរូ	Википедия:Документация шаблонов
ទំព័រគំរូ:CompactTOC8	Шаблон:CompactTOC8
ទំព័រគំរូ:Template sandbox notice	Шаблон:Песочница шаблона
ទំព័រគំរូ:Image frame	Шаблон:Image frame
ទំព័រគំរូ:Latin Union	Шаблон:Латинский Союз
ចំណាត់ថ្នាក់ក្រុម:ម៉ាញ៉េតូស្តាទិច	Категория:Магнитостатика
ចំណាត់ថ្នាក់ក្រុម:ក្រលាផ្ទៃ	Категория:Площадь
ទំព័រគំរូ:Infobox broadcasting network	Шаблон:Вещательная сеть
ចំណាត់ថ្នាក់ក្រុម:លោការីត	Категория:Логарифмы
Portal:Current events/Headlines	Портал:Текущие события/Заголовки
ទំព័រគំរូ:CURRENTMINUTE	Шаблон:CURRENTMINUTE
ទំព័រគំរូ:ទិន្នន័យ​នៃប្រទេសអ៊ូបេគីស្ថាន	Шаблон:UZB
ទំព័រគំរូ:Question	Шаблон:Вопрос
បញ្ជីរាយនាម ជ័យលាភីរង្វាន់ណូបែល ផ្នែកគីមីវិទ្យា	Список лауреатов Нобелевской премии по химии
ទំព័រគំរូ:ទិន្នន័យ នៃប្រទេសអេស្ប៉ាញ	Шаблон:Флагификация/Испания
ទំព័រគំរូ:Pad	Шаблон:Отбивка
ទំព័រគំរូ:ទិន្នន័យប្រទេស កាណាដា	Шаблон:Флагификация/Канада
ទំព័រគំរូ:Column-rule	Шаблон:Column-rule
ទំព័រគំរូ:Conservation status	Шаблон:Охранный статус
ទំព័រគំរូ:Convert/numdisp/frac	Шаблон:Convert/numdisp/frac
ទំព័រគំរូ:Convert/numdisp/frac1	Шаблон:Convert/numdisp/frac1
ទំព័រគំរូ:Cookbook	Шаблон:Кулинарная книга
ទំព័រគំរូ:Council of Europe	Шаблон:Совет Европы
ទំព័រគំរូ:Country IOC alias CAM	Шаблон:СтранаОИ CAM
ទំព័រគំរូ:Intellectual property	Шаблон:Интеллектуальная собственность
ទំព័រគំរូ:ទិន្នន័យប្រទេស ម៉ាល់ឌីវ	Шаблон:Флагификация/Мальдивы
ទំព័រគំរូ:ទិន្នន័យ នៃប្រទេសសិង្ហបុរី	Шаблон:Флагификация/Сингапур
ទំព័រគំរូ:ទិន្នន័យប្រទេស យេម៉ែន	Шаблон:Флагификация/Йемен
ទំព័រគំរូ:Lang-pl	Шаблон:Lang-pl
ទំព័រគំរូ:Country flag IOC alias USA	Шаблон:СтранаОИ флаг USA
ទំព័រគំរូ:DANFS	Шаблон:DANFS
ទំព័រគំរូ:Str right	Шаблон:Str right
ទំព័រគំរូ:Diff	Шаблон:Diff
ទំព័រគំរូ:ប្រវត្តិសាស្ត្រវៀតណាម	Шаблон:История Вьетнама
ចំណាត់ថ្នាក់ក្រុម:ភាសាអង់គ្លេស	Категория:Английский язык
ទំព័រគំរូ:FOSS	Шаблон:FOSS
ទំព័រគំរូ:G8	Шаблон:G8
ទំព័រគំរូ:Monarchies	Шаблон:Монархии
ទំព័រគំរូ:WikiProject Biography	Шаблон:Уровень статьи
ទំព័រគំរូ:សំលៀកបំពាក់	Шаблон:Головные уборы
ទំព័រគំរូ:Countries and regions of the Caucasus	Шаблон:Кавказ
ទំព័រគំរូ:Nature nav	Шаблон:Разделы геологии
ទំព័រគំរូ:Time Persons of the Year 2001–2025	Шаблон:Человек года (по версии журнала Тайм) 2001—2025
ទំព័រគំរូ:Natural sciences-footer	Шаблон:Естествознание
ទំព័រគំរូ:Infobox country Olympics	Шаблон:Страна на Олимпийских играх
ទំព័រគំរូ:ប្រអប់យុទ្ធនាការ សង្គ្រាមវៀតណាម	Шаблон:Вьетнамская война
ទំព័រគំរូ:ជ័យលាភីរង្វាន់ណូបែល ផ្នែកគីមីវិទ្យា ឆ្នាំ ១៩០១-១៩២៥	Шаблон:Нобелевская премия по химии 1901—1925
ទំព័រគំរូ:User vi-2	Шаблон:User vi-2
ទំព័រគំរូ:User vi-1	Шаблон:User vi-1
ទំព័រគំរូ:User id-2	Шаблон:User id-2
ទំព័រគំរូ:PDB	Шаблон:PDB
ទំព័រគំរូ:OMIM2	Шаблон:OMIM2
ទំព័រគំរូ:Nav book tool	Шаблон:Книги
ទំព័រគំរូ:Lang-th	Шаблон:Lang-th
ទំព័រគំរូ:Lang-sq	Шаблон:Lang-sq
ទំព័រគំរូ:Lang-pi	Шаблон:Lang-pi
ទំព័រគំរូ:Lang-pa	Шаблон:Lang-pa
ទំព័រគំរូ:Lang-es	Шаблон:Lang-es
ទំព័រគំរូ:Lang-ca	Шаблон:Lang-ca
ទំព័រគំរូ:Lang-bo	Шаблон:Lang-bo
ទំព័រគំរូ:Lang-az	Шаблон:Lang-az
ទំព័រគំរូ:Km icon	Шаблон:Ref-km
ទំព័រគំរូ:AprilCalendar	Шаблон:Календарь на апрель
ទំព័រគំរូ:JuneCalendar	Шаблон:Календарь на июнь
ទំព័រគំរូ:MarchCalendar	Шаблон:Календарь на март
ទំព័រគំរូ:ISO 3166	Шаблон:ISO 3166
ទំព័រគំរូ:DiseasesDB2	Шаблон:DiseasesDB2
ទំព័រគំរូ:Country flag IOC alias CAM	Шаблон:СтранаОИ флаг CAM
ចំណាត់ថ្នាក់ក្រុម:នាមត្រូលជនជាតិជប៉ុន	Категория:Японские фамилии
ចំណាត់ថ្នាក់ក្រុម:ក្រុមហ៊ុនអាកាសចរណ៍	Категория:Пассажирские самолёты
ចំណាត់ថ្នាក់ក្រុម:ពិជគណិត	Категория:Алгебра
ចំណាត់ថ្នាក់ក្រុម:មុំ	Категория:Углы
ចំណាត់ថ្នាក់ក្រុម:នព្វន្ធ	Категория:Арифметика
ចំណាត់ថ្នាក់ក្រុម:User ko-0	Категория:User ko-0
ចំណាត់ថ្នាក់ក្រុម:ព្រះពុទ្ធសាសនានៅប្រទេសបារាំង	Категория:Буддизм во Франции
ចំណាត់ថ្នាក់ក្រុម:អត្ថបទខ្លីមិនពេញលេញ អំពីព្រះពុទ្ធសាសនា	Категория:Незавершённые статьи о буддизме
ទំព័រគំរូ:Multicol	Шаблон:Multicol
សិទ្ធិកុមារ	Права ребёнка
ចំណាត់ថ្នាក់ក្រុម:អាស៊ីខាងកើត	Категория:Восточная Азия
ទំព័រគំរូ:Chess diagram 6x6	Шаблон:Шахматная диаграмма 6x6
ចំណាត់ថ្នាក់ក្រុម:អេឡិចត្រូម៉ាញ៉េទិច	Категория:Электромагнетизм
ទំព័រគំរូ:Lang-mn	Шаблон:Lang-mn
ទំព័រគំរូ:Lang-sa	Шаблон:Lang-sa
ទំព័រគំរូ:Lang-sv	Шаблон:Lang-sv
វិគីភីឌា:វិគីគម្រោងប្រវត្តិសាស្ត្រ	Проект:История
វិគីភីឌា:WikiProject Education	Проект:Образование
ចំណាត់ថ្នាក់ក្រុម:រាជរដ្ឋាភិបាលកម្ពុជា	Категория:Государственное устройство Камбоджи
ទំព័រគំរូ:Precision/tz	Шаблон:Precision/tz
ទំព័រគំរូ:Precision/tz/1	Шаблон:Precision/tz/1
ចំណាត់ថ្នាក់ក្រុម:បណ្ណាល័យ	Категория:Библиотеки
ចំណាត់ថ្នាក់ក្រុម:មេរថក្រោះសមរភូមិ	Категория:Основные боевые танки
ជំនួយ:Books/for experts	Википедия:Книги/Для экспертов
វិគីភីឌា:Link color	Википедия:Цвета ссылок
ចំណាត់ថ្នាក់ក្រុម:យន្តហោះយោធាគ្រូបណ្តុះបណ្តាល	Категория:Учебные самолёты
ទំព័រគំរូ:ទិន្នន័យ​នៃប្រទេសម៉ុងហ្គោល	Шаблон:MNG
ចំណាត់ថ្នាក់ក្រុម:ទំព័រគំរូTOC	Категория:Шаблоны:TOC
ទំព័រគំរូ:Image label begin	Шаблон:Image label begin
ទំព័រគំរូ:Bg icon	Шаблон:Ref-bg
វិគីភីឌា:Requests	Википедия:Запросы
ចំណាត់ថ្នាក់ក្រុម:កងកម្លាំងអាកាស	Категория:Военно-воздушные силы
ចំណាត់ថ្នាក់ក្រុម:សាកលវិទ្យាល័យនៅប្រទេសជប៉ុន	Категория:Университеты Японии
ចំណាត់ថ្នាក់ក្រុម:User es-0	Категория:User es-0
ទំព័រគំរូ:BirthsInCentury	Шаблон:BirthsInCentury
ចំណាត់ថ្នាក់ក្រុម:វប្បធម៌ខ្មែរ	Категория:Культура Камбоджи
ទំព័រគំរូ:Geodis	Шаблон:Одноимённые населённые пункты
ចំណាត់ថ្នាក់ក្រុម:User en-1	Категория:User en-1
ចំណាត់ថ្នាក់ក្រុម:User de-1	Категория:User de-1
ទំព័រគំរូ:Nowrap begin	Шаблон:Nowrap begin
ទំព័រគំរូ:ខ្លីមិនពេញលេញ ព្រះពុទ្ធសាសនា	Шаблон:Buddhism-stub
ទំព័រគំរូ:Split section	Шаблон:Отделить
ទំព័រគំរូ:Chaturanga diagram	Шаблон:Диаграмма чатуранги
ទំព័រគំរូ:សេរីភាព	Шаблон:Свободы
ទំព័រគំរូ:Not English	Шаблон:Закончить перевод
ទំព័រគំរូ:រដ្ឋ និងទឹកដីក្នុងមណ្ឌលឥទ្ធិពលជប៉ុនចក្រពត្តិកំឡុងសង្គ្រាមលោកលើកទី២	Шаблон:Великая восточноазиатская сфера взаимного процветания
ទំព័រគំរូ:December calendar	Шаблон:Календарь на декабрь
ទំព័រគំរូ:JulyCalendar	Шаблон:Календарь на июль
ទំព័រគំរូ:Philippine Presidents	Шаблон:Президенты Филиппин
ទំព័រគំរូ:សង្គ្រាមត្រជាក់	Шаблон:Холодная война
ទំព័រគំរូ:Infobox laboratory	Шаблон:Карточка лаборатории
ទំព័រគំរូ:ព្រះត្រៃបិដក	Шаблон:ПалийскийКанон
វិគីភីឌា:WikiProject Council/Guide	Википедия:Совет вики-проектов/Руководство
វិគីភីឌា:WikiProject Council/Directory	Википедия:Совет вики-проектов/Каталог проектов
ទំព័រគំរូ:Organisation of Islamic Cooperation	Шаблон:ОИК
ចំណាត់ថ្នាក់ក្រុម:កោះជ្វា	Категория:Ява
ទំព័រគំរូ:Frac	Шаблон:Дробь
ទំព័រគំរូ:Start date	Шаблон:Start date
ទំព័រគំរូ:MediaWiki	Шаблон:MediaWiki
ទំព័រគំរូ:Law	Шаблон:Право
ចំណាត់ថ្នាក់ក្រុម:ការធ្វើសេចក្ដីរាយការណ៏ពត៌មាន	Доклад
ទំព័រគំរូ:Religious text primary	Шаблон:Религиозные источники
ទំព័រគំរូ:Unknown	Шаблон:Неизвестно
ទំព័រគំរូ:កម្ពុជា	Шаблон:Камбоджа в темах
ទំព័រគំរូ:Free	Шаблон:Бесплатно
ទំព័រគំរូ:Bio-stub	Шаблон:Bio-stub
ទំព័រគំរូ:Db-t3	Шаблон:Db-duptemplate
ទំព័រគំរូ:Db-g2	Шаблон:Db-test
ទំព័រគំរូ:Vatican City topics	Шаблон:Ватикан в темах
ទំព័រគំរូ:Isfdb name	Шаблон:Isfdb name
ទំព័រគំរូ:ប្រវត្តិសាស្ត្រភូមា	Шаблон:История Мьянмы
ទំព័រគំរូ:Herbs & spices	Шаблон:Пряности
ទំព័រគំរូ:Andorra topics	Шаблон:Андорра в темах
ទំព័រគំរូ:Football kit box	Шаблон:Football kit box
ទំព័រគំរូ:Elementbox isotopes decay	Шаблон:Строка изотопа
ទំព័រគំរូ:ISOYEAR	Шаблон:ISOYEAR
ទំព័រគំរូ:La Francophonie	Шаблон:Франкофония
ទំព័រគំរូ:Buddhism-Horizontal	Шаблон:Буддизм-навигация
វិគីភីឌា:សារ ទំព័រគំរូ/Disputes	Википедия:Шаблоны/Предупреждения
ទំព័រគំរូ:ចក្រភពនាយសមុទ្ររបស់បារាំង	Шаблон:Заморская экспансия Франции
វិគីភីឌា:Service awards	Википедия:Награды за работу
ទំព័រគំរូ:Gov-stub	Шаблон:State-stub
ទំព័រគំរូ:Infobox file format	Шаблон:Файловый формат
ទំព័រគំរូ:Elect	Шаблон:Выборы
ទំព័រគំរូ:អត្ថបទខ្លី អំពីកម្ពុជា	Шаблон:Cambodia-stub
ទំព័រគំរូ:Multi-column numbered list	Шаблон:Multi-column numbered list
វិគីភីឌា:Version 1.0 Editorial Team	Проект:Издание Википедии
ទំព័រគំរូ:Country IOC alias ZZX	Шаблон:СтранаОИ ZZX
វិគីភីឌា:WikiProject Buddhism	Проект:Буддизм
ទំព័រគំរូ:Articles of the Universal Declaration of Human Rights	Шаблон:Статьи Всеобщей декларации прав человека
ទំព័រគំរូ:User id-1	Шаблон:User id-1
ទំព័រគំរូ:Wikipedia 1.0 Navigation	Шаблон:Википедия 1.0 Навигация
ទំព័រគំរូ:Infobox Buddhist term	Шаблон:Buddhist term
ទំព័រគំរូ:S-inc	Шаблон:S-inc
ទំព័រគំរូ:Polynomials	Шаблон:Алгебраические уравнения
ទំព័រគំរូ:ប្រធានបទវៀតណាម	Шаблон:Вьетнам в темах
ទំព័រគំរូ:UN document	Шаблон:Документ ООН
វិគីភីឌា:WikiProject Council	Википедия:Совет вики-проектов
ទំព័រគំរូ:ForLoop/aux	Шаблон:For/aux
ទំព័រគំរូ:Payoff matrix	Шаблон:Платёжная матрица
ទំព័រគំរូ:S-hou	Шаблон:S-hou
ទំព័រគំរូ:The Sun	Шаблон:Солнце
ទំព័រគំរូ:Mammals	Шаблон:Современные отряды млекопитающих
ទំព័រគំរូ:Dynamic list	Шаблон:Неполный список
វិគីភីឌា:Manual of Style (ប្រអប់ព័ត៌មាន)	Википедия:Шаблоны/Карточки
ទំព័រគំរូ:Lead missing	Шаблон:Нет вступления
ទំព័រគំរូ:Infobox Chinese	Шаблон:Chinese
ទំព័រគំរូ:Infobox Monarchy	Шаблон:Монарх (титул)
ទំព័រគំរូ:Efn	Шаблон:Efn
ទំព័រគំរូ:S-ppo	Шаблон:S-ppo
ទំព័រគំរូ:Time	Шаблон:Time
ចំណាត់ថ្នាក់ក្រុម:យន្តហោះប្រដេញ	Категория:Истребители
ទំព័រគំរូ:Harvard citation/core	Шаблон:Harvard citation/core
ទំព័រគំរូ:Lists of flags	Шаблон:Списки флагов
ទំព័រគំរូ:Issubst	Шаблон:Issubst
ទំព័រគំរូ:Hidden sort key	Шаблон:Hs
ទំព័រគំរូ:តំណភ្ជាប់ខាងក្រៅ	Шаблон:Лишние ссылки
ទំព័រគំរូ:Infobox high court	Шаблон:Орган судебной власти
ទំព័រគំរូ:សិទ្ធិ	Шаблон:Права
ទំព័រគំរូ:Cite comic	Шаблон:Cite comic
វិគីភីឌា:Userboxes/WikiProjects	Википедия:Шаблоны/Участники/Проекты
ទំព័រគំរូ:សិទ្ធិមនុស្ស	Шаблон:Права человека
ទំព័រគំរូ:Style/IPA	Шаблон:Style/IPA
ទំព័រគំរូ:Style/yid	Шаблон:Style/yid
Module:Convert	Модуль:Convert
ទំព័រគំរូ:Green Party of England and Wales/meta/shortname	Шаблон:Зелёная партия Англии и Уэльса/короткое название
ទំព័រគំរូ:Infobox comics location	Шаблон:Карточка локации комикса
ទំព័រគំរូ:UK Independence Party/meta/shortname	Шаблон:Партия независимости Соединённого Королевства/короткое название
ទំព័រគំរូ:Project header	Шаблон:Проект-начало
វិគីភីឌា:សារ ទំព័រគំរូ/General	Википедия:Шаблоны/Общего назначения
វិគីភីឌា:សារ ទំព័រគំរូ/តំណភ្ជាប់	Википедия:Шаблоны/Ссылки
វិគីភីឌា:សារ ទំព័រគំរូ/Deletion	Википедия:Шаблоны/Удаление содержимого
ទំព័រគំរូ:Inuse-section	Шаблон:Редактирую раздел
ទំព័រគំរូ:ទិន្នន័យប្រទេស អូម៉ង់	Шаблон:Флагификация/Оман
ទំព័រគំរូ:ទិន្នន័យប្រទេស កាមេរូន	Шаблон:Флагификация/Камерун
អាកាសចរណ៍ឡាវ ជើងហោះហើរ លេខ៣០១	Катастрофа ATR 72 под Паксе
ព្យុះហៃយ៉ាន	Хайян (тайфун)
ពិសេស:បំលាស់ប្ដូរថ្មីៗ	Служебная:Свежие правки
Module:HtmlBuilder	Модуль:HtmlBuilder
Module:Coordinates	Модуль:Coordinates
Module:Navbox	Модуль:Navbox
វិគីភីឌា:សារ ទំព័រគំរូ/លំហឈ្មោះ ឯកសារ	Википедия:Шаблоны/Лицензии файлов
Call of Duty: Advanced Warfare	Call of Duty: Advanced Warfare
បញ្ជីនៃទង់ជាតិអង្គភាពរដ្ឋបាលរាជវង្សង្វៀនរបស់	Флаги административных единиц династии Нгуен
