ທະວີບອາຟະລິກ	Африка
ປະເທດຍີ່ປຸ່ນ	Япония
ທະວີບອາເມລິກາໃຕ້	Южная Америка
ປະເທດນອກແວດ	Норвегия
ປະເທດອັງກິດ	Англия
ປະເທດເອກົດ	Шотландия
ປະເທດການ	Уэльс
ປະເທດອຽກລັງ	Ирландия
ປະເທດຮົງກະລີ	Венгрия
ປະເທດແອສະປາຍ	Испания
ສະຫະລັດອາເມລິກາ	Соединённые Штаты Америки
ປະເທດແບນຊິກ	Бельгия
ປະເທດລູກຊຳບວກ	Люксембург
ໂລກ	Земля
ປະເທດແຟງລັງ	Финляндия
ປະເທດຊູແອດ	Швеция
ປະເທດດານມາກ	Дания
ປະເທດໂປໂລຍ	Польша
ປະເທດລີຕົວນີ	Литва
ປະເທດອິຕາລີ	Италия
ປະເທດສະວິດ	Швейцария
ປະເທດໂອຕະລິດ	Австрия
ປະເທດກະແລັດ	Греция
ປະເທດຕວກກີ	Турция
ເບຍ	Пиво
ປະເທດປອກຕຸຍການ	Португалия
ທະວີບເອີລົບ	Европа
ອາຊີ	Азия
ທະວີບອາເມລິກາເໜືອ	Северная Америка
ທະວີບອັງຕາກຕິກ	Антарктида
ວິກິພີເດຍ	Википедия
ປະເທດໂຮນລັງ	Нидерланды
ຄອມພິວເຕີ	Компьютер
ອິນເຕີເນັດ	Интернет
ບາຣັກ ໂອບາມາ	Обама, Барак
ປະເທດອູຣູກວາຍ	Уругвай
ຈັກພິມ	Принтер
ລອນດອນ	Лондон
ປາລີ	Париж
ແອນດຣອຍດ໌	Android
ກູໂກລ	Google (компания)
ປະເທດເມັກຊິກ	Мексика
ມະຫາສະໝຸດອັດລັງຕິກ	Атлантический океан
ມະຫາສະໝຸດປາຊີຟິກ	Тихий океан
ວັນຈັນ	Понедельник
ເດືອນມັງກອນ	Январь
ກຸມພາ	Февраль
ມີນາ	Март
ເມສາ	Апрель
ພຶດສະພາ	Май
ມິຖຸນາ	Июнь
ກໍລະກົດ	Июль
ສິງຫາ	Август
ກັນຍາ	Сентябрь
ຕຸລາ	Октябрь
ພະຈິກ	Ноябрь
ທັນວາ	Декабрь
ວັນອັງຄານ	Вторник
ວັນພຸດ	Среда
ວັນພະຫັດ	Четверг
ວັນສຸກ	Пятница
ວັນເສົາ	Суббота
ວັນອາທິດ	Воскресенье
ປະເທດຝະລັ່ງ	Франция
ໝາ	Собака
ສະຫະລາຊະອານາຈັກ	Великобритания
ແມວ	Кошка
ປະເທດຈີນ	Китайская Народная Республика
ພາສາຝະລັ່ງ	Французский язык
ປະເທດບະເຣຊິນ	Бразилия
ປະເທດລັດເຊຍ	Россия
ຮູບຈັດຕຸລັດ	Квадрат
ທະເລ	Море
ແຂວງເກແບັກ	Квебек
ປະເທດເຢຍລະມັນ	Германия
ປະເທດບີເອໂລລຸດ	Белоруссия
ປະເທດອີສະລັງ	Исландия
ປະເທດແອສະໂຕນີ	Эстония
ຍົນ	Самолёт
ຮູບສີ່ແຈສາກ	Прямоугольник
ມຸມສາກ	Прямой угол
ປະເທດແລດໂຕນີ	Латвия
ປະເທດອູກະແລນ	Украина
ສາທາລະນະລັດແຊັກ	Чехия
ປະເທດສະໂລວາກີ	Словакия
ປະເທດສະໂລເວນີ	Словения
ປະເທດລູມານີ	Румыния
ປະເທດບູນກາລີ	Болгария
ປະເທດມາເຊດວນ	Республика Македония
ປະເທດກະໂລອາຊີ	Хорватия
ປະເທດບົດສະນີແຮກເຊໂກວີນ	Босния и Герцеговина
ປະເທດອາແຊກບາຍຊັງ	Азербайджан
ປະເທດອັງດອກ	Андорра
ປະເທດຊີບ	Республика Кипр
ປະເທດເຊອັອກຊີ	Грузия
ປະເທດມານ	Мальта
ປະເທດໂມນາໂກ	Монако
ປະເທດແຊັງມາແລງ	Сан-Марино
ຫໍແອບແຟນ	Эйфелева башня
ຄີບອດ	Компьютерная клавиатура
ປະເທດອິນໂດເນເຊຍ	Индонезия
ໂທລະພາບ	Телевидение
ປະເທດຈີເລ	Чили
ພຣະເຢຊູ	Иисус Христос
ປະຫວັດສາດ	История
ພາສາ	Язык
ລະບອບຜະເດັດການ	Диктатура
ບິກແບງ	Большой взрыв
ດາຣາສາດ	Астрономия
ປະເທດສິງກະໂປ	Сингапур
ວິທະຍາສາດ	Наука
ມົງເລອານ	Монреаль
ປະເທດລິກເຕນສະຕາຍ	Лихтенштейн
ກິລາ	Спорт
ອາໂດນ ຮິດແລ	Гитлер, Адольф
ເຟດບຸກ	Facebook
ສົງຄາມໂລກຄັ້ງທີສອງ	Вторая мировая война
ໂມງ	Часы
ອຸບຸນຕູ	Ubuntu
ລິນຸກຊ໌	Linux
ຄະນິດສາດ	Математика
ພາສາລາແຕັງ	Латинский язык
ປະເທດອາກເມນີ	Армения
ປະເທດແຊກບີ	Сербия
ດວງຈັນ	Луна
ປະເທດອົດສະຕະຣາລີ	Австралия
ວັດຖຸວິທະຍາ	Физика
ປະເທດອາກຊັງຕິນ	Аргентина
ໂທລະຄົມມະນາຄົມ	Электросвязь
ປະເທດເປຣູ	Перу
ຊີວະສາດ	Биология
ປະເທດກຳປູເຈຍ	Камбоджа
ໄດໂນເສົາ	Динозавры
ສາສະໜາອິສະລາມ	Ислам
ຈິດ	Ум
ສັນຕິພາບ	Мир (отсутствие войны)
ກາບກອນ	Поэзия
ຈັກກະພັດນາໂປເລອົງທີ 1	Наполеон I
ປີແສງ	Световой год
ໂອເຊອານີ	Океания
ລະບົບສຸລິຍະ	Солнечная система
ປຶ້ມ	Книга
ມື້	Сутки
ປີ	Год
ອົກຊີແຊນ	Кислород
ດົນຕີ	Музыка
ພາສາອິຕາລີ	Итальянский язык
ອາລູມິນຽມ	Алюминий
ປະເທດນູແວນເຊລັງ	Новая Зеландия
ປະເທດປາປົວຊີນູແວນກີເນ	Папуа — Новая Гвинея
ປະເທດເວເນຊູເອລາ	Венесуэла
ສັດ	Животные
ປະເທດຊູຣີນາມ	Суринам
ປະເທດປາຣາກວາຍ	Парагвай
ປະເທດກຸຍຢານ	Гайана
ສິລະປະ	Искусство
ປະເທດເອກົວເຕີ	Эквадор
ປະເທດໂກລົມບີ	Колумбия
ພຸດທະສາສະໜາ	Буддизм
ປະເທດໂບລີວີ	Боливия
ປະເທດກົວເຕມາລາ	Гватемала
ປະເທດອີຣານ	Иран
ປະເທດກົດສະຕາລິກາ	Коста-Рика
ປະເທດລາວ	Лаос
ທະວີບອາເມລິກາ	Америка
ງົວ	Корова
ປະເທດມາເລເຊຍ	Малайзия
ປະເທດມຽນມາ	Мьянма
ປະລາຕົງ	Платон
ຢູທູບ	YouTube
ປະເທດໄທ	Таиланд
ລົດໄຟ	Поезд
ປະເທດຫວຽດນາມ	Вьетнам
ປະເທດເກົາຫຼີໃຕ້	Республика Корея
ປະເທດບັງກະລາເທດ	Бангладеш
ປະເທດອັງໂກລາ	Ангола
ທະວິດເຕີ	Твиттер
ປະເທດບູໄນ	Бруней
ປະເທດຟີລິບປິນ	Филиппины
ປັກກິ່ງ	Пекин
ວິວັດທະນາການ	Эволюция
ສະຫະປະຊາຊາດ	Организация Объединённых Наций
ທໍລະນີສາດ	Геология
ພູມສາດ	География
ສີ	Цвет
ຄຳນາມ	Имя существительное
ປະເທດໂກໂຊໂວ	Республика Косово
ໝວດ:ມູນຖານ	Категория:Всё
ລະດູໜາວ	Зима
ລະດູບານໃໝ່	Весна
ລະດູຮ້ອນ	Лето
ລະດູໃບໄມ້ຫຼົ່ນ	Осень
ພາສາແອສະປາໂຍນ	Испанский язык
ໝາກໄມ້	Плод
ເງິນ	Деньги
ລັດນີວຢອກ	Нью-Йорк (штат)
Uetersen	Итерзен
Microsoft Windows	Windows
ໄທບີຣຽສ	Тиберий
ລົດ	Автомобиль
ບອກໂດ	Бордо
ໂຕກຽວ	Токио
ບາກເຊໂລນ	Барселона
ໝາກນັດ	Ананас крупнохохолковый
ກາໂຕລິກ	Католицизм
ພະຄຳພີ	Библия
ພະນົມເປັນ	Пномпень
ນິກາຍໂບດທູຈີຊັດ	Церковь истинного Иисуса
ພາສາອັງກິດ	Английский язык
ບາງກອກ	Бангкок
ດົງເຮີຍ	Донгхой
ໂກຣິສໂກໂວລາ	Коньсковоля
ປີ 2009	2009 год
ປີ 2008	2008 год
ອາຫານ	Пища
XML	XML
ການປະຕິວັດອຸດສາຫະກຳ	Промышленная революция
ໄມໂຄຼຊອຟທ໌	Microsoft
ຄູໂຣ	Курув
ເຄມີສາດ	Химия
14 ກຸມພາ	14 февраля
22 ມີນາ	22 марта
16 ເມສາ	16 апреля
ອາໂນນ ຊວາເຊເນກເກີ	Шварценеггер, Арнольд
19 ກໍລະກົດ	19 июля
ເຕະບານ	Футбол
ໄອໂຟນ	IPhone
ເຮືອດຳນ້ຳ	Подводная лодка
ໄມເຄິ້ນ ແຈັກຊັ້ນ	Джексон, Майкл
ພະລາຊະວັງແວກໄຊ	Версаль
ມະຫາວິຫານນົດ-ດາມ	Собор Парижской Богоматери
ໝວດ:ແມ່ແບບ	Категория:Википедия:Шаблоны
ແມ່ນ້ຳອາມາຊົນ	Амазонка
ໂຮງຮຽນ	Школа
ມະຫາວິທະຍາໄລ	Университет
ວິກິພີເດຍ:Sandbox	Википедия:Песочница
ວິກິພີເດຍ:ເລີ່ມຕົ້ນ	Википедия:Добро пожаловать в Википедию
ເຮືອນ	Жилище
ທະວີບອົດສະຕະຣາລີ	Австралия (континент)
ຮາດແວ	Аппаратное обеспечение
ພຶດຊະຄະນິດ	Алгебра
ສະໜາມບິນດົງເຮີຍ	Донгхой (аэропорт)
ອາວະກາດ	Космическое пространство
ປ່າໄມ້	Лес
ຂົງຈື້	Конфуций
ມາຣິລິນ ມອນໂຣ	Мэрилин Монро
ໝວດ:ຄະນິດສາດ	Категория:Математика
ເອີໂລ	Евро
ທະເລເມດີແຕກລາເນ	Средиземное море
ຄິດຕະສາສະໜາ	Христианство
Windows 8	Windows 8
ເຂົ້າຈ້າວ	Рис (продукт питания)
ທະວີບ	Континент
ສັດປີກ	Птицы
ນະຄອນຫຼວງ	Столица
ພາສາປອກຕຸຍການ	Португальский язык
ເດືອນ	Месяц
1949	1949 год
ຕາກດີກະລາດາ	Тихоходки
ພາສາຍີ່ປຸ່ນ	Японский язык
ໜ້າຈໍ	Монитор (устройство)
ສາລານຸກົມ	Энциклопедия
ໜ້າຫຼັກ	Заглавная страница
ຊີພີຢູ	Процессор
ເຣົາເຕີຣ໌	Маршрутизатор
ໂຕຕ້ານໄຟຟ້າ	Резистор
ທຣານຊິສເຕີ	Транзистор
ເບດບອນ	Бейсбол
ບານບ້ວງ	Баскетбол
ກິລາໂອແລມປິກ	Олимпийские игры
ລົດເມ	Автобус
ແຄວ້ນກາຕາໂລຍ	Каталония
ການຮ່ວມເພດ	Половой акт
ປັດຊະຍາ	Философия
ຈິມິ ເຮນດຣິກຊ໌	Хендрикс, Джими
ໝວດ:Candidates for speedy deletion	Категория:Википедия:К быстрому удалению
ອະນາທິປະໄຕ	Анархизм
ລັດທິທຶນນິຍົມ	Капитализм
ປະເທດ	Страна
ເວັບເບຣົາວ໌ເຊີຣ໌	Браузер
Boeing 737	Boeing 737
ໝວດ:ດາຣາສາດ	Категория:Астрономия
ການປະຕິວັດຝະລັ່ງ	Великая французская революция
ຮັກຮ່ວມເພດ	Гомосексуальность
ອາຫານຝະລັ່ງ	Французская кухня
ໂຮແມ	Гомер
ພາສາກາຕາລັງ	Каталанский язык
ພຣະພຸດທະເຈົ້າ	Будда
ອະເທວະນິຍົມ	Атеизм
ຫໍສະໝຸດ	Библиотека
ນິເວດສາດ	Экология
ການເມືອງ	Политика
ລະບອບປະຊາທິປະໄຕ	Демократия
ໂລກາພິວັດ	Глобализация
ແຊນ	Ген
ລັດຖະບານ	Правительство
ຄວາມສວຍງາມ	Красота
ລາຊາທິປະໄຕ	Монархия
ລັດ	Государство
ດັງ	Нос
ເພງ	Песня
ເດິນຟິນ	Дельфины
ສັດລ້ຽງລູກດ້ວຍນ້ຳນົມ	Млекопитающие
ໂລຊີຊີແອນ	Программное обеспечение
ອາເດແອັນ	Дезоксирибонуклеиновая кислота
ແອສະແປດ	Биологический вид
ພາສາລັດເຊຍ	Русский язык
ກົດໝາຍ	Право
ລັດຖະທຳມະນູນ	Конституция
ສະມາຄົມປະຊາຊາດແຫ່ງອາຊີຕາເວັນອອກສຽງໃຕ້	Ассоциация государств Юго-Восточной Азии
ກອງທືນການເງີນລະຫວ່າງປະເທດ	Международный валютный фонд
ພາສາສະວາຮີລີ	Суахили
ພາສາຈີນ	Китайский язык
ທຳມະຊາດ	Природа
ນ້ຳດື່ມ	Питьевая вода
ພາສາລູມານີ	Румынский язык
ສຶກສາສາດ	Педагогика
ແຮ່ທາດ	Минерал
ເຊັນ	Дзэн
ເມົາສ໌	Компьютерная мышь
ປະໂລເຕອິນ	Белки
ພະຍຸໂທຣນາໂດ	Смерч
ໄຕມຸມ	Тригонометрия
ເລຂາຄະນິດ	Геометрия
ໄວຍະກອນ	Грамматика
ນິນເທັນໂດ	Nintendo
ເສດຖະສາດ	Экономика (наука)
ທຶນ	Капитал
ເງິນຕາ	Валюта
ເຢນ	Японская иена
ອຸດສາຫະກຳ	Промышленность
ພາສີ	Налог
ພາສາສາດ	Лингвистика
ຄຳ (ພາສາສາດ)	Слово
ໂຕໜັງສືເກຣັກ	Греческий алфавит
ວັນນະຄະດີ	Литература
ໝວດ:ປະເທດຝະລັ່ງ	Категория:Франция
ໝວດ:ດົນຕີ	Категория:Музыка
ໝວດ:ວັນນະຄະດີ	Категория:Литература
ຂັ້ນຕອນວິທີ	Алгоритм
ການສຶກສາ	Образование
ຄອບຄົວ	Семья
ກາເຟ	Кофе
ນົມ	Молоко
ສົງຄາມເຢັນ	Холодная война
ຊຽງໄຮ້	Шанхай
ອິນເຕີຣ໌ເນັຕ ໂປຣໂຕໂຄລ	IP
ໄບຕ໌	Байт
ບິຕ	Бит
ຄວາມຮູ້	Знание
ສາສະໜາພາມ	Индуизм
ປະລະມະນູ	Атом
ພາສາກະເລັກ	Греческий язык
ລະບົບປະຕິບັດການ	Операционная система
ອີແມລ	Электронная почта
ສາສະໜາ	Религия
ພາສາເກົາຫຼີ	Корейский язык
ຕຶກແອັມພາຍສະເຕດ	Эмпайр-стейт-билдинг
ອະນຸສາວະລີເທພີເສລີພາບ	Статуя Свободы
ພາສາລາວ	Лаосский язык
ພາສາໄທ	Тайский язык
ສາສະໜາຊູດາ	Иудаизм
ພາສາການ	Валлийский язык
ສາສະໜາຊິກ	Сикхизм
ຈອນ ເມນາດ ເຄນ	Кейнс, Джон Мейнард
ວຽງຈັນ	Вьентьян
ພຶຕິກຳ	Поведение
ອາລົມ	Эмоция
ຈິຕະວິທະຍາ	Психология
ຄວາມຄຶດ	Мышление (психология)
ມະຫາສະໝຸດ	Океан
ຈະລິຍະທຳ	Этика
ຍານວິທະຍາ	Эпистемология
ເຈດຈຳນົງເສລີ	Свобода воли
ແກນກາງ	Ядро операционной системы
ສົມເດັດພະລາຊິນີນາດເອລີຊາແບັດທີ 2 ແຫ່ງສະຫະລາຊະອານາຈັກ	Елизавета II
ຄວາມທຸກຍາກ	Бедность
ຕາລາງທາດ	Периодическая система химических элементов
ເດິນຟິນໜູ	Морские свиньи
ກົກໄມ້	Дерево
ເນີຍແຂງ	Сыр
ຜັກ	Овощи
ໂຣບົດ	Робот
ເຕັກໂນໂລຊີ	Технология
ກົນຈັກ	Машина
ວິສະວະກຳ	Инженерное дело
ສານສົນເທດ	Информация
ໜັງສືພິມ	Газета
ໂທລະສັບ	Телефон
ວັດທະນະທຳ	Культура
ຫມາຍເລກໄອພີ	IP-адрес
ແພດສາດ	Медицина
ອົງກອນນິຕິບັນຍັດ	Законодательная власть
ຫ້ຽນ	Троллинг
ສົມຜົນ	Уравнение
ຕຳລາ (ຄະນິດສາດ)	Функция (математика)
ກະລູຊິດ	Углеводы
ຮອກມົນ	Гормоны
ເກມ	Игра
ຂອງຫຼິ້ນ	Игрушка
ຮູບເງົາ	Фильм
ລົດຖີບ	Велосипед
ກຳປັ່ນ	Судно
ກະສິກຳ	Сельское хозяйство
ລາຍຊື່ໜ່ວຍນັບເວລາ	Время
ເຈ້ຍ	Бумага
ປະລາສະຕິກ	Пластмассы
ເນື້ອທີ່	Площадь
ຈຳນວນ	Число
ຈຳນວນສົນ	Комплексное число
ແມັດ	Метр
ຈິຕະກຳ	Живопись
ນັກອາວະກາດ	Космонавт
ການຖ່າຍຮູບ	Фотография
ການຟ້ອນລຳ	Танец
ເອເລັກໂຕຣນິກ	Электроника
ສ່ວນປະກອບເອເລັກໂຕຣນິກ	Электронные компоненты
ດີອົດ	Диод
ເຕັກໂນໂລຊີຂໍ້ມູນຂ່າວສານ	Информационные технологии
ຕະຫລາດຫລັກຊັບ	Фондовая биржа
ອາຊີຕາເວັນອອກສຽງໃຕ້	Юго-Восточная Азия
ບະລັງແນດ	Белоснежка
ຊັງດີຢົງ	Золушка
ປະຕິທິນ	Календарь
ເຂດເວລາ	Часовой пояс
ສຸຂະພາບ	Здоровье
ເອດສ໌	ВИЧ-инфекция
ສະຖາປັດຕະຍະກຳ	Архитектура
ຂົວ	Мост
ເຂົ້າໜົມມາກາຣົງ	Макарон
ສະຖິຕິສາດ	Статистика
ຈຳນວນຖ້ວນ	Целое число
ເຂື່ອນສາມຜາ	Три ущелья (электростанция)
ຍຸກແສງສະຫວ່າງ	Эпоха Просвещения
ສະໄໝກາງ	Средние века
ລວມຍອດຜະລິດຕະພັນພາຍໃນ	Валовой внутренний продукт
ແຟຊັ້ນ	Мода
ລູກຄິດ	Абак
ຄາບສະໝຸດອີເບລີ	Пиренейский полуостров
ຈຳນວນຈິງ	Вещественное число
ໝາກຟະແລດ	Земляника ананасная
ໝາກກ້ຽງ	Апельсин
ພາສາຈ້ວງ	Чжуанский язык
ພາສານາວາເທິນ	Астекские языки
ສິ່ງແວດລ້ອມສໍາລັບການພັດທະນາແບບຮວບຮວມ	Интегрированная среда разработки
ພາສາອາຣັບ	Арабский язык
ພາສາອົກຊີຕັງ	Окситанский язык
ນາຍົກລັດຖະມົນຕີ	Премьер-министр
ສໍດຳ	Карандаш
ໂຕະ	Стол
ແທັງເກີ	Танкер
ກວາງຄໍຍາວ	Жираф
ພາສາເຊ	Си (язык программирования)
ວິກິພີເດຍ:ບົດຄວາມດີເດັ່ນ	Википедия:Избранные статьи
ວິກິພີເດຍ:Village pump	Википедия:Форум
ກວ່າງໂຈວ	Гуанчжоу
ໂຮງໜໍ	Больница
ການສົມລົດເພດດຽວກັນ	Однополый брак
ໂທລະສັບມືຖື	Сотовый телефон
ລົດສະນິຍົມທາງເພດ	Сексуальная ориентация
ງົວປ່າອາເມລິກາ	Бизоны
ບານເຕະໂລກ	Чемпионат мира по футболу
ຍາຈາງ	Нячанг
ສາທາລະນະສົມບັດ	Общественное достояние
ກຸ່ມພາສາໂລມັງ	Романские языки
ຮູບສາມແຈ	Треугольник
ຈຳນວນທຳມະຊາດ	Натуральное число
ສັດທະອັກສອນສາກົນ	Международный фонетический алфавит
ສະມາດໂຟນ	Смартфон
ພິກັດພູມສາດ	Географические координаты
ເກີບ	Лёгкая обувь
ເສລີພາບໃນການເວົ້າ	Свобода слова
ສວນສາທາລະນະ	Парк
ສັບປະດາ	Неделя
ຜັກທຽມ	Чеснок
ມະນຸດສາດ	Антропология
ເອແດມບວກ	Эдинбург
កោះ	Остров
ພາສາລັດຖະການ	Официальный язык
ບູຮານວິທະຍາ	Археология
ອຸດທະຍານແຫ່ງຊາດຟົງ ງາ-ເຄ ບັງ	Фонгня-Кебанг
ແຂວງກວາງບິນ	Куангбинь
ເສັ້ນສູນສູດ	Экватор
ປະໂລແຕສະຕັງ	Протестантизм
ວັດຈະນານຸກົມ	Словарь
ເພງຊາດ	Государственный гимн
ຄຳກຳມະ	Глагол
ພາສາແຟໂລ	Фарерский язык
ສັດກິນຊີ້ນ	Хищные
ເກາະຊີແລນ	Зеландия (остров)
ເຮືອຂ້າມຟາກ	Паром
Józef Gosławski	Гославский, Юзеф
ການຂັບລຳ	Пение
ເສັ້ນຜົມ	Волосы
ວິຊາຊີບ	Профессия
ສິນຄ້າ	Благо (экономика)
ຜົນຕຳລາ	Производная функции
ບລອກ	Блог
ນົກແກ້ວ	Попугаеобразные
ຊື່ໂດເມນ	Доменное имя
ມ້າລາຍ	Зебры
ເລກມາຕະຖານສາກົນປະຈຳປຶ້ມ	Международный стандартный книжный номер
ພາສາຈາໂມໂລ	Чаморро (язык)
ພາສາເຈໂລກີ	Чероки (язык)
ຈິຕະນິຍົມ	Идеализм
ເສັ້ນຂະໜານ	Широта
ໝວດ:ພາສາໂປແກມ	Категория:Языки программирования
ຈັດສະຕິນ ບີເບີ	Бибер, Джастин
ກຸ່ມພາສາໄທ-ກະໄດ	Тай-кадайские языки
ເນີຍ	Сливочное масло
ເທວະວິທະຍາ	Богословие
ນ້ຳຕົກຕາດນີອາກາລາ	Ниагарский водопад
ໂຫລາສາດ	Астрология
ຫົງ	Лебеди
ຫົນທາງ	Дорога
ເຮລີກົບແຕ	Вертолёт
ລົດຈັກ	Мотоцикл
ມ້າແມ່ນ້ຳ	Обыкновенный бегемот
ສັງຄົມສາດ	Общественные науки
ແຫຼມ	Полуостров
ລະຫັດໂທລະສັບລະຫວ່າງປະເທດ	Список телефонных кодов стран
ຟົວກາ	Фуа-гра
ມົນທົນ	Провинция
ໝາກຫຸ່ງ	Папайя
ວິຕາມິນ	Витамины
ເວັບໄຊຕ໌	Сайт
ກວາງອູດ	Лось
ເສືອອາເມລິກາ	Ягуар
ສະພາ	Парламент
ສະພາວະເງິນເຟີ້	Инфляция
ເຮືອ	Лодка
ໂປລີເນຊີ	Полинезия
ດຽນບຽນຟູ	Дьенбьенфу (город)
ໝີໄຮ້ຫາງ	Коала
ເສັ້ນແວງ	Долгота
ສະຫັດສະວັດ	Тысячелетие
ຊ້າງຂົນຍາວ	Мамонты
ອອງ ຊານ ຊຸຈີ	Аун Сан Су Чжи
ໄຂ້ຫວັດຫມູ	Свиной грипп
ພາສາໄທລື້	Лы (язык)
ເສິນຫຼົງ	Чан, Джеки
ເອກະລາດ	Независимость
ມະຣິວຸລ	Мариуполь
ມະຫາປີລະມິດ ແຫ່ງ ກິຊາ	Пирамида Хеопса
ISO 4217	ISO 4217
ຕະຫຼາດ	Рынок
ກະໂລໂມຊົມ	Хромосома
ມັນດ້າງ	Батат
ພະຍັນຊະນະ	Согласные
ນ້ຳຕົກຕາດຄອນພະເພັງ	Кхон (водопады)
ຟີລຳ	Тип (биология)
ພະເຈົ້າຮົງລີທີ 8 ແຫ່ງອັງກິດ	Генрих VIII
ຂ່າວ	Новости
ດັດສະນີການພັດທະນາມະນຸດ	Индекс человеческого развития
ເສດຖະສາດຈຸນລະພາກ	Микроэкономика
ສັດລ້ຽງ	Животные-компаньоны
ເລເຈບ ໄຕຢິບ ແອໂດກັນ	Эрдоган, Реджеп Тайип
ນໍ້າມັນເຊື້ອໄຟ	Бензин
ເສດຖະສາດມະຫາພາກ	Макроэкономика
ສະໜວນກາຊາ	Сектор Газа
ເຄື່ອງດື່ມ	Напиток
ປະໂລກະລຳ ແອງຟອກມາຕິກ	Компьютерная программа
ຍານອາວະກາດ	Космический аппарат
ເຈັນນິເຟີຣ໌ ໂລເປສ	Лопес, Дженнифер
ມີດຕັດ	Ножницы
ຊ້າງທະເລ	Морж
ຕຶກ	Здание
ແມ່ນ້ຳຂອງ	Меконг
ວາລະສານ	Журнал
ສານ	Суд
Rupiah ອິນໂດເນເຊຍ	Индонезийская рупия
ປະໂຫຍກ	Предложение (лингвистика)
ສວນລອຍຟ້າບາບິລອນ	Висячие сады Семирамиды
ໝາແຜງ	Гиены
ພິ່ນອິ່ນ	Пиньинь
ເຊື້ອໄຟ	Топливо
ອູດແກະໃຫຍ່	Лама (животное)
ຄວາຍ	Азиатский буйвол
Long Thanh International Airport	Лонгтхань (аэропорт)
ຍານພາຫະນະ	Транспортное средство
ນ້ຳມັນ	Масло
ວິນຍານນິຍົມ	Анимизм
ບໍລິການຂໍ້ຄວາມສັ້ນ	SMS
ເຮືອນຄົວ	Кухня (помещение)
ຮັກຮ່ວມສອງເພດ	Бисексуальность
ເອສົບ	Эзоп
ສິ່ງແວດລ້ອມ	Окружающая среда
ໂກແລສະເຕໂລນ	Холестерин
ສະຫະພັນທະລັດ	Федеративное государство
ໄຂ້ຫວັດນົກ	Птичий грипп
ມາຕຣິກ	Матрица (математика)
ຕຳນານ	Легенда
ເທວາທິປະໄຕ	Теократия
ຂົວໂກນເດນເກດ	Золотые Ворота (мост)
ໝາກສຸກ ໝາກໃສ	Ветряная оспа
ທ່າເຮືອ	Порт
Vaishnavism	Вайшнавизм
ໝາກມີ້	Джекфрут
ທຸງຊາດລາວ	Флаг Лаоса
ໃບສະຫຼຸບຊັບສົມບັດ	Бухгалтерский баланс
ສາຍການບິນ	Авиакомпания
ເສດຖະສາດສາກົນ	Международные экономические отношения
ວັນກຳມະກອນສາກົນ	Первое мая (праздник)
ລາດາ	Радиолокационная станция
ແມ່ແບບ:Commonscat	Шаблон:Commonscat
ຈັກກະວັດແອສະປາຍ	Империя
ມະຫາຍານ	Махаяна
ກະສວຍອາວະກາດ	Спейс шаттл
ການທ່ອງທ່ຽວ	Туризм
ຕູ້ໄປສະນີ	Почтовый ящик
Visual Basic .NET	Visual Basic .NET
ແຂວງ	Административное деление Лаоса
ຕຳລາຂັ້ນສອງ	Квадратичная функция
ອີໂບລາ	Геморрагическая лихорадка Эбола
ໝວດ:ລັດຖະບານ	Категория:Правительство
ໝວດ:ຄວາມຮັກ	Категория:Любовь
ສະຖານີລົດໄຟ	Железнодорожная станция
ພາສາມາລິໂຄປາ	Марикопа (язык)
ພາສາໂຮປີ	Хопи (язык)
ພາສາເຮົາຊາ	Хауса (язык)
ພາສາໄທເໜືອ	Шанский язык
ຈູມມະລີ ໄຊຍະສອນ	Сайнясон, Тюммали
ຫງວຽນເຕິນຢຸງ	Нгуен Тан Зунг
ຍິ່ງລັກ ຊິນນະວັດ	Чиннават, Йинглак
ທອງສິງ ທຳມະວົງ	Тхаммавонг, Тхонгсинг
ກ້ອງດິຈິຕອນ	Цифровой фотоаппарат
ອັດຕາແລກປ່ຽນ	Валютный курс
ທະນາຄານກາງ	Центральный банк
ການຜັງເມືອງ	Градостроительство
ຮອບບິດ (ປຶ້ມ)	Хоббит, или Туда и обратно
ຄະນາທິປະໄຕ	Олигархия
ບານເຕະໂລກ 2014	Чемпионат мира по футболу 2014
ການແຍກໃຊ້ອຳນາດ	Разделение властей
ໝາກກ້ຽງໃຫຍ່	Помело (фрукт)
ວົງຈອນພອນ	Мангустовые
ໄຟຟ້າພະລັງນໍ້າ	Гидроэлектростанция
ວິສະວະກຳໂລຊີຊີແອນ	Программная инженерия
ອູດແກະ	Альпака
ຄວາມກົດອາກາດ	Атмосферное давление
ບ່ວງ	Ложка
VoIP	IP-телефония
ໄມ້ຖູ່	Палочки для еды
ກຳລັງຊື້ທຽບຖານ	Паритет покупательной способности
ເຄື່ອງໝາຍວັກ	Пунктуация
ຕັກຊີ	Такси
ຄຳອຸທານ	Междометие
ພຽງພອນເໝັນ	Скунсовые
ເຊລີນ້າ ໂກເມຊ	Гомес, Селена
ໂຮງງານ	Фабрика
ບານເຕະທີມຊາດບະເລຊິນ	Сборная Бразилии по футболу
ບານໂປໂລຍ	Polandball
ຕຳລາໄຕມຸມ	Тригонометрические функции
ຄຣິສຕະຈັກເຊເວັນເດ ແອັດເວັນຕິສ	Церковь адвентистов седьмого дня
PAL	PAL
ອຳນາດຕຸລາການ	Судебная власть
ຄວາມສະເໝີພາກທາງເພດ	Равенство полов
ເຂົ້າຫນຽວ	Клейкий рис
ລັດທິ	Доктрина
ກະລັງກັງຢົງ	Большой каньон
ແມ່ນ້ຳເຈົ້າພະຍາ	Чаупхрая
ຊຸບເປີຄອມພິວເຕີ	Суперкомпьютер
ໂຄງສ້າງພື້ນຖານ	Инфраструктура
ໜູລ້າງນ້ຳ	Енот-полоскун
ຕົ້ນໂຣສ ເມຣີ	Розмарин лекарственный
ປະເທດທີ່ບໍ່ມີທາງອອກສູ່ທະເລ	Государства без выхода к морю
ເວັກເຕີ	Векторное пространство
ປຶ້ມເອເລັກໂຕຣນິກ	Электронная книга
ພາສີມູນຄ່າເພີ່ມ	Налог на добавленную стоимость
ພະເຈົ້າເອດູອາກທີ 3 ແຫ່ງອັງກິດ	Эдуард III
Mikoyan MiG-29	МиГ-29
ການພັດທະນາແບບຍືນຍົງ	Устойчивое развитие
ອ່າວໄທ	Сиамский залив
ການວາງແຜນຊັບພະຍາກອນຂອງອົງກອນ	ERP
ນິກາຍເຖຣະວາດ	Тхеравада
ໂທລະພາບຄວາມລະອຽດສູງ	Телевидение высокой чёткости
ທຸງຊາດໄທ	Флаг Таиланда
ພະຍຸໄຕ້ຝຸ່ນ	Тайфун
ດຸນການຊຳລະ	Платёжный баланс
ການຊອກຄ່າເໝາະສົມ (ຄະນິດສາດ)	Оптимизация (математика)
ພາສາຄູເພໂຍ	Купеньо (язык)
ລະດູແລ້ງ	Сухой сезон
Phu Quoc	Фукуок
ປະເທດລາວໃນໂອລິມປິກລະດູຮ້ອນ 2008	Лаос на летних Олимпийских играх 2008
ວິກິພີເດຍ:ຂໍໃຫ້ຂະຫຍາຍ	Википедия:Как править статьи
Leopard 2	Леопард 2
ວົງຜື	Осоковые
ເດຈາວູ	Дежавю
ເຄື່ອງຮັບວິທະຍຸ	Радиоприёмник
Eurocopter Tiger	Eurocopter Tiger
ເສດຖະກິດ	Экономика
ເອໂຄໂນເມທຣິກ	Эконометрика
ລາຄາ	Цена
ມະຫາວິທະຍາໄລເອແດມບວກ	Эдинбургский университет
ທາງລົດໄຟ	Железнодорожный путь
ສຳປະສິດຈິນີ	Коэффициент Джини
ກາຕະລີນແຫ່ງອາລາກົງ	Екатерина Арагонская
ໝາກເຜັດ	Красный перец
ບິກ	Ручка (канцелярия)
ໝາກກ້າຍ	Плантан
ທືນສັບພະຍາກອນມະນຸດ	Человеческий капитал
ການສະໜອງ ແລະ ຄວາມຕ້ອງການ	Закон спроса и предложения
ຊອດໄຂ່ແດງ	Майонез
ENIAC	ЭНИАК
ຊຸດຈຳນວນ	Числовой ряд
ພັດທະຍາ	Паттайя
ດອກເບ້ຍ	Процентный доход
ຫຸ່ນຍົນສາດ	Робототехника
Boeing AH-64 Apache	McDonnell Douglas AH-64 Apache
ອຸປະຕິເຫດ	Авария
ຢາງລຶບ	Стирательная резинка
ເຂື່ອນຮູເວີ	Плотина Гувера
ນູເມລິກ	Цифровой формат
ລະບົບມາດຕະຖານຄຳ	Золотой стандарт
Sukhoi Su-27	Су-27
ການບັນເທີງ	Развлечение
កាំ	Радиус
ມະຫາວິຫານແຊັງໂປນ	Собор Святого Павла
ຍິວວິທະຍາໄລຂອງເຢຣູຊາເລັມ	Еврейский университет в Иерусалиме
ມະຫາວິທະຍາໄລແຄລິຟໍເນຍ ລອດແອນເຈລິດ	Калифорнийский университет в Лос-Анджелесе
ຊັງຕີແມັດ	Сантиметр
ມິລີແມັດ	Миллиметр
ມິໂກຣແມັດ	Микрометр
ລາຍຊື່ປະເທດຮຽງຕາມຄວາມໜ້າແໜ້ນຂອງປະຊາກອນ	Список стран по плотности населения
ເສດຖະກິດຕົກຕໍ່າ	Рецессия
ເມນເຟຣມ	Мейнфрейм
ບໍ່ນ້ຳຮ້ອນ	Геотермальный источник
ເນັຕບຸກ	Нетбук
ນະໂຍບາຍເງິນຕາ	Денежно-кредитная политика государства
ນາໂນແມັດ	Нанометр
ການຄ້າສາກົນ	Международная торговля
ຈອຍສະຕິກ	Джойстик
ເທວະດາ	Божество
ອັດຕາດອກເບ້ຍ	Процентная ставка
ລົດໂຮງໝໍ	Автомобиль скорой помощи
ຈັງຫວັດພູເກັດ	Пхукет
ເສັ້ນສະແດງ	График функции
ສູດເຮລົງ	Формула Герона
ບັນທັດຖານວັດແທກ ລາຍໄດ້ ແລະ ຜົນຜະລິດ ແຫ່ງຊາດ	Валовой национальный продукт
ຕົ້ນທຶນໂອກາດ	Альтернативные издержки
ວົງເຫງັນ	Виверровые
ນະໂຍບາຍການເງິນ	Фискальная политика
ເຄື່ອງໝາຍຊາດຂອງໄທ	Эмблема Таиланда
ຕຳລາເສັ້ນຊື່	Линейная функция
ປະຊາທິປະໄຕແບບມີຜູ້ແທນ	Представительная демократия
ທະນາຄານພັດທະນາອາຊີ	Азиатский банк развития
ເນີຍແຂງລົກຟອກ	Рокфор
ການຂະຫຍາຍໂຕທາງເສດຖະກິດ	Экономический рост
ເມືອງຫຼວງພະບາງ	Луангпхабанг
ສົມເດັດພະລາຊາທິບະດີເຟລີເປທີ 6 ແຫ່ງແອສະປາຍ	Филипп VI (король Испании)
ວັນນະຍຸດ	Тон (лингвистика)
ນ້ຳເຕົ້າຮູ້	Соевое молоко
ການຊົມໃຊ້	Потребление
ປິໂກແມັດ	Пикометр
ເພດສຶກສາ	Половое просвещение
ການຕ່ຳ	Ткачество
ກະຊວງ	Министерство
ວັດຖຸດິບ	Сырьё
ຄອມພິວເຕີຣ໌ຈໍາລອງ	Виртуальная машина
ຈອງ	Половник (столовый прибор)
ລົດພະລັງງານໄຟຟ້າ	Электромобиль
ຫີນະຍານ	Хинаяна
Kang Dae Sung	Тэ Сон
Dassault Mirage 2000	Dassault Mirage 2000
ເງີນກີບລາວ	Лаосский кип
ເດຊີແມັດ	Дециметр
ຄວາມຮັ່ງມີ	Богатство
ເຄື່ອງໝາຍຊາດລາວ	Герб Лаоса
ພະຍາດໄລມ	Болезнь Лайма
ທໍ	Tor
ໂທລະພາບແບບດິຈິຕໍລ໌	Цифровое телевидение
ຕານ ສ່ວຍ	Тан Шве
ຮູບເງົາກາຕູນ	Мультфильм
ປະໂລແວງ	Провен
ຕຳລາຂັ້ນສາມ	Кубическое уравнение
Sukhoi Su-30	Су-30
ໂວນຟຣາມອານຟາ	WolframAlpha
ຈັງຫວັດຊົນບຸລີ	Чонбури (провинция)
ສິລະປະປະຍຸກ	Декоративно-прикладное искусство
ແວງກາແບກເນໂຊວີຍົງ	Каберне Совиньон
‍ໃບອະນຸຍາດຂອງຊອຟຕ໌ແວຣ໌	Лицензия на программное обеспечение
ເພງຊາດໄທ	Гимн Таиланда
ອາຊີອາຕິກ	Монголоидная раса
กงสุล	Консул (дипломат)
ລົດອັກຄີໄຟ	Пожарный автомобиль
ເຟັມໂຕແມັດ	Ферми (единица измерения)
ການທົດສອບສົມມຸດຕິຖານສະຖິຕິ	Проверка статистических гипотез
ປັດໃຈການຜະລິດ	Факторы производства
ສຸລິຍະຄະຕິ	Солнечный календарь
ລັດຖະບານເອເລັກໂຕຣນິກ	Электронное государство
ວາຈົກ	Залог (лингвистика)
ຜູ້ຊົມ	Публика
ພຶດຊະຄະນິດພື້ນຖານ	Элементарная алгебра
ແບບຈຳລອງ IS/LM	Модель IS-LM
ຟຣີແລນເຊີຣ	Фрилансер
ຄວາມໄດ້ປຽບທຽບຖານ	Теория сравнительных преимуществ
ພຣະໄຕຣປິດົກ	Палийский канон
ຄະລາວາດນິຍົມ	Секуляризм
ນັກໂທດການເມືອງ	Политический заключённый
ດອກຈຳປາ	Плюмерия
ສະໜາມບິນສາກົນວັດໄຕ	Ваттай (аэропорт)
າເປັນ	Анггун
ຄວາມຍືດຍຸ່ນ	Эластичность (экономика)
ຂະບວນການຄືນສູ່ເຢລູຊາເລມ	Назад в Иерусалим!
ຂົວມິດຕະພາບ ລາວ-ໄທ ແຫ່ງທີສອງ	Второй мост тайско-лаосской дружбы
ຈັງຫວັດຊຽງໃໝ່	Чиангмай (провинция)
ໂດລາເອມອນ	Дораэмон
ຈັງຫວັດສົງຂາ	Сонгкхла (провинция)
ຊາຍບອກ	Киборг
ຈັງຫວັດສະຕູນ	Сатун (провинция)
ອັກສອນໄທ	Тайское письмо
ຈັງຫວັດຊຽງຮາຍ	Чианграй (провинция)
ຈັງຫວັດກະບີ່	Краби (провинция)
ຈັງຫວັດປັດຕານີ	Паттани (провинция)
ຈັງຫວັດລະນອງ	Ранонг (провинция)
T-80	Т-80
ຈັງຫວັດພິຈິດ	Пхичит (провинция)
ຈັງຫວັດນະຄອນສະຫວັນ	Накхонсаван (провинция)
ຈັງຫວັດສຸລາດທານີ	Сураттани (провинция)
ຈັງຫວັດລຳປາງ	Лампанг (провинция)
ຈັງຫວັດເພັດຊະບູນ	Пхетчабун (провинция)
ຈັງຫວັດລຳພູນ	Лампхун (провинция)
ຈັງຫວັດຕາດ	Трат (провинция)
ຈັງຫວັດນົນທະບຸລີ	Нонтхабури (провинция)
ຈັງຫວັດຍະລາ	Яла (провинция)
ປະທານປະເທດ ແຫ່ງ ສປປ ລາວ	Список премьер-министров Японии
ໃບລາຍງານຜົນໄດ້ຮັບ	Отчёт о финансовых результатах
ຈັງຫວັດອຳນາດຈະເລີນ	Амнатчарен (провинция)
ຈັງຫວັດອ່າງທອງ	Ангтхонг (провинция)
ຈັງຫວັດຕັງ	Транг (провинция)
ຈັງຫວັດພັດທະລຸງ	Пхаттхалунг (провинция)
ຈັງຫວັດພະເຍົາ	Пхаяу (провинция)
ຈັງຫວັດປະຈວບຄີລີຂັນ	Прачуапкхирикхан (провинция)
ຈັງຫວັດອຸໄທທານີ	Утхайтхани (провинция)
ຈັງຫວັດແພ່	Пхрэ (провинция)
ຈັງຫວັດນະຄອນສີທຳມະລາດ	Накхонситхаммарат (провинция)
ຈັງຫວັດຊຸມພອນ	Чумпхон (провинция)
ຈັງຫວັດນ່ານ	Нан (провинция)
ຈັງຫວັດເພັດຊະບຸລີ	Пхетчабури (провинция)
ຄຳນາມປະສົມ	Сложное слово
ອ໋າວຢາຍ	Аозай
ໂທລະພາບແບບອະນາລ໊ອກ	Аналоговое телевидение
ລາຍຊື່ປະເທດລຽງຕາມພື້ນທີ່	Список государств и зависимых территорий по площади
ຈັງຫວັດແມ່ຮ່ອງສອນ	Мэхонгсон (провинция)
ລັດວິສາຫະກິດ	Государственное предприятие
ຈັງຫວັດນະລາທິວາດ	Наратхиват (провинция)
ຈັງຫວັດສະໝຸດປາການ	Самутпракан (провинция)
ຈັງຫວັດນະຄອນລາຊະສີມາ	Накхонратчасима (провинция)
ຈັງຫວັດສຸພັນບຸລີ	Супханбури (провинция)
ຈັງຫວັດພັງງາ	Пхангнга (провинция)
ປາຂ່າ(ໂລມາອີຣະວະດີ)	Иравадийский дельфин
ແລປົງ	Рапунцель
ຈັງຫວັດອຸຕະລະດິດ	Уттарадит (провинция)
ຈັງຫວັດກຳແພງເພັດ	Кампхэнгпхет (провинция)
ລະຄັງກຳປັນ	Рында (колокол)
Externality	Экстерналия
ຈັງຫວັດໄຊຍະພູມ	Чайяпхум (провинция)
ຈັງຫວັດເລີຍ	Лей (провинция)
ຈັງຫວັດການຈະນະບຸລີ	Канчанабури (провинция)
ຈັງຫວັດຕາກ	Так (провинция)
ຈັງຫວັດພິສະນຸໂລກ	Пхитсанулок (провинция)
ບໍລິການລົດເຊົ່າ	Прокат автомобилей
AIDC F-CK-1 Ching-kuo	AIDC F-CK-1
ເສດຖະວັດຖຸສາດ	Эконофизика
ຂົວເອີລັນ	Эландский мост
ເກໂກລີ ເລີມາກຊານ	Лемаршаль, Грегори
ແຂວງສາລະວັນ	Сараван (провинция)
ກ້ອງຖ່າຍວິດີໂອ	Видеокамера
ຄັງສຳຮອງເງິນຕາຕ່າງປະເທດ	Золотовалютные резервы
ຜູ້ໂດຍສານ	Пассажир
ສົມເດັດພະເຈົ້າກຸງທົນບຸລີ	Таксин (король Сиама)
ໄກສອນ ພົມວິຫານ	Фомвихан, Кейсон
ສຸພານຸວົງ	Суфанувонг
ຈັງຫວັດປາຈີນບຸລີ	Прачинбури (провинция)
ອຳນາດບໍລິຫານ	Орган публичной власти
ຈັງຫວັດບຸລີລຳ	Бурирам (провинция)
ຈັງຫວັດຂອນແກ່ນ	Кхонкэн (провинция)
ຈັງຫວັດຈັນທະບຸລີ	Чантхабури (провинция)
ຈັງຫວັດໜອງຄາຍ	Нонгкхай (провинция)
ຄົມມະນາຄົມ	Виды транспорта
ຈັງຫວັດສະໝຸດສາຄອນ	Самутсакхон (провинция)
ຈັງຫວັດສິງບຸລີ	Сингбури (провинция)
ຈັງຫວັດນະຄອນປະຖົມ	Наконпатом (провинция)
ແຂວງຜົ້ງສາລີ	Пхонгсали (провинция)
ແຂວງບໍ່ແກ້ວ	Бокэу
ແຂວງຈໍາປາສັກ	Тямпасак (провинция)
ຈັງຫວັດສະເຊີງເຊົາ	Чаченгсау (провинция)
ຈັງຫວັດລະຍອງ	Районг (провинция)
ຈັງຫວັດລາຊະບຸລີ	Ратчабури (провинция)
ຈັງຫວັດລົບບຸລີ	Лопбури (провинция)
ຈັງຫວັດສະລະບຸລີ	Сарабури (провинция)
ອາຍແກັສແຫຼວ	Сжиженные углеводородные газы
ສະຫະພາບໂທລະຄົມມະນາຄົມ	Международный союз электросвязи
ເຈົ້າມະຫາຊີວິດສີສະຫວ່າງວົງ	Сисаванг Вонг
ເຈົ້າສີສະຫວ່າງວັດທະນາ	Саванг Ватхана
ໜູຮັກ ພູມສະຫວັນ	Пхумсаван, Нухак
ຈັງຫວັດສີສະເກດ	Сисакет (провинция)
ຈັງຫວັດສຸໂຂໄທ	Сукхотхай (провинция)
ຈັງຫວັດສະແກ້ວ	Сакэу (провинция)
ຈັງຫວັດກາລະສິນ	Каласин (провинция)
ເມືອງປາກເຊ	Паксе
ລາວ (ຊົນເຜົ່າ)	Лао
ການກໍ່ສ້າງ	Строительство
ນະຄອນຫຼວງວຽງຈັນ	Вьентьян (префектура)
Henri Mouhot	Муо, Анри
ຂ່າ (ພືດ)	Альпиния галанга
ແອຣ໌ເອເຊຍ	AirAsia
ອາຂ່າ	Акха
Seung Ri	Сынни
ສົມເດັດພະສັນຕະປາປາຟຣັງຊົວ	Франциск (папа римский)
ຈັງຫວັດສະໝຸດສົງຄາມ	Самутсонгкхрам (провинция)
ຈັງຫວັດປະທຸມທານີ	Патхумтхани (провинция)
ຈັງຫວັດໄຊນາດ	Чайнат (провинция)
ໜີ້ຕ່າງປະເທດ	Внешний долг
ແຂວງໄຊຍະບູລີ	Сайнябули (провинция)
ໝາກຂີ້ຫູດ	Кафир-лайм
ແຂວງສະຫວັນນະເຂດ	Саваннакхет (провинция)
ແຂວງຊຽງຂວາງ	Сиангкхуанг
ແຂວງອຸດົມໄຊ	Удомсай
ຈັງຫວັດນະຄອນນາຍົກ	Накхоннайок (провинция)
ເສັ້ນໂຄ້ງບໍ່ຈຳແນກ	Кривая безразличия
ຈັງຫວັດມະຫາສາລະຄາມ	Махасаракам (провинция)
ພະເຈົ້າບຸເຣງນອງ	Байиннаун
ອຳເພີ	Ампхе
ຈັງຫວັດພະນະຄອນສີອະຍຸທະຍາ	Аюттхая (провинция)
ຕຳລາຂັ້ນສີ່	Уравнение четвёртой степени
ສະໜາມບິນສາກົນເຕິນເຊິນເຍິດ	Таншоннят
KAI T-50 Golden Eagle	KAI T-50 Golden Eagle
ປ່ອງຢ້ຽມປີ 2000	Windows 2000
ການຈັດການລູກຄ້າສໍາພັນ	Система управления взаимоотношениями с клиентами
Sukhoi Superjet 100	Sukhoi Superjet 100
7 ສິ່ງມະຫັດສະຈັນ	Семь чудес света
ໂສມງາມກັບເຈົ້າຊາຍອະສູນ	Красавица и чудовище
Choi Seung Hyun	T.O.P
Kwon Ji Yong	G-Dragon
ແຂວງຫົວພັນ	Хуапхан
ແຂວງອັດຕະປື	Аттапы
ອົງການ ຄວບຄຸມໄພສຸກເສີນລັດຖະບານກາງ	Федеральное агентство по управлению в чрезвычайных ситуациях (США)
ຈັງຫວັດຍະໂສທອນ	Ясотхон (провинция)
ແຂວງຄຳມ່ວນ	Кхаммуан
ຕຳລາຊີອີເອັສ	Функция CES
ຕຳລາການຜະລິດ	Производственная функция
ຄຳເມືອງ	Юан (язык)
ຜາສາດຫີນວັດພູ	Ват-Пху
ແຂວງເຊກອງ	Секонг
ການຄ້າ	Торговля
ຈຳນວນອະປົກກະຕິ	Иррациональное число
ຈຳປາສັກ	Тямпатсак (город)
ຄວາມລົ້ມເຫຼວຂອງຕະຫຼາດ	Фиаско рынка
ກາເຟອຽກລັງ	Кофе по-ирландски
ເພງຊາດລາວ	Гимн Лаоса
ໜູຖົງຊາຍ	Валлаби
ສວນຄົວ	Огород
ໝັງກາຕູນ	Истории в картинках
ຈັກຂັ້ນ	Разностная машина Чарльза Бэббиджа
ກູແຊກ	Гужеры
ເມືອງຫຼວງນໍ້າທາ	Луангнамтха (город)
ເອັນຣິໂຄ ເລັດຕາ	Летта, Энрико
Squadron (ການບິນ)	Эскадрилья
ລິງລົມ	Медленный лори
ລາຍຊື່ປະເທດຮຽງຕາມຈຳນວນປະຊາກອນ	Список стран по населению
7 ສິ່່ງມະຫັດສະຈັນຂອງໂລກ	Новые семь чудес света
ຄຳຂວັນປະຈຳຊາດ	Список национальных девизов
ຫ້ວຍຊາຍ	Хуайсай
ແຂວງວຽງຈັນ	Вьентьян (провинция)
ໄຮ້ເພດ	Асексуальность
ກອງປະຊຸມອາເຊັມ	АСЕМ
ໂຈດຊິງລາງວັນມິເລນຽມ	Задачи тысячелетия
ໂຜນ ກິ່ງເພດ	Кингпетч, Поне
ວັນ ລະຫວ່ງປະເທດ ຜູ້ໄຊ້ ມືຂ້າຍ	Международный день левши
ໄທໃຫຍ່	Шаны
ກະເທີຍ	Катой
ເນີຍແຂງຟ້າແກ່	Голубые сыры
ເສດຖະຄະນິດສາດ	Математическая экономика
ແຂວງຫຼວງພະບາງ	Луангпхабанг (провинция)
ເມືອງໄກສອນ ພົມວິຫານ	Саваннакхет (город)
ການບິນອະວະກາດ	Пилотируемый космический полёт
ການບິນລາວ	Lao Airlines
ພັກປະຊາຊົນປະຕິວັດລາວ	Народно-революционная партия Лаоса
ອາຊີໃຕ້	Южная Азия
ສະໜາມບິນສາກົນເຫຼ້າສຸດ	Дананг (аэропорт)
Harvard Mark I	Марк I (компьютер)
ນາຍົກລັດຖະມົນຕີ ແຫ່ງ ສປປ ລາວ	Премьер-министр Лаоса
BM-30 Smerch	Смерч (РСЗО)
ສາມຫຼ່ຽມຄຳ	Золотой треугольник
ເຂົ້າຈີ່ປາເຕ້	Паштет
ກິໂລແມັດ	Километр
ລົດມ້າ	Конка
ທິດສະດີຜູ້ຊົມໃຊ້	Теория потребления
ດຸນຍະພາບເສດຖະກິດ	Экономическое равновесие
Halo effect	Гало-эффект
ອານາຈັກອະຍຸທະຍາ	Аютия (государство)
ຄອມພິວເຕີຣ໌ນ້ອຍຕໍ່ເດັກນ້ອຍຫນຶ່ງຄົນ	One Laptop Per Child
ປະລິມານເງິນ	Денежная масса
ຜົນປະໂຫຍດຂອບເຂດ (ເສດຖະສາດ)	Предельная полезность
McDonnell Douglas F-15E Strike Eagle	McDonnell Douglas F-15E Strike Eagle
ເຂດພິເສດໄຊສົມບູນ	Сайсомбун
ຄອບ-ດັກລາສ	Функция Кобба — Дугласа
ເສດຖະສາດສະຫວັດດີການ	Экономика благосостояния
ອານາຈັກລ້ານຊ້າງ	Лансанг
VietJet Air	VietJet Air
ຮູບສອງແຈ	Двуугольник
ອານາຈັກສຸໂຂໄທ	Сукхотаи (царство)
ຊີເກມສ໌	Игры Юго-Восточной Азии
ຊ່ວຍເຫຼືອ:ເນື້ອໃນ	Википедия:Справка
ຂົວມິດຕະພາບ ລາວ-ໄທ ແຫ່ງທຳອິດ	Мост тайско-лаосской дружбы
ຊຸດໂຣບົດ	Экзоскелет
ແຂວງຫຼວງນໍ້າທາ	Луангнамтха (провинция)
ນ້ຳອູ	У (река)
ເຄື່ອງເຮັດເຂົ້າຈີ່	Хлебопечка
ທ່າແຂກ	Тхакхэк
ຊຽງຕຸງ	Чёнгтун
ລົດຮັບສົ່ງເດີ່ນຍົນ	Перронный автобус
ຮັກຕ່າງເພດ	Гетеросексуальность
ຕົ້ມຍຳ	Том ям
ក	Кхмерское письмо
ອານາຈັກລ້ານນາ	Ланна
ພະລັງງານຂັ້ນຕົ້ນ	Первичная энергия
ພະທາດຫຼວງ	Пха Тхатлуанг
ຮູບໜຶ່ງແຈ	Одноугольник
ຊີເກມສ໌ ‍2009	Игры Юго-Восточной Азии 2009
ກິເລດ	Клеша
ຕຳບົນ	Тамбон
ອານາຈັກທົນບຸລີ	Тхонбури (королевство)
ການວິໄຈການຕະຫລາດ	Маркетинговое исследование
ຫຼັກເກນ ເຮັກເຊີ=ໂອລີນ	Теория Хекшера — Олина
ການຄາດຫວັງແບບດັດສົມ	Теория адаптивных ожиданий
ສະພາແຫ່ງຊາດ	Парламент Лаоса
ພິດຕີ້ຄຽວ	Pretty Cure
ໂຣບົດທະຫານ	Боевой робот
ຈຳນວນປົກກະຕິ	Рациональное число
ເດີ່ນຍົນ	Аэропорт
ຂົວມິດຕະພາບລາວ-ໄທ ແຫ່ງທີ 3	Третий мост тайско-лаосской дружбы
ລະບອບການປົກຄອງ	Форма государственного правления
ພຣະໄຕປິດົກ	Трипитака
​Vishnu Purana​	Вишну-пурана
ຄວາມຂາດແຄນທາງເສດຖະກິດ	Товарный дефицит
ກີ່ຄິດໄລ່ Jacquard	Жаккардовый ткацкий станок
ເນື້ອທີ່ໜ້າພຽງ	Площадь поверхности
ໝວດ:ປະເທດເຢັຽລະມັນ	Категория:Германия
ໝວດ:ສະຫະລັດອາເມລິກາ	Категория:США
ໝວດ:ປະເທດການາດາ	Категория:Канада
ໝວດ:ສະຫະລາຊະອານາຈັກ	Категория:Великобритания
ໝວດ:ປະເທດແອສະປາຍ	Категория:Испания
ໝວດ:ປະເທດຍີ່ປຸ່ນ	Категория:Япония
ຈຸດແລກປ່ຽນທາງອິນເຕີຣ໌ເນັຕ	Точка обмена интернет-трафиком
ເສດຖະປະຫວັດສາດ	Клиометрика
ຫໍພະແກ້ວ	Хо Пха Кео
ປະຕູໄຊ	Триумфальная арка Патусай
ໝວດ:ປະເທດເກົາຫຼີໃຕ້	Категория:Южная Корея
ໝວດ:ປະເທດໄທ	Категория:Таиланд
ໝວດ:ປະເທດຫວຽດນາມ	Категория:Вьетнам
ໝວດ:ສັດລ້ຽງລູກດ້ວຍນ້ຳນົມ	Категория:Млекопитающие
ໝວດ:ພືດ	Категория:Растения
ໝວດ:ວັດຖຸວິທະຍາ	Категория:Физика
ໝວດ:ຊີວະສາດ	Категория:Биология
ໝວດ:ປະຫວັດສາດ	Категория:История
ໝວດ:ພູມສາດ	Категория:География
ໝວດ:ສັງຄົມ	Категория:Общество
ໝວດ:ສາສະໜາ	Категория:Религия
ໝວດ:ກິລາ	Категория:Спорт
ໝວດ:ສາດ	Категория:Наука
ໝວດ:ສະຫະປະຊາຊາດ	Категория:ООН
ໝວດ:ມໍລະດົກໂລກ	Категория:Всемирное наследие
ໝວດ:ໂລກ	Категория:Земля
ໝວດ:ອາວະກາດ	Категория:Космос
ໝວດ:ຂໍ້ມູນຂ່າວສານ	Категория:Информация
ລາຍໄດ້	Доход
ໂມເດລຄວາມດຶງດູດການຄ້າ	Гравитационная модель
ພາສາທີວີ	Тиви (язык)
ໄອຊິກ	Международная стандартная отраслевая классификация
Airbus A318	Airbus A318
ຍອດຄວາມຕ້ອງການ	Совокупный спрос
ອັກສອນລາວ	Лаосское письмо
ອຸໂບສົດ	Убосот
ໝວດ:ນິເວດສາດ	Категория:Экология
ຊາດຊາຍ ຊ່ຽວນ້ອຍ	Чионой, Чарчай
ໝວດ:ພຸດທະສາສະໜາ	Категория:Буддизм
ໝວດ:ຄຣິສຕະສາດສະໜາ	Категория:Христианство
ໝວດ:ສາສະໜາອິສະລາມ	Категория:Ислам
ລວມຕຳລາຄະນິດສາດ	Проект:Математика/Списки/Список математических функций
ການຂາຍເມຍໃນປະເທດອັງກິດ	Продажа жены в Англии
ເມືອງວຽງໄຊ	Пещеры Вьенгсай
ໂພຊະນາການ	Диетология
ແຂວງບໍລິຄຳໄຊ	Боликхамсай
ສິນຄ້າ (ທຸລະກິດ)	Продукт (бизнес)
ລັດອິດສະລາມອີຣັກແລະເຣເວນທ໌	Исламское государство Ирака и Леванта
ລື້	Лы (народ)
ການທ່ອງທ່ຽວໃນປະເທດລາວ	Туризм в Лаосе
ການຄົມມະນາຄົມໃນປະເທດລາວ	Транспорт в Лаосе
ພະມະຫາກະສັດໄທ	Короли Сиама
ວັດຊຽງທອງ	Ват Сиенг Тхонг
ຄ່າສະເຫຼ່ຍ	Среднее значение
ການຈັດການ	Менеджмент
ໝວດ:ວັດທະນະທຳ	Категория:Культура
ໝວດ:ຄວາມຮູ້	Категория:Знание
ໝວດ:ທະວີບ	Категория:Континенты
ໝວດ:ທໍລະນີສາດ	Категория:Геология
ໝວດ:ພາສາ: ເຮືອບິນ	Категория:Воздушные суда
ຮູດີສ	Хуситы
ສະບາຍດີ ຫລວງພະບາງ	Сабади Луангпрабанг
ລະດູຝົນ	Сезон дождей
ຕົ້ມດອກໄຂ່	Даньхуатан
ອອກໂຕດົກ	Православие
ວົງຍ່ອຍສິງທະເລ	Морские львы
ພາສາພວນ	Пхуанский язык
ໝວດ:ນັກສະແດງ	Категория:Актёры
ແມ່ແບບ:Tl	Шаблон:Tl
ແມ່ແບບ:Wikipedialang	Шаблон:Wikipedialang
ໝວດ:ປະເທດ	Категория:Страны
ໝວດ:ເສດຖະສາດ	Категория:Экономика
ວິກິພີເດຍ:ຜູ້ບໍລິຫານ	Википедия:Администраторы
ໝວດ:ອາຊີບ	Категория:Профессии
ໝວດ:ເວລາ	Категория:Время
ໝວດ:ທຳມະຊາດ	Категория:Природа
ໝວດ:ອິນເຕີເນັດ	Категория:Интернет
ໝວດ:ວັດສະດຸ	Категория:Материалы
ໝວດ:ແພດສາດ	Категория:Медицина
​Brahma Sampradaya​	Брахма-сампрадая
ໝວດ:ການເມືອງ	Категория:Политика
ໝວດ:ການສຶກສາ	Категория:Образование
ໝວດ:ສິລະປະ	Категория:Искусство
ໝວດ:ຊອຟແວ	Категория:Программное обеспечение
ລາຍຊື່ພາສາຄອມພິວເຕີຕາມເຄົ້າ	Генеалогический список языков программирования
​Kumara Sampradaya​	Нимбарка-сампрадая
ก	Кокай
ກ	Кокай (лаосский)
ແມ່ແບບ:Bot	Шаблон:Bot
ອັກສອນມອນ	Монское письмо
ປະເທດການາດາ	Канада
ໝວດ:ບົດຄວາມດີເດັ່ນ	Категория:Википедия:Избранные статьи
ຄວາມຕ້ອງການ (ເສດຖະສາດ)	Платёжеспособный спрос
ໂຕທຳລາວ	Туа-тхам
ທາດດຳ	Тхат Дам
ເກມຄອມພິວເຕີ	PC-игра
ຜົນປະໂຫຍດ (ເສດຖະສາດ)	Функция полезности
ແມ່ແບບ:Flagicon	Шаблон:Флаг
ໝວດ:ເອີລົບ	Категория:Европа
ໝວດ:ພາສາ: ຫຼັກການແບ່ງປະເພດຫົວຂໍ້	Категория:Классификация по главным темам
ແມ່ແບບ:ຄູ່ມືການໃຊ້ງານ	Шаблон:Doc
ໝວດ:ຜູ້ໃຊ້ແບ່ງຕາມພາສາ	Категория:Википедия:Участники по языкам
ວິກິພີເດຍ:ຫ້າຫຼັກການ	Википедия:Пять столпов
ໝວດ:ແນວປະຕິບັດວິກິພີເດຍ	Категория:Википедия:Руководства
ວິກິພີເດຍ:ກ່ອງຜູ້ໃຊ້	Википедия:Юзербоксы
ຊໂງ ໃຈ-ກກິ	Сон Джэги
ທຸລະກິດ	Предпринимательство
ແມ່ແບບ:Softredirect	Шаблон:Soft redirect
ແມ່ແບບ:ລຶບ	Шаблон:К быстрому удалению
ໝວດ:ພາສາ: ເຕັກໂນໂລຊີ	Категория:Технология
ສວນເສືອສີລາຊາ	Тигровый зоопарк Сирача
ໝວດ:ພັນທຸສາດ	Категория:Генетика
ໝວດ:ພາສາ	Категория:Языки
ໝວດ:ໄວຍາກອນ	Категория:Грамматика
ໝວດ:ປະຕິທິນ	Категория:Календарь
ໝວດ:ວິກິພີເດຍ	Категория:Википедия
ວິກິພີເດຍ:ຂໍ້ປະຕິເສດຄວາມຮັບຜິດຊອບ	Википедия:Отказ от ответственности
ໝວດ:Pages with broken file links	Категория:Страницы со ссылками на отсутствующие файлы
ແມ່ແບບ:Navbox	Шаблон:Navbox
ໜູຖົງ	Кенгуру
ໝວດ:ພາສາໝາຍ	Категория:Языки разметки
ໝວດ:ການບຳລຸງຮັກສາວິກິພີເດຍ	Категория:Википедия:Статьи для улучшения
ໝວດ:ຄອມພິວເຕີ	Категория:Цифровые вычисления
ໝວດ:ແມ່ແບບທຸງ	Категория:Шаблоны:Флаги
ແມ່ແບບ:!-	Шаблон:!-
ແມ່ແບບ:Tnavbar	Шаблон:Tnavbar
ແມ່ແບບ:Fontie	Шаблон:Unicode
ແມ່ແບບ:Clear	Шаблон:Clear
ແມ່ແບບ:Col-begin	Шаблон:Столбцы
ແມ່ແບບ:Col-end	Шаблон:Столбцы/конец
ໝວດ:ອາຟຣິກກາ	Категория:Африка
ໝວດ:ປຶ້ມ	Категория:Книги
ແມ່ແບບ:ບາເບລ	Шаблон:Babel
ແມ່ແບບ:Commons	Шаблон:Commons
ແມ່ແບບ:Reflist	Шаблон:Примечания
ວິກິພີເດຍ:ການອ້າງອີງແຫຼ່ງທີ່ມາ	Википедия:Ссылки на источники
ວິກິພີເດຍ:ຊອກຫາ	Википедия:Поиск
ແມ່ແບບ:Stub	Шаблон:Заготовка
ແມ່ແບບ:User eo-1	Шаблон:User eo-1
ແມ່ແບບ:User de	Шаблон:User de
ແມ່ແບບ:User de-1	Шаблон:User de-1
ແມ່ແບບ:User es	Шаблон:User es
ແມ່ແບບ:User de-3	Шаблон:User de-3
ແມ່ແບບ:User en-3	Шаблон:User en-3
ແມ່ແບບ:User en-1	Шаблон:User en-1
ແມ່ແບບ:User en-2	Шаблон:User en-2
ແມ່ແບບ:User en-4	Шаблон:User en-4
ແມ່ແບບ:User en	Шаблон:User en
ແມ່ແບບ:User de-2	Шаблон:User de-2
ແມ່ແບບ:User fr-1	Шаблон:User fr-1
ແມ່ແບບ:User ja-4	Шаблон:User ja-4
ແມ່ແບບ:User ja	Шаблон:User ja
ແມ່ແບບ:User ja-1	Шаблон:User ja-1
ແມ່ແບບ:User fr	Шаблон:User fr
ໝວດ:ອາຊີ	Категория:Азия
ແມ່ແບບ:Esoteric	Шаблон:Эзотерика
ໝວດ:ປະເທດມາເລເຊຍ	Категория:Малайзия
ແມ່ແບບ:Lang-ja	Шаблон:Lang-ja
ແມ່ແບບ:Mod	Шаблон:Mod
ແມ່ແບບ:User es-2	Шаблон:User es-2
ແມ່ແບບ:ຍິນດີຕ້ອນຮັບ	Шаблон:Приветствие
ແມ່ແບບ:Sisterprojects	Шаблон:Сообщество Википедии
ໝວດ:ດວງຈັນ	Категория:Луна
ແມ່ແບບ:USA	Шаблон:USA
ແມ່ແບບ:Country data Thailand	Шаблон:Флагификация/Таиланд
ແມ່ແບບ:Country data Indonesia	Шаблон:Флагификация/Индонезия
ແມ່ແບບ:Country data Cambodia	Шаблон:Флагификация/Камбоджа
ໝວດ:ພາສາສາດ	Категория:Лингвистика
ແມ່ແບບ:Wikiatlas	Шаблон:Wikiatlas
ໝວດ:User fr-1	Категория:User fr-1
ແມ່ແບບ:Image label	Шаблон:Метка изображения
ແມ່ແບບ:Country data Brunei	Шаблон:Флагификация/Бруней
ໝວດ:ແມວ	Категория:Кошки
ໝວດ:ນາຊີ	Категория:Нацисты
ແມ່ແບບ:Sidebar	Шаблон:Боковая навигационная таблица
ແມ່ແບບ:Country data France	Шаблон:Флагификация/Франция
ແມ່ແບບ:ປັບປຸງການອ້າງອີງ	Шаблон:Refimprove
ແມ່ແບບ:ກ່ອງຜູ້ໃຊ້ລຸ່ມ	Участник:Box/Конец колонки
ແມ່ແບບ:ຂໍ້ມູນປະເທດ	Шаблон:Государство
ແມ່ແບບ:Country data Laos	Шаблон:Флагификация/Лаос
ແມ່ແບບ:Px	Шаблон:Px
ແມ່ແບບ:ກ່ອງຜູ້ໃຊ້ເທິງ	Участник:Box
ແມ່ແບບ:Infobox Political party	Шаблон:Партия
ແມ່ແບບ:ກ່ອງຂ້ໍມູນ ປະຊາຄົມອາຊຽນ	Шаблон:Навигационная таблица с колонками
ແມ່ແບບ:ກ່ອງຂໍ້ມູນ ນັກມວຢ	Шаблон:Боксёр
ແມ່ແບບ:Infobox ບໍລິສັດ	Шаблон:Карточка компании
ແມ່ແບບ:Country data Vietnam	Шаблон:Флагификация/Вьетнам
ແມ່ແບບ:ປ້າຍບົດຄວາມດີເດັ່ນ	Шаблон:Избранная статья
ໝວດ:ປາລີ	Категория:Париж
ໝວດ:User en	Категория:User en
ໝວດ:User zh	Категория:User zh
ໝວດ:User en-2	Категория:User en-2
ແມ່ແບບ:Infobox	Шаблон:Карточка
ແມ່ແບບ:User zh	Шаблон:User zh
ໝວດ:ອັກສອນ	Категория:Алфавиты
ແມ່ແບບ:Navbox/core	Шаблон:Navbox/core
ແມ່ແບບ:Template other	Шаблон:Template other
ໝວດ:ພາສາ: ບິນ	Категория:Авиация
ໝວດ:ຄຳແລະວະລີ	Категория:Слова и выражения
ໝວດ:ອາຫານແລະເຄື່ອງດື່ມ	Категория:Еда и напитки
ແມ່ແບບ:Pp-template	MediaWiki:Protectedpagetext
ແມ່ແບບ:Infobox City Poland	Шаблон:НП-Польша
ແມ່ແບບ:ວິກິວັດຈະນານຸກົມ	Шаблон:Викисловарь
ແມ່ແບບ:Languageicon	Шаблон:Ref-lang
ແມ່ແບບ:Babel-4	Шаблон:Babel-4
ແມ່ແບບ:User ru	Шаблон:User ru
ໝວດ:ອະເມລິກາ	Категория:Америка
ໝວດ:ເຂົ້າຈີ່	Категория:Хлеб
ແມ່ແບບ:ກັບສາງ	Шаблон:Архив
ແມ່ແບບ:Sisterlinks	Шаблон:Навигация
ແມ່ແບບ:Border	Шаблон:Граница
ແມ່ແບບ:Fmbox	Шаблон:Fmbox
ໝວດ:ພາສາທະຫານ	Категория:Вооружённые силы
ແມ່ແບບ:Country data Philippines	Шаблон:Флагификация/Филиппины
ແມ່ແບບ:Country data Malaysia	Шаблон:Флагификация/Малайзия
ແມ່ແບບ:Country data Myanmar	Шаблон:Флагификация/Мьянма
ແມ່ແບບ:Increase	Шаблон:Рост
ແມ່ແບບ:Image label end	Шаблон:Image label end
ແມ່ແບບ:CAN	Шаблон:CAN
ໝວດ:ຄຳສັບ	Категория:Лексика
ແມ່ແບບ:Lang-my	Шаблон:Lang-my
ໝວດ:ຄຳ	Категория:Статьи о словах
ແມ່ແບບ:ກ່ອງຜູ້ໃຊ້ຄັ່ນ	Участник:Box/Разрыв колонки
ໝວດ:ແຫຼ່ງນ້ຳ	Категория:Водоёмы
ແມ່ແບບ:ຕ້ອງການອ້າງອີງ	Шаблон:Нет ссылок
ໝວດ:ສະໜາມບິນໃນຫວຽດນາມ	Категория:Аэропорты Вьетнама
ແມ່ແບບ:Image label small	Шаблон:Image label small
ໝວດ:ພະມະຫາກະສັດອັງກິດ	Категория:Короли Англии
ໝວດ:ສານອາຫານ	Категория:Питательные вещества
ແມ່ແບບ:SUL Box	Участник:Box/Пользователь SUL
ໝວດ:ໂທລະສັບມືຖື	Категория:Сотовые телефоны
ໝວດ:ພາສາ: ເຮືອບິນທະຫານ	Категория:Военные самолёты
ແມ່ແບບ:Lang-en	Шаблон:Lang-en
ໝວດ:ເນີຍແຂງ	Категория:Сыры
ແມ່ແບບ:UK	Шаблон:GBR
ໝວດ:ສະຖາປັດຕະຍະກຳ	Категория:Архитектура
ໝວດ:ລົດໄຟ	Категория:Железнодорожный транспорт
ແມ່ແບບ:Interwiki	Шаблон:Языковой раздел
ແມ່ແບບ:MainPageInterwikis	Шаблон:Интервики на заглавной
ໝວດ:ໂພຊະນາການ	Категория:Питание
ແມ່ແບບ:ບໍ່ເປັນກາງ	Шаблон:Проверить нейтральность
ແມ່ແບບ:Dmoz	Шаблон:Dmoz
ໝວດ:ເມືອງໃນແຂວງເກແບັກ	Категория:Города Квебека
ໝວດ:User eo	Категория:User eo
ໝວດ:User fr	Категория:User fr
ໝວດ:User ja	Категория:User ja
ໝວດ:User th	Категория:User th
ໝວດ:User ja-2	Категория:User ja-2
ໝວດ:User fr-N	Категория:User fr-N
ໝວດ:ແມ່ນ້ຳອາມາຊົນ	Категория:Амазонка
ໝວດ:ແຂວງກວາງບິນ	Категория:Куангбинь
ໝວດ:User en-3	Категория:User en-3
ໝວດ:User en-N	Категория:User en-N
ໝວດ:User eo-1	Категория:User eo-1
ໝວດ:User es	Категория:User es
ແມ່ແບບ:EU	Шаблон:Евросоюз
ໝວດ:User es-2	Категория:User es-2
ໝວດ:User es-3	Категория:User es-3
ນິກາຍອັງກະລິກັງ	Англиканство
ແມ່ແບບ:Country data United Kingdom	Шаблон:Флагификация/Великобритания
ແມ່ແບບ:Cite encyclopedia	Шаблон:Cite encyclopedia
ໝວດ:ເວັບໄຊຕ໌	Категория:Сайты
ໝວດ:User ko	Категория:User ko
ໝວດ:User ko-1	Категория:User ko-1
ໝວດ:ຫົວໜ່ວຍການປົກຄອງ	Категория:Административное деление
ໝວດ:ພາສາວັນນະຍຸດ	Категория:Тоновые языки
ໝວດ:ເມືອງໃນປະເທດຝະລັ່ງ	Категория:Города Франции
ໝວດ:ວັນນະຄະດີເດັກນ້ອຍ	Категория:Детская литература
ແມ່ແບບ:ພາສາທາງການຂອງສະຫະປະຊາຊາດ	Шаблон:Официальные языки ООН
ໝວດ:ອຸບປະກອນເຂົ້າອອກ	Категория:Устройства ввода
ແມ່ແບບ:ຮູບຫຼາຍແຈ	Шаблон:Многоугольники
ໝວດ:ທະເລ	Категория:Моря
ໝວດ:ປະເທດອັງກິດ	Категория:Англия
ໝວດ:ນັກສະແດງແບ່ງຕາມສັນຊາດ	Категория:Актёры по странам
ໝວດ:ລະບົບສຸລິຍະ	Категория:Солнечная система
ແມ່ແບບ:ຮູບແບບແຫ່ງລັດ	Шаблон:Формы правления
ໝວດ:ອຸດສາຫະກຳ	Категория:Промышленность
ໝວດ:ນ້ຳ	Категория:Вода
ໝວດ:ສັດກິນຊີ້ນ	Категория:Хищные
ໝວດ:ແຂວງ	Категория:Провинции Лаоса
ໝວດ:ຟີລຳ	Категория:Типы и отделы
ໝວດ:ເຮລີກົບແຕ	Категория:Вертолёты
ໝວດ:ນາຍົກລັດຖະມົນຕີ	Категория:Премьер-министры
ໝວດ:ນັກຮ້ອງການາດາ	Категория:Певцы и певицы Канады
ແມ່ແບບ:User cs	Шаблон:User cs
ແມ່ແບບ:User es-3	Шаблон:User es-3
ໝວດ:User ru	Категория:User ru
ໝວດ:User ru-3	Категория:User ru-3
ໝວດ:User th-N	Категория:User th-N
ແມ່ແບບ:Lang	Шаблон:Lang
ໝວດ:ສາຂາວິຊາວິທະຍາສາດ	Категория:Науки по группам
ໝວດ:ຊາວພະມ້າ	Категория:Персоналии:Мьянма
ໝວດ:ມະນຸດ	Категория:Человек
ໝວດ:ພາສາ: ບົດຄວາມ	Категория:Статьи
ແມ່ແບບ:ບົດຄວາມຫຼັກ	Шаблон:Main
ໝວດ:ວັນນະຄະດີແບ່ງຕາມປະເພດ	Категория:Литературные произведения по жанрам
ແມ່ແບບ:ໃຜກ່າວ	Шаблон:Кто
ໝວດ:ວົງເສືອແລະແມວ	Категория:Кошачьи
ໝວດ:ແມ່ນ້ຳແບ່ງຕາມປະເທດ	Категория:Реки по странам
ໝວດ:ສະກຸນເງິນ	Категория:Валюты
ໝວດ:ແມ່ນ້ຳ	Категория:Реки
ໝວດ:ແມ່ນ້ຳໃນປະເທດບະເລຊິນ	Категория:Реки Бразилии
ໝວດ:ແມ່ນ້ຳໃນປະເທດເປລູ	Категория:Реки Перу
ໝວດ:ນັກຮ້ອງແບ່ງຕາມສັນຊາດ	Категория:Певцы и певицы по странам
ໝວດ:ນ້ຳມັນ	Категория:Масла
ໝວດ:User zh-1	Категория:User zh-1
ໝວດ:User zh-3	Категория:User zh-3
ໝວດ:ພະມະຫາກະສັດໄທ	Категория:Короли Таиланда
ໝວດ:ຊັບສິນທາງປັນຍາ	Категория:Право интеллектуальной собственности
ໝວດ:ນັກສະແດງຈີນ	Категория:Актёры Китая
ໝວດ:ນັກສະແດງໄທ	Категория:Актёры Таиланда
ໝວດ:ນາຍົກລັດຖະມົນຕີເຢຍລະມັນ	Категория:Главы правительств Германии
ໝວດ:ປະທານປະເທດລາວ	Категория:Президенты Лаоса
ໝວດ:ຈັງຫວັດໃນປະເທດໄທ	Категория:Провинции Таиланда
ໝວດ:ຊາວໄທ	Категория:Персоналии:Таиланд
ໝວດ:ນັກຮ້ອງຈີນ	Категория:Певцы и певицы Китая
ໝວດ:ນິກາຍໃນສາສະໜາຄິດ	Категория:Христианские конфессии
ໝວດ:ມໍລະດົກໂລກແບ່ງຕາມປະເທດ	Категория:Всемирное наследие по странам
ໝວດ:ແມ່ນ້ຳໃນປະເທດໂກລົມບີ	Категория:Реки Колумбии
ໝວດ:ປະເທດລາວ	Категория:Лаос
ໝວດ:ຜັກ	Категория:Овощи
ໝວດ:ໝາກໄມ້	Категория:Фрукты
ໝວດ:ພາສາໃນປະເທດລາວ	Категория:Языки Лаоса
ໝວດ:ພາສາຄອມພິວເຕີ	Категория:Компьютерные языки
ໝວດ:ພາສາລາວ	Категория:Лаосский язык
ໝວດ:ພາສາລາແຕັງ	Категория:Латинский язык
ໝວດ:ມໍລະດົກໂລກໃນປະເທດຝະລັ່ງ	Категория:Всемирное наследие во Франции
ໝວດ:ມະຫາສະໝຸດ	Категория:Океаны
ໝວດ:ມະນຸດສາດ	Категория:Антропология
ໝວດ:ລົດສະນິຍົມທາງເພດ	Категория:Сексуальная ориентация
ໝວດ:ລະບົບປະຕິບັດການ	Категория:Операционные системы
ໝວດ:ລະດູ	Категория:Времена года
ໝວດ:ແຮ່ທາດສາດ	Категория:Минералогия
ໝວດ:ວິວັດທະນາການ	Категория:Эволюция
ໝວດ:ສັດ	Категория:Животные
ໝວດ:ສັດທະສາດ	Категория:Фонетика
ໝວດ:ສະເຕໂລອິດ	Категория:Стероиды
ໝວດ:ອົງການລະຫວ່າງລັດຖະບານ	Категория:Международные межправительственные организации
ໝວດ:ປະໂລເຕອິນ	Категория:Белки
ໝວດ:ເຄື່ອງໝາຍວັກ	Категория:Пунктуация
ໝວດ:ເພງ	Категория:Песни
ໝວດ:ເພດສຶກສາ	Категория:Половое просвещение
ໝວດ:ນະຄອນຫຼວງ	Категория:Столицы государств
ໝວດ:ເມືອງໃນລາວ	Категория:Города Лаоса
ໝວດ:ເອດສ໌	Категория:ВИЧ-инфекция
ໝວດ:ອາຊີຕາເວັນອອກສຽງໃຕ້	Категория:Юго-Восточная Азия
ໝວດ:ໄດໂນເສົາ	Категория:Динозавры
ໝວດ:ກຸ່ມພາສາໂລມັງ	Категория:Романские языки
ໝວດ:ພາສາ: ການຂົນສົ່ງ	Категория:Транспорт
ໝວດ:ການຟ້ອນລຳ	Категория:Танец
ໝວດ:ກະລູຊິດ	Категория:Углеводы
ໝວດ:ປະເພດຄຳເວົ້າ	Категория:Части речи
ໝວດ:ນັກເສດຖະສາດ	Категория:Экономисты
ແມ່ແບບ:Flagcountry	Шаблон:Флагификация
ແມ່ແບບ:ກ່ອງຂໍ້ມູນ ພາສາ	Шаблон:Язык
ໝວດ:ພືດທີ່ກິນໄດ້	Категория:Пищевые растения
ໝວດ:ກາເຟ	Категория:Кофе
ໝວດ:ພາສາອິຕາລີ	Категория:Итальянский язык
ໝວດ:ພາສາແອສະປາໂຍນ	Категория:Испанский язык
ໝວດ:ພາສາໃນປະເທດໄທ	Категория:Языки Таиланда
ໝວດ:ແຊນ	Категория:Гены
ໝວດ:ຍານພາຫະນະ	Категория:Транспортные средства
ໝວດ:ລົດ	Категория:Автомобиль
ໝວດ:Tanks	Категория:Танки
ໝວດ:ພາສາໃນປະເທດຫວຽດນາມ	Категория:Языки Вьетнама
ໝວດ:ອາຫານຝະລັ່ງ	Категория:Французская кухня
ໝວດ:ເນີຍແຂງຝະລັ່ງ	Категория:Французские сыры
ໝວດ:ເນີຍແຂງຟ້າແກ່	Категория:Голубые сыры
ການບໍລິການ	Услуга
ໝວດ:ສະໄໝກາງ	Категория:Средние века
ແມ່ແບບ:Wikia	Шаблон:Wikia
ໝວດ:ສຸຂະພາບ	Категория:Здоровье
ແມ່ແບບ:Country data Quebec	Шаблон:Флагификация/Квебек
ແມ່ແບບ:Country data Singapore	Шаблон:Флагификация/Сингапур
ແມ່ແບບ:G8	Шаблон:G8
ແມ່ແບບ:User wa	Шаблон:User wa
ໝວດ:ເສດຖະສາດມະຫາພາກ	Категория:Макроэкономика
ໝວດ:ຄຳກຳມະ	Категория:Глагол
ໝວດ:ພາສາ:ສາຍການບິນ	Категория:Пассажирские самолёты
ໝວດ:ແຂວງເກແບັກ	Категория:Квебек
ໝວດ:ພາສາປືນໃຫຍ່	Категория:Артиллерия
ໝວດ:ຂົວ	Категория:Мосты
ໝວດ:ພາສາກາຕາລັງ	Категория:Каталанский язык
ສິດທິເດັກ	Права ребёнка
ໝວດ:ເອແດມບວກ	Категория:Эдинбург
ໝວດ:ຮາດແວ	Категория:Компьютерное аппаратное обеспечение
ໝວດ:ພະລັງງານ	Категория:Энергия
ໝວດ:ລິກຂະສິດ	Категория:Авторское право
ໝວດ:ພາສາຝະລັ່ງ	Категория:Французский язык
ໝວດ:ຫຼັກ້ຮົບ tanks	Категория:Основные боевые танки
ຊ່ວຍເຫຼືອ:ເຈ້ຍກ່າຍ	Википедия:Шпаргалка
ໝວດ:ເຮືອບິນຄູຝຶກທະຫານ	Категория:Учебные самолёты
ໝວດ:ຫຸ່ນຍົນສາດ	Категория:Робототехника
ໝວດ:ໂຣບົດ	Категория:Роботы
ໝວດ:ພາສາລູມານີ	Категория:Румынский язык
ໝວດ:ພາສາອົກຊີຕັງ	Категория:Окситанский язык
ໝວດ:ສັດມີແກນສັນຫຼັງ	Категория:Хордовые
ໝວດ:ເມືອງໃນປະເທດລາວ	Категория:Населённые пункты Лаоса
ໝວດ:ມົງເລອານ	Категория:Монреаль
ໝວດ:ໂທລະສັບ	Категория:Телефония
ໝວດ:ໜ່ວຍນັບເວລາ	Категория:Единицы измерения времени
ໝວດ:ວິທະຍາສາດປະຍຸກ	Категория:Прикладные науки
ໝວດ:ທາດ	Категория:Пагоды
ແມ່ແບບ:Image label begin	Шаблон:Image label begin
ໝວດ:ພາສາກໍາລັງທາງອາກາດ	Категория:Военно-воздушные силы
ໝວດ:ໂຣບົດທະຫານ	Категория:Боевые роботы
ໝວດ:User en-1	Категория:User en-1
ໝວດ:ນັກສະແດງອາເມລິກັນ	Категория:Актёры США
ໝວດ:ບົດຄວາມຕ້ອງຂະຫຍາຍ	Категория:Википедия:Статьи с незавершёнными разделами
ປະເທດໂມນດາວີ	Молдавское княжество
ແມ່ແບບ:Infobox file format	Шаблон:Файловый формат
ເຫດຍົນຕົກທີ່ປາກເຊ	Катастрофа ATR 72 под Паксе
ຮຳຊະ	Хамса (амулет)
ພິເສດ:ການດັດແກ້ຫຼ້າສຸດ	Служебная:Свежие правки
Module:Coordinates	Модуль:Coordinates
ສາຍການບິນມາເລເຊຍທຽ່ວບິນMH370	Рейс 370 Malaysia Airlines
ອຸປະຕິເຫດເຮືອເຊໂວລຫລົ່ມ	Крушение парома «Севоль»
