Naakaii Łizhiní Bikéyah	Африка
Binaʼadaałtzózí Dinéʼiʼ Bikéyah	Япония
Bitsiighaʼ Łichííʼí Bikéyah	Ирландия
Hángewii	Венгрия
Dibé Diníí Bikéyah	Испания
Wááshindoon Bikéyah Ałhidadiidzooígíí	Соединённые Штаты Америки
Bélgii Bikéyah	Бельгия
Látsębooʼ	Люксембург
Yágháhookáán	Вселенная
Nahasdzáán	Земля
Nahoditsʼǫʼłání	Финляндия
Déinish Dineʼé Bikéyah	Дания
Póolish Dineʼé Bikéyah	Польша
Łitʼoowę́ęya	Литва
Ídelii	Италия
Swis Bikéyah	Швейцария
Óóswiya	Австрия
Gwíík Dineʼé Bikéyah	Греция
Tʼóok Bikéyah	Турция
Béésh Bichʼahníí Bikéyah	Европа
(*"asia")	Азия
Shádiʼááhjí kéyah yistinígíí	Антарктида
Kéyah Wóyahgo Siʼánígíí	Нидерланды
Béésh bee akʼeʼelchíhí tʼáá bí nitsékeesígíí	Компьютер
Hastiin alą́ąjįʼ dahsidáhígíí Barack Obama	Обама, Барак
Táłtłʼááh Chʼosh Bitooh (Kéyah Dah Siʼánígíí)	Уругвай
Bilasáana	Яблоко
Méhigo	Мексика
Akééháshį́į́h Hahoodzo	Калифорния
Máaz	Марс
Kénya	Кения
Iithiyópya	Эфиопия
Gáana	Гана
Náshdóítsoh bitsiijįʼ daditłʼooígíí	Лев
Dáághahii Dinéʼiʼ Bikéyah	Франция
Łééchąąʼí	Собака
Tótaʼ Dinéʼiʼ Bikéyah	Великобритания
Mósí	Кошка
Dáághahii bizaad	Французский язык
Łóóʼ	Рыбы
Bwazííl	Бразилия
Biʼééʼ Łichííʼí Bikéyah	Россия
Łóóʼtsoh dóó Tééh hóyáanii	Китообразные
Naakaii bichʼil łitsxooí	Манго (фрукт)
Élábéemah Hahoodzo	Алабама
Béésh Bichʼahii Bikéyah	Германия
Bééshbichʼahii bizaad	Немецкий язык
Tin Bikéyah	Исландия
Ééstii Bikéyah	Эстония
Séetin	Сатурн
Didzéchííʼ	Вишня (плод)
Chidí naatʼaʼí	Самолёт
Hastiin alą́ąjįʼ dahsidáhígíí George W. Bush	Буш, Джордж Уокер
Létbiiya	Латвия
Yóókwein	Украина
Chek Bikéyah	Чехия
Słóbaʼ Bikéyah	Словакия
Słobíín Bikéyah	Словения
Wooméiniya	Румыния
Bálgaa Bikéyah	Болгария
Dziłigaii Bikéyah	Албания
Haʼaʼaahjí Hakʼaz Dineʼé Bikéyah	Гренландия (административная единица)
Kwóóʼad Bikéyah	Хорватия
Bosna dóó Hetsog Bikéyah	Босния и Герцеговина
Azééwii Bikéyah	Азербайджан
Andówa	Андорра
Béésh Łichíiʼii Bikéyah	Республика Кипр
Jóojah (Kéyah)	Грузия
Kʼazah Bikéyah	Казахстан
Dziłizhin Bikéyah	Черногория
Bádikin Sídii	Ватикан
San Mawínoo Bikéyah	Сан-Марино
Kyóoba	Куба
Hashkʼaan Bikéyah	Барбадос
Indoníízha	Индонезия
Tʼóok bizaad	Турецкий язык
Kéyah Naakai Łizhinii Bikéyah Shádiʼááhjí Siʼánígíí	Южно-Африканская Республика
Aljííya	Алжир
Ózbeʼ Bikéyah	Узбекистан
Tó	Вода
Níłchʼi naalkidí	Телевидение
Chíilii	Чили
Doodaatsaahii (Jíísas)	Иисус Христос
Mókiwii	Меркурий
Ákáʼátʼįįł (béésh ntsékeesígíí álʼíní)	Apple
Biinis	Венера
Jíbitoo	Юпитер
Yoowéinis	Уран (планета)
Néʼtoon	Нептун
Sį́ʼgaboo	Сингапур
Tłóotoo	Плутон
Łííhtensain	Лихтенштейн
Dágháilchįįh	Гитлер, Адольф
Naaltsoos biniiʼ	Facebook
Naaki góneʼ yéigo daʼahijoogą́ą́ʼ	Вторая мировая война
Ałhíʼayiiltááh	Математика
Aooméénii Bikéyah	Армения
Ooljééʼ	Луна
Nahatʼeʼiitsoh Bikéyah	Австралия
Béésh Łigaii Bikéyah	Аргентина
Kolíya Bikéyah Náhookǫsjí Siʼánígíí	Корейская Народно-Демократическая Республика
Naayééʼ	Динозавры
Bilasáana bitseeʼ nineezígíí	Груша
Naturalis Historia of Pliny the Elder	Естественная история (Плиний)
Encyclopædia Britannica	Энциклопедия Британника
Tó yaʼnidaʼaazgééd	Акведук
Chʼil łitsooí díkʼǫ́zhígíí	Лимон
Hashkʼaan (łitsooígíí)	Банан
Sǫʼ	Звезда
Jóhonaaʼéí	Солнце
Háájiʼjin	Водород
Níłchʼi Ászólí	Гелий
Haʼaʼaahjí Tíímow	Восточный Тимор
Séwes	Церера
Haʼooméya	Хаумеа
Maakiimaakii	Макемаке
Ééwis	Эрида
Káábin	Углерод
Níłchʼi Yáʼátʼéehii	Кислород
Hadoh dóó hakʼaz neiłkidígíí	Термометр
Níłchʼi Łitsxooí	Неон
Chihuahua Hahoodzo	Чиуауа
Soodin	Натрий
Béésh Łikoní	Магний
Béésh Ászólí	Алюминий
Tó Wónaanídę́ę́ʼ Bitsįʼ Yishtłizhii Bikéyah	Индия
Tʼoobááloo	Тувалу
Béésh (Fe)	Железо
Tʼónga	Тонга
Łeetsoii	Сера
Samóa	Самоа
Sólomon Tó Bináhaazyínígíí	Соломоновы Острова
Banoʼáátʼoo	Вануату
Páápowa Bigíní Ániidí	Папуа — Новая Гвинея
Níłchʼi Dootłʼizhí	Аргон
Eʼeʼaahjí Tónteel bikáaʼgi Kéyah Yázhí dah Ndaaʼeełgo Ałhidadiidzooígíí	Федеративные Штаты Микронезии
Káálsiiyin	Кальций
Dilyį́hí	Свинец
Kílíbas	Кирибати
Chʼah Diʼilii Bikéyah	Монголия
Fííjii	Фиджи
Béésh doo Ńdiniichxíihii	Титан (элемент)
Táłkááʼ Bighan Dineʼé Bikéyah	Венесуэла
Méíin Hahoodzo	Мэн (штат)
Łį́į́ʼ	Домашняя лошадь
Naaldeehii	Животные
Sówinam	Суринам
Kéyah Nahasdzáán Ałníiʼgi Siʼánígíí	Эквадор
Kolámbiya	Колумбия
Béésh Łibáhí	Кобальт
Bolíbiya	Боливия
Béésh Łichíiʼii	Медь
Niihémpshoo Hahoodzo	Нью-Гэмпшир
Chʼosh doo yitʼíinii dláádí dóó Ábishjaaʼ	Грибы
Jaméíkʼa	Ямайка
Méésíchóoshish Hahoodzo	Массачусетс
Kanédikiʼ Hahoodzo	Коннектикут
Naaʼahóóhai	Курица
Antíígwa dóó Hashkʼaan Bikéyah Yázhí	Антигуа и Барбуда
Kéyah Ałkéé Nitį́įgo Dah Ndaaʼeełí	Гавайи
Damóo Bikéyah	Доминика
Domingo Bikéyah	Доминиканская Республика
Bisóodi	Домашняя свинья
Héítii	Республика Гаити
Iiwą́ą́	Иран
Iiwááʼ	Ирак
Hakʼaz Dineʼé Bikéyah Hahoodzo	Аляска
Ízrel Bikéyah	Израиль
Shádiʼááhjí Ásáí Bikéyah	Йемен
Jóoʼdan	Иордания
Gah Bikeeʼ Taahíʼahí	Флорида
Kíígiz Bikéyah	Киргизия
Hoozdo Hahoodzo	Аризона
Kóóweiʼ	Кувейт
Lááʼos	Лаос
Łíbanoo	Ливан
Óogin Hahoodzo	Орегон
Naakaii Dootłʼizhí Bikéyah Yázhí (Tó Bináhaazyínígíí)	Мальдивы
Kéyah dah siʼánígíí	Америка
Áshįįh Biiʼtó Hahoodzo	Юта
Béégashii	Корова
Maléízha	Малайзия
Dziłgaiitsoh Honeezkʼazii Bikéyah	Непал
Omą́ą́	Оман
Eʼeʼaahjí Naakaii Dootłʼizhí Bikéyah	Пакистан
Kʼatár	Катар
Ásáí Bikéyah Saʼoodí	Саудовская Аравия
Swii Lankʼa	Шри-Ланка
Sííwiya	Сирия
Tʼajiʼ Bikéyah	Таджикистан
Tʼáí Bikéyah	Таиланд
Kǫʼ naʼałbąąsii diné bee nágéhéʼ	Поезд
Tʼóokmen Bikéyah	Туркмения
Ásáí Bikéyah Yázhí Ałhidadiidzooígíí	Объединённые Арабские Эмираты
Biʼednam	Вьетнам
Kolíya Bikéyah Shádiʼááhjí Siʼánígíí	Республика Корея
Óola	Золото
Naʼałkaahí	Учёный
Bangla Bikéyah	Бангладеш
Angóola	Ангола
Iiʼniʼ Tłʼiishtsoh Bikéyah	Бутан
Bwoonéí	Бруней
Tʼanzanííya	Танзания
Béésh Tózháanii	Ртуть
Kéyah Dańlíinii	Филиппины
Naakaii Łizhinii Bikéyah Beʼałnííʼ	Центральноафриканская Республика
Hastiin Albert Einstein	Эйнштейн, Альберт
Tʼóogo	Того
Hooghan Tsé Bee Ádaalyaaí Bikéyah	Зимбабве
Shádiʼááhjí Soodą́ą	Южный Судан
Tswana Dineʼé Bikéyah	Ботсвана
Wóndii Dineʼé Bikéyah	Бурунди
Ooljééʼ Bikéyah Yázhí	Коморы
Kéyah Káango Náhookǫsjí Siʼánígíí	Республика Конго
Kéyah Káango Shádiʼááhjí Siʼánígíí	Демократическая Республика Конго
Jibótii	Джибути
Gíní Nahasdzáán Ałníiʼgi Siʼánígíí	Экваториальная Гвинея
Gabǫ́ǫ́ (Kéyah)	Габон
Géémbiya	Гамбия
Gíní	Гвинея
Gíní Bisó	Гвинея-Бисау
Chį́į́h Yee Adilohii Bideeʼ Tónteel Bibąąh	Кот-д’Ивуар
Táłtłʼááh Chʼosh Daadánígíí Bitooh (Łizhinii Bikéyahdi)	Камерун
Tónteel Bibąąh Dootłʼizhí	Кабо-Верде
Sotho Dineʼé Bikéyah	Лесото
Łíbya	Ливия
Madaʼgéésgáá	Мадагаскар
Malááwii	Малави
Moowitéínya	Мавритания
Moroko	Марокко
Namííbya	Намибия
Yogénda	Уганда
Wánda Dineʼé Bikéyah	Руанда
Seishel	Сейшельские Острова
Náshdóítsoh Bitsiijįʼ Daditłʼooʼígíí Bidził	Сьерра-Леоне
Soomáálii Bikéyah	Сомали
Soodą́ą	Судан
Swáazi Dineʼé Bikéyah	Свазиленд
Nahasdzáán Bikáaʼgi Kéyah Naaznilgo Ałhidadiidzooígíí	Организация Объединённых Наций
Nidaashchʼąąʼígíí	Цвет
Béésh Łigaii	Серебро
Béésh Dildǫʼí	Олово
Łéétsoh	Уран (элемент)
Hastiin alą́ąjįʼ dahsidáhígíí Bill Clinton	Клинтон, Билл
Míshigin Hahoodzo	Мичиган
Tó Nitsaa Nílį́bąąh Hahoodzo	Иллинойс
Náhookǫsjí Dzígaii	Северная Дакота
Ałnííʼjí Dzígaii	Южная Дакота
Ayání Naakaii Hahoodzo	Монтана
Tóʼííbézhí	Вайоминг
Nímasii Kʼidadilyéhé	Айдахо
Ahééhałtį́į́h Hahoodzo	Вашингтон (штат)
Naʼazhǫǫsh Hahoodzo	Невада
Kayíbíyinsíí (tónteel)	Карибское море
Dibé Nitsaa Hahoodzo	Колорадо
Naakaii bizaad	Испанский язык
Naʼashjéʼii	Пауки
Chʼosh bijáád tseebíhígíí	Паукообразные
Chʼosh bideeʼ ádaadinígíí	Хелицеровые
Chʼosh bijáád dahólónígíí	Членистоногие
Béeso	Деньги
Bijíniyah Hahoodzo	Виргиния
Eʼeʼaahjí Bijiniyah Hahoodzo	Западная Виргиния
Kin Yótʼááh Deezʼá Hahoodzo	Нью-Йорк (штат)
Wóód Áalin Hahoodzo	Род-Айленд
Chʼosh bijáád hastání	Насекомые
Méelin Hahoodzo	Мэриленд
Déláwee Hahoodzo	Делавэр
Oohááyoo Hahoodzo	Огайо
Pénsówéíniyah Hahoodzo	Пенсильвания
Niijéízii Hahoodzo	Нью-Джерси
Índíʼyéenah Hahoodzo	Индиана
Chidí	Автомобиль
Jóojah Hahoodzo	Джорджия
Akałii Bikéyah	Техас
Náhookǫsjí Kééláanah Hahoodzo	Северная Каролина
Shádiʼááhjí Kééláanah Hahoodzo	Южная Каролина
Méhigoʼ sídii	Мехико
Bilasáana diwozhí	Ананас крупнохохолковый
Mísísípii Hahoodzo	Миссисипи (штат)
Ténésii Hahoodzo	Теннесси
Yootó Hahoodzo	Нью-Мексико
Mínisóodah Hahoodzo	Миннесота
Wiskaansin Hahoodzo	Висконсин
Haʼaʼaahjí Dzígaii	Айова
Nabeeskah Hahoodzo	Небраска
Shádiʼááhjí Dzígaii	Канзас
Tó Dzígaii Nílį́	Миссури (штат)
Tónteel Chʼínílį́	Луизиана
Kentákii Hahoodzo	Кентукки
Dził Biiʼ Dzígaii	Арканзас
Halgai Hóteel Hahoodzo	Оклахома
Ho Chi Min Sídii	Хошимин
Bilagáana bizaad	Английский язык
Náhookǫsjí Hakʼaz Dineʼé Bikéyah	Нунавут
1901 – 1950	1902 год
Tłʼiish	Змеи
1951 – 2000	1979 год
Pope Benedict XVI	Бенедикт XVI
Maʼii Ashkii	Джеронимо
Tsin naaʼeeł táłtłʼááh naagháhígíí	Подводная лодка
Tahoniigááh	Грипп
Tłʼízí	Коза домашняя
Kǫʼ	Огонь
Tʼááłáhági átʼéego:Templates	Категория:Википедия:Шаблоны
Dloziłchííʼ	Обыкновенная белка
Tʼááłáhági átʼéego:Bideeʼtsʼinígíí	Категория:Полорогие
Tʼááłáhági átʼéego:Ndaaʼnaʼii	Категория:Чешуйчатые
Tiníléítsoh	Комодский варан
Chʼosh bijáád neeznánígíí	Десятиногие ракообразные
Aymara bizaad	Аймара (язык)
Łeeyiʼ chʼoshtsoh binááʼ hólónígíí	Безногие земноводные
Tʼááłáhági átʼéego:Dééł dóó Tóidoozohii	Категория:Журавлеобразные
Médíwííyin Sii	Средиземное море
Jóojah (Ałtsʼáʼáztiin)	Джорджия (значения)
Alóós	Рис (продукт питания)
Tsídii	Птицы
Kéłánii bikágí yilzhólígíí	Онихофоры
Kéchwa bizaad	Кечуанские языки
Ínsadoobíídiiya	Энциклопедия
Íiyisíí Naaltsoos	Заглавная страница
Dziłgaiitsoh Honeezkʼazii	Гималаи
Tʼááłáhági átʼéego:Candidates for speedy deletion	Категория:Википедия:К быстрому удалению
Chʼil ahwééh	Чай
Adijiłii	Настоящие ежи
Kéyah Sahééwa Eʼeʼaahjí Siʼánígíí	Западная Сахара
1801 – 1850	1815 год
Łį́į́ʼ Bideeʼłáaʼii	Единорог
Hastiin Hernán Cortés	Кортес, Эрнан
Tsʼíʼii daʼaneezí	Комары
Dibé	Овца
Łóóʼ hashkéhé	Акулы
Ghą́ą́ʼaskʼidii	Верблюды
Bidił Daazdoígíí dóó Daʼałtʼoʼígíí	Млекопитающие
Bíchį́į́h yee adilohii	Слон
Mágí dóó Mágí Ndahalinígíí	Приматы
(*wálá-)	Муравьи
Tsísʼná	Пчёлы
Naayízítsʼósí	Кабачок
Sęęschʼil	Цветная капуста
Ayęęzhii yiltʼąąʼí	Баклажан
Naalʼeełí	Утиные
Yas	Снег
Jádí dághaaʼígíí	Гну
1851 – 1900	1865 год
Biʼééʼ Łichííʼí bizaad	Русский язык
1751 – 1800	1784 год
Bááh	Хлеб
Bee Hazʼą́ą Ił Chʼétʼaah	Всеобщая декларация прав человека
Kéyah haʼdéísná	Землетрясение
Tó nitéél nitságoʼ atságáá	Цунами
Níyoltsoh	Смерч
Saad bee alʼį́į́hni	Письменность
Tʼááłáhági átʼéego:Dáághahii	Категория:Франция
Mąʼii łitsooí	Обыкновенная лисица
Naaltéʼ	Рабство
Ahwééh	Кофе
Abeʼ	Молоко
Dził	Гора
Doo Nidahałtingóó	Пустыня
Cryptographic	Криптография
Guadalajara	Гвадалахара
Tsídii naʼałkʼaiʼí	Пингвиновые
Kolíya Dineʼé bizaad	Корейский язык
Gah	Кролики
Tó niteel	Океан
Hodíłchʼil Níłtsánígíí	Дождевой лес
HiTSʼezh	IPod
Hazéí	Беличьи
Hazéí naatʼáʼii	Летяги
Ééʼ néíshoodí	Римско-католическая церковь
Kwį́į́n Elizabeth II	Елизавета II
Hastiin alą́ąjįʼ dahsidáhígíí Ronald Reagan	Рейган, Рональд
Hastiin Emperor Yongle	Юнлэ
Naʼashjéʼiitsoh	Пауки-волки
Naaldlooshii dadichʼízhii	Пресмыкающиеся
Tsin Deigházhígíí	Грызуны
Hasbídí	Голубиные
Tééh hóyáanii	Морские свиньи
Biyáázh Tsʼǫʼasánígíí (Táyiʼ dóó Niʼkáágóó Ndaakaaígíí)	Земноводные
Géeso	Сыр
Chʼil naʼatłʼoʼii (chʼiyáán)	Виноград (ягода)
Tsísʼná bitłʼizh	Мёд
Atsįʼ	Мясо
Naʼashjéʼii tsiizisí	Пауки-сенокосцы
Nímasii	Картофель
Áshįįh łikan	Сахар
Haʼałtsédii	Орех
Wááshindoon bisiláołtsooí	Вооружённые силы США
Naʼiiniʼ bá Hooghantsoh	Всемирный торговый центр
Áshįįh	Поваренная соль
Wááshindoondi bee hazʼáanii ádeiłʼíní	Конгресс США
Tsin naaʼeeł	Судно
Nidaʼąnyéézh	Орошение
Naadą́ą́ʼ	Кукуруза сахарная
Naʼashchʼąąʼ	Живопись
Wótáahgoo ałnaaʼáłtʼahiʼ	Космонавт
Azhish	Танец
Naʼashjéʼii nahachaʼígíí	Пауки-скакунчики
Kéyah Daʼnaaznilígíí	Алфавитный список стран и территорий
Shash	Медвежьи
Hastiin alą́ąjįʼ dahsidáhígíí John Adams	Адамс, Джон (президент)
Hastiin alą́ąjįʼ dahsidáhígíí Thomas Jefferson	Джефферсон, Томас
Hastiin alą́ąjįʼ dahsidáhígíí Andrew Jackson	Джексон, Эндрю
Ńdíshchííʼ	Сосна
Tłʼoh naadą́ą́ʼ	Пшеница
Naałniih yichʼą́ą́h naabaahígíí bąąh dahooʼaahgo	ВИЧ-инфекция
Abeʼ bee neezmasí	Тонкие блинчики
Jéíʼádįįh	Туберкулёз
Łóódtsoh	Натуральная оспа
Zelda bahaneʼ	The Legend of Zelda
Naakáí dinéʼiʼ biempire Méhigodi	Ацтеки
Łéétsoh bee atsiniltłʼish álʼį́	Ядерная энергия
Łéétsoh beeʼeldǫǫhtsoh beeʼalį́į́h	Ядерное оружие
Chidí naaʼnaʼí beeʼeldǫǫh bikááʼ dah naaznilígíí	Танк
Dah woozh	Земляника ананасная
Jalisco Hahoodzo	Халиско
Mágí bichʼiyąʼ	Кокосовая пальма
Dzidzétsoh	Персик
Chʼil łitsxooí	Апельсин
Chʼil dishooí	Киви (фрукт)
Chʼil dootłʼizhí díkʼǫ́zhígíí	Лайм (плод)
Abeʼ yistiní	Мороженое
Méhigo bizaad	Астекские языки
Diné bizaad	Навахо (язык)
Jeeʼiighááh	Кожистокрылые
Tenochtitlan	Теночтитлан
Ásáí Bizaad	Арабский язык
Honeezílígi	Субтропики
Atʼaʼ yiltʼąąʼí	Пальмовые
Niłchiis	Росомаха
Tsin yilátah ayání	Жираф
Naalʼeełídaaʼí	Утконос
Naʼashǫ́ʼii	Ящерицы
Béésh bee akʼeʼelchí áłtsisígíí	Персональный компьютер
Wikiibíídiiya:Naaltsoos nizhónígo ádaalyaaígíí	Википедия:Избранные статьи
Bimááʼ Hahoodzo	Вермонт
Hoozdoh	Финикс
Tʼáyaałchííʼ	Золотой шилоклювый дятел
Táłkááʼ tsʼin bíchį́į́hnézí	Гангский гавиал
Tsin naaʼeeł chidí naatʼaʼí bee nágéhéʼ	Авианосец
Tsídiitsoh	Страус
Kolíya bikéyah (Ałtsʼáʼáztiin)	Корея
Mąʼiitsoh	Волк
Chʼídeeldlóohiitsoh	Китоглав
Hodíłchʼilgi dlǫ́ʼiitsoh	Мусанг
Tóidoozohii bidaaʼ łichííʼígíí	Камышница
Táłtłʼááh yilcháazhii	Губки
Tónteel naʼashjéʼii	Морские пауки
Séigoʼ bíláshgaanézí	Фрины
Naʼashjéʼii jáádnézí	Сенокосцы
Séigoʼchilí bitseeʼ ádinígíí	Ложноскорпионы
Séigoʼ	Скорпионы
Zahalchíʼii	Фаланги
Hastiin Emperor Qianlong	Цяньлун
Séigoʼ bitseeʼ áłtsʼózígíí	Телифоны
Yaaʼ doo yitʼíinii	Клещи (животные)
Hodíłchʼilgi naaʼahóóhai	Тинаму
Tłʼiishkʼosí (tsídii)	Змеешейки
Télii	Домашний осёл
Náshdóítsoh noodǫ́zígíí	Тигр
Kʼíneeshbízhiinééz	Спагетти
Chʼosh yoołgai bitsʼaʼígíí	Устрицы
Tábąąhgi łeeyiʼ chʼosh	Морской пескожил
Azeeʼ hókániitsoh	Бодяк обыкновенный
Táłkáaʼgi Tsídii	Гусеобразные
Tązhii dóó Naaʼahóóhai Ndahalinígíí	Курообразные
Naalʼeełii keelóól	Поганковые
Tsídii Deílʼésígíí	Аистообразные
Daʼałtʼoʼígíí Biyęęzhii Deiłchíhígíí	Однопроходные
Adijiłii bíchį́į́hnézí	Ехидновые
Biyázhí neiyéhé	Опоссумовые
Hazéítsʼósii	Бурундуки
Chidí bikʼah	Нефть
Chéłchaaʼ	Жесткокрылые
Łį́į́ʼ ałchiní	Лошадь Пржевальского
Dlǫ́ʼii yił aheełtʼéhii noodǫ́zígíí	Полосатый мангуст
Naʼastsʼǫǫsíʼniiʼí	Бандикутовые
Shash naʼazísí	Вомбаты
Nahatʼeʼiitsohchilí	Кенгуровые крысы (сумчатые)
Náʼagéédí łichíiʼii	Златокроты
Bįįh Danilínígíí	Оленевые
Tin	Лёд
Tłʼohchin díchʼííʼí	Чеснок
Taʼneeskʼání áłtsʼóózígíí	Огурец обыкновенный
Tłʼohchin (chʼil daadánígíí)	Лук репчатый
Chʼil łichxíʼí	Томат
Béésh Łichíiʼii Bikéyah Náhookǫsjígo Siʼanígíí	Турецкая Республика Северного Кипра
Naʼazhǫǫsh Hátsoh	Лас-Вегас
Náshdóí dilwoʼí	Гепард
Tsékǫʼ	Ископаемый уголь
Néʼéshjaaʼ	Совообразные
Bíígháán Dahólónígíí	Позвоночные
Kʼishchííʼ	Берёза
Ǫǫbǫʼii	Удод
Náshdóí Ndahalinígíí	Кошачьи
Yádiłhił yiiyídíʼ nahosdzáán yináádáłiʼ	Международная космическая станция
Tó wónaanídę́ę́ʼ toohjįʼ noołnahii	Серая цапля
Hashkʼaan dijéʼé	Финик пальчатый
Wááshindoon (Ałtsʼáʼáztiin)	Вашингтон
Bidił Daazdoígíí dóó Daʼalghałígíí	Хищные
Chʼoshtsoh	Таракановые
Dlǫ́ʼii yázhí	Ласка
Tsʼíʼii dóó Tséʼédǫ́ʼii	Двукрылые
Biniiʼłigaii (néʼéshjaaʼ)	Обыкновенная сипуха
Mąʼii Ndahalinígíí	Псовые
Bijáád Ádaadinígíí	Моллюски
Chʼosh łitsxooí dóó Chʼosh łichííʼí	Божьи коровки
Táłkááʼ naalzheehí	Скопа
Bizaʼazis Dahólónígíí	Сумчатые
Dlǫ́ʼiiłgaii	Горностай
Naalʼeełí bitsiiʼ dootłʼizhí	Кряква
Sǫʼ łóóʼ	Морские звёзды
Giníłbáhí	Ястреб-тетеревятник
Tʼádootłʼizhii	Сойка
Zhį́ʼii	Ворон
Táłkááʼ tsʼin Danilínígíí	Крокодилы
Chʼosh bikágí dantłʼizí	Ракообразные
Dééł	Журавлиные
Chʼosh bitsʼaʼígíí	Двустворчатые
Atsá dóó Giní Ndahalinígíí	Соколообразные
Łóóʼ ooshgę́ęzhii	Хрящевые рыбы
Tániilʼáí	Стрекозы
Wóláchííʼ yildeełí bikágí ntłʼizí	Панголины
Gah Danilínígíí	Зайцеобразные
Tsísʼnátsoh	Шмели
Hazéí yiltseeʼí	Тысячелистник обыкновенный
Chʼosh bikǫʼí	Светляки
Zéédzísgaii	Обыкновенный фазан
Dlǫ́ʼii Ndahalinígíí	Куньи
Tsin yiłkaałii	Дятловые
Bideeʼtsʼinígíí	Полорогие
Dééł dóó Tóidoozohii Ndahalinígíí	Журавлеобразные
Gáagii dóó Joogii Ndahalinígíí	Врановые
Chʼiltaatʼagii	Полевой лунь
Tsin naaʼeeł diné bee nágéhéʼ	Паром
Gad	Можжевельник
Jááłánii	Многоножки
Biishchʼid Dahólónígíí	Плацентарные
Chʼosh Deildeełii	Насекомоядные
Tó wónaanídę́ę́ʼ naalʼeełítsoh łibáhígíí	Серый гусь
Tónteel dóó Tábąąhgi Tsídii	Ржанкообразные
Ńdíshchíitah dlǫ́ʼii	Лесная куница
Biyaatsʼiin Dahólónígíí	Челюстноротые
Tooh łéʼétsoh	Ондатра
Chaatʼíní	Щавель кислый
Łóóʼ hashkéhé dootłʼizhígíí	Синяя акула
Wóʼatsʼǫǫsii Ádaatʼéhígíí	Полужесткокрылые
Atsáłgaii	Мохноногий канюк
Béégashiiʼilí	Як
Tó wónaanídę́ę́ʼ dlǫ́ʼii	Лесной хорёк
Tsxį́į́łnaalkʼįhii	Стрижиные
Dziłditłʼoii Bił Hahoodzo	Сан-Хуан (округ, Юта)
Hakʼaz naalʼeełí	Обыкновенная гага
Naalʼeełítsoh bitsiiʼ halzhinígíí	Канадская казарка
Chʼó	Ель
Łóóʼtsoh łizhin dóó łigaígíí	Косатка (млекопитающее)
Jáádtsʼósí	Шилоклювковые
Téél dzítsooii dóó Tsétah chʼosh	Жужелицы
Naalʼeełítsoh diłhiłígíí	Чёрная казарка
Tábąąh dlǫ́ʼii	Американская норка
Dlǫ́ʼii bitéél halgaií	Каменная куница
Tábąąstííntsoh łibáhígíí	Длинномордый тюлень
Naakaii Łizhiní Bikéyahdi Hadahóólįįdígíí	Afrotheria
Diné Nááhódlóonii bizaad	Атабаскские языки
Łį́į́ʼ bitsísʼná	Овод (насекомое)
Tónteel tsídii	Чайковые
Ałtį́į́ jikʼáshí (chʼil)	Хвощ
Hazaʼaleehtsoh (dííshjį́ ááłjiní)	Сельдерей пахучий
Kʼaalógii dóó Iichʼąhii	Чешуекрылые
Díłdánii yił aheełtʼéhii	Обыкновенный перепел
Chʼałdą́ą́ʼ / Jádí nátʼoh (chʼil daadánígíí)	Спаржа лекарственная
Tséʼédǫ́ʼii dootłʼizhí	Падальные мухи
Jaaʼabaní Danilínígíí	Рукокрылые
Wóónałchídii	Щелкуны
Tsídii bidaanézí	Аистовые
Dlǫ́ʼii	Хорьки
Lókʼaaʼ	Тростник обыкновенный
Tsídiiłbáhí	Воробьиные
Biłʼeʼeliníʼ	Пекарский порошок
Táłtłʼááh chʼoshchilí	Эвфаузиевые
Tsiiʼyiishbizhí Dinéʼiʼ Bikéyah	Китайская цивилизация
Naalʼeełí binááʼ łitsooígíí	Обыкновенный гоголь
Tábąąstíín	Выдра
Jélii łóóʼ	Медуза
Náshdóíłgaii łikizhígíí	Ирбис
Tábąąstííntsoh Danilínígíí	Ластоногие
Dlǫ́ǫ́ʼ	Луговые собачки
Náshdóí bijaałizhiní	Каракал
Chʼóhojilyééh	Дурман обыкновенный
Chʼah Diʼilii Bikéyahdę́ę́ʼ naalʼeełítsoh	Сухонос
Tsídii yáłtiʼí	Попугаеобразные
Tééh łį́į́ʼ	Зебры
Náshdóí łikizhígíí	Оцелот
Dííłdzid jeeshóóʼ	Обыкновенный стервятник
Tʼáadoo leʼé danílʼį́ bił hazʼą́	Музей
Shash łizhin dóó łigaígíí	Большая панда
Shash łigaígíí	Белый медведь
Gaantsʼosí	Морские лилии
Hastiin alą́ąjįʼ dahsidáhígíí Theodore Roosevelt	Рузвельт, Теодор
Neeshchʼííłgai	Кешью
Beeʼódleehí	Ловушка
Dilní bee Nidaʼanéhígíí	Музыкальные инструменты
Dééłgai	Лебеди
Bikááʼ náʼoobałí	Вертолёт
Dziʼizítsoh	Мотоцикл
Tééhoołtsódii	Обыкновенный бегемот
Séí	Песок
Naakaii Łizhiní Bikéyahdę́ę́ʼ náshdóítsoh łikizhígíí	Леопард
Déélgééd	Носороговые
Beeʼeldííl Dahsinil	Альбукерке
Hashkʼaan dootłʼizhí (babáayah)	Папайя
Chʼil łigaii (atʼééké bijish)	Кочанная капуста
Náshdóítsoh	Пума
Ásáí dinéʼiʼ	Арабы
Deeteel	Лось
Shádiʼááhdę́ę́ʼ náshdóítsoh łikizhígíí	Ягуар
Lókʼaatsoh	Bambuseae
Káango (Ałtsʼáʼáztiin)	Конго
Kʼaiʼ	Ива
Shash bizaʼazis hólóní	Коала
Náshdóí kʼos bee naashchʼąąʼígíí	Дымчатый леопард
Shashtsoh	Бурый медведь
Łéʼétsoh	Крысы
Akʼáán	Мука
Mágítsoh	Гориллы
Bitsįʼ yishtłizhii	Индейцы
Chʼil akʼahí	Авокадо
Neeshchʼííłbáhí	Арахис культурный
Dzidzétsoh díkʼǫ́ǫzhii	Абрикос
Naʼashǫ́ʼii łahgo ánééhé	Хамелеоны
Yootó	Санта-Фе (Нью-Мексико)
Łééchąąłgaii	Грейхаунд
Nahatʼeʼiitsoh Bikéyahdę́ę́ʼ łééchąąʼí ałchiní	Динго
Chʼééhjiyáán	Арбуз обыкновенный
Teide	Тейде
Naʼastsʼǫǫsí	Домовые мыши
Hakʼaz bįįh	Северный олень
Chʼosh doo yitʼínii	Микроорганизмы
Táshchozhii	Ласточковые
Neeshchʼííʼ hááheeshchiiʼí	Миндаль
Łóóʼ bigaan tseebíí	Осьминоги
Chʼosh bikágí ntłʼizí	Крабы
Tábąąstííntsoh bideeʼ hólónígíí	Морж
Mágí diʼilí	Орангутаны
Atsátsoh	Беркут
Łóóʼtʼą́hí atsiniltłʼish ííłʼínígíí	Электрические скаты
Chʼil łitsxooí ntsxaaígíí	Грейпфрут
Kʼíníjíłʼahí (dííshjį́ ááłjiní)	Крыжовник обыкновенный
Kʼaalógiiłgaígíí	Белянки (бабочки)
Naʼastsʼǫǫsí binááʼ áłtsʼíísígíí	Землеройковые
Dzaanééz	Мул
Tsinlátah shash łichíʼígíí	Малая панда
Tsídii jáádnézí	Фламинго
Tééh łééchąąʼí	Гиены
Łóóʼtsoh dootłʼizhígíí	Синий кит
Sóól	Клён
Aghaaʼ	Шерсть (материал)
Deesdoigi	Тропики
Shádiʼááhdę́ę́ʼ tłʼízí	Лама (животное)
Mósíʼilí	Персидская кошка
Lókʼaatah mósí ałchiní	Камышовый кот
Náátsʼózídę́ę́ʼ mósíłkizhii ałchinígíí	Бенгальская кошка
Náshdóítʼą́ʼí łikizhígíí	Сервал
Tábąąh béégashii	Азиатский буйвол
Béégashiitsoh naʼałkǫ́ǫ́ʼígíí	Ламантины
Hastiin Leiw Éíwiksson	Лейф Эрикссон
Akágí yitsʼǫǫsii	Пиявки
Anáʼálwoʼ:TʼAN (FAQ)	Википедия:ЧАВО
Táłkááʼ tsʼin	Настоящие крокодилы
Chidítsoh	Грузовой автомобиль
Dlǫ́ʼiitsoh áłtsʼózígíí	Генеты
Gáagii	Вороны
Tó wónaanídę́ę́ʼ náshdóí	Обыкновенная рысь
Jááłánii (bitsiitsʼiin nteelígíí)	Губоногие
Giní	Соколы
Dahiitį́hii	Колибри
Tsídii biyęęzhtsohígíí	Киви (птица)
Tązhii	Индейки
Chʼosh (Bíígháán Ádaadinígíí)	Беспозвоночные
Gáagii naashchʼąąʼígíí	Сизоворонковые
Mąʼii	Койот
Dah Naatʼaʼí Sǫʼ bił Sinil	Гимн США
Akʼah sisíʼí tsin	Эвкалипт
Mááya dinéʼiʼ	Майя (народ)
Gahtsoh	Зайцы (род)
Bisóodi bíchį́į́h nineezí	Трубкозуб
Sonora Hahoodzo	Сонора
Nahakʼízii	Настоящие сверчки
Chaaʼ	Бобры
Chʼilzooł	Брокколи
Kááʼtsʼiní	Броненосцевые
Atsʼiis naałdzid	Рак лёгкого
Yágháhoníkáángóó ałánátʼahí	Спейс шаттл
Béésh náábałí atsiniltłʼish ííłʼínígíí	Ветрогенератор
Shą́ą́ʼnahalghałí (naaldeehii)	Дамановые
Nahatʼeʼiitsoh łichíiʼii	Большой рыжий кенгуру
Azeeniłchin	Яснотковые
Chʼał	Бесхвостые
Tsxilghááh	Хвостатые земноводные
Shádiʼááhdę́ę́ʼ atsátsoh	Южноамериканская гарпия
Shádiʼááhdę́ę́ʼ chʼał kʼaasdáhígíí	Древолазы
Chʼał niłtólí	Стеклянные лягушки
Chʼał dichʼízhí	Жабы
Tónteel tsídiitsoh	Альбатросовые
Chidí nadlééh	Кабриолет
Chʼał atʼąąʼ nahalinii	Рогатые чесночницы
Naashgalí	Мескалеро
Bisóodi ałchiní	Кабан
Mariner 10	Маринер-10
Sǫʼ łóóʼ bigaanézí	Офиуры
Dághaałóóʼ	Сомообразные
Łóóʼtʼą́hí	Камбалообразные
Toohjįʼ ndiigaii	Белая американская цапля
Kʼaalógii bitseeʼ hólóní	Парусники (бабочки)
Mágí binááʼtsohígíí	Долгопяты
Chiiłchin	Сумах душистый
Ndoochííʼ	Птероспора
Tó wónaanídę́ę́ʼ dlǫ́ʼiiłkizhii	Перевязка
Díłdánii	Зубчатоклювые куропатки
Táłtłʼááh łį́į́ʼ	Морские коньки
Łóóʼ bíígháántsiighąąʼ ádaadinígíí	Миксины
Tó wónaanídę́ę́ʼ dzeeh	Благородный олень
Kinłání (Hoozdoh Hahoodzo)	Флагстафф (Аризона)
Michoacán Hahoodzo	Мичоакан
Táłtłʼááh chʼosh daadánígíí	Настоящие креветки
Mágíshzhin	Шимпанзе
Łóóʼntsxaaí łikizhígíí	Китовая акула
Dlǫ́ʼii yił Aheedaałtʼéhígíí	Мангустовые
Béésh Bichʼahníí Bikéyahdę́ę́ʼ ayání	Зубр
Łóóʼtsoh bitsiiʼ dikʼání	Кашалот
Waaʼ (dííshjį́ ááłjiní)	Шпинат огородный
Néʼéshjaatsoh	Виргинский филин
Shádiʼááhdę́ę́ʼ tłʼízíʼilí	Альпака
Chʼosh ditłʼooí	Гусеница
Łóóʼ bigaan neeznání	Кальмары
Bijáád noodǫ́ǫzii	Окапи
Méhigo Hahoodzo	Мехико (штат)
Ayání	Бизон
Mąʼiiłgaii	Песец
Gólízhii Danilínígíí	Скунсовые
Táłtłʼááh adijiłii	Морские ежи
Nahachagii	Короткоусые прямокрылые
Wóóneeshchʼįįdii (nahachaʼígíí)	Саранча
Tsídiitsoh ditsʼozígíí	Эму
Ałhaʼdeetʼaah	Договор
Naayééʼ tsídii	Археоптерикс
Tsísʼná (bitłʼizh ííłʼínígíí)	Медоносные пчёлы
Chééwokii dinéʼiʼ	Чероки
Tsin naaʼeeł hééł bee nágéhéʼ	Грузовое судно
Ałtį́į́ jikʼáshí áłtsʼózígíí (chʼil)	Хвощ полевой
Yéigo ałhoshii	Соневые
Naʼashjéʼii bijéí dah łichíiʼii	Чёрная вдова
Mágí dághaaʼígíí	Императорский тамарин
Didzéłchííʼ	Падуб
Naałání	Команчи
Oozéí / Ayahkinii	Хопи (народ)
Toohjįʼ noołnahiitsoh	Исполинская цапля
Bidááʼ Haʼaztʼiʼ Tsékooh	Большой каньон
Táłtłʼááh naʼashjéʼii	Водяной паук
Táłtłʼááh tsisteełtsoh	Кожистая черепаха
Nahatʼeʼii	Кенгуровые прыгуны
Tsídii yáłtiʼí yázhí	Волнистый попугайчик
Tábąąh mąʼii	Енот-полоскун
Hołchʼíʼí	Крапива
Tsįdláád	Уснея
Dáághahii dinéʼiʼ	Французы
Shash łizhinígíí	Барибал
Náshdóí bizaʼazis hólóní	Сумчатый волк
Łeeyiʼ chʼosh	Земляные черви
Shash bitéélgaígíí	Гималайский медведь
Chʼoshtʼą́hí	Плоские черви
Hashtłʼish jeeshóóʼ	Бородач
Jádí bíchį́į́htsohígíí	Сайга
Táłtłʼááh chʼoshtsoh chʼééh digháhii	Голотурии
Tsísʼná bizǫ́ǫ́z ádinígíí	Meliponini
Chidí naatʼaʼí dilwoʼí	Истребитель
Bíchį́į́h naatsʼǫǫdí	Тапиры
Tó wónaanídę́ę́ʼ mąʼii	Обыкновенный шакал
Chʼóshgai (tsin)	Ель сизая
Łóóʼ Bigaan Dahólónígíí	Головоногие
Naʼashǫ́ʼii łóóʼ	Угреобразные
Dahbaʼ (tsin)	Ясень
Łóóʼ hashkéhétsoh	Белая акула
Neeshchʼííłchííʼ	Каштан
Chį́į́hnézí nahatʼeʼígíí	Прыгунчиковые
Táłtłʼááh ayání	Дюгонь
Dibé Diníí Bikéyahdę́ę́ʼ náshdóí	Пиренейская рысь
Kʼaiʼ Bił Hahazteel	Канаб
Toohjįʼ ndiigaiitsoh	Большая белая цапля
Wóóneeshchʼįįdii	Певчие цикады
Dééshzhiin	Чёрный лебедь
Naakaii náásééł	Богомоловые
Dlǫ́ǫ́ʼ ntsxaaígíí	Капибара
Mąʼii bijaaʼtsohí	Фенек
Dilchaʼ	Сурки
Díwózhii	Sarcobatus
Náshdóí łibáhígíí	Рыжая рысь
Chʼilhaatʼaʼii	Дербник
Tééh hóyáaniitsoh	Белуха (млекопитающее)
Jádí bideeʼ yisdizígíí	Импала
Náátsʼózídę́ę́ʼ mąʼiiłchííʼ	Красный волк
Łóóʼtsoh bighą́ą́ʼ yílkʼidígíí	Горбатый кит
Ghą́ą́ʼnaakiskʼidii	Двугорбый верблюд
Tábąąh mąʼiiniiʼí	Енотовидная собака
Naʼazhǫǫsh (ndajiné dóó adazhdikaʼgi)	Казино
Ndikʼąʼ	Хлопчатник обыкновенный
Dlǫ́tʼą́ʼí	Сурикат
Azeeʼ hókániitsoh (chʼil daadánígíí)	Артишок испанский
Kéchwa dinéʼiʼ	Кечуа (народ)
Mąʼii bizaʼazis hólóní	Тасманийский дьявол
Shash bítááʼłgaígíí	Очковый медведь
Jádítsoh	Большой куду
Naatʼáanii Moctezuma II	Монтесума II
Biwooʼ Ádaałtsʼíísígíí	Неполнозубые
Ásáí dinéʼiʼ bikéyah	Арабский мир
Shash yázhí	Малайский медведь
Shash ndilnaʼii	Губач
Teeł	Рогоз
Hwéeldi	Долгий марш навахо
Chʼódeenínii	Ель голубая
Łéʼétsoh yiljaaʼí	Лютик
Hakʼaz náshdóí	Канадская рысь
Mąʼii yił Ałhidanoolinígíí Yázhí	Енотовые
Béésh Bichʼahii beʼakétłʼóól dijoolí	Кольраби
Nahooyéí (chʼil naʼatłʼoʼii)	Вьюнок
Tłʼoh waaʼí nahalinígíí	Клевер ползучий
Tséʼésgízii	Смородина золотистая
Tábąąstííntsoh dághaaʼígíí	Морской заяц
Atʼééké bijish yázhí	Брюссельская капуста
Tsékooh	Каньон
Bisńdíshchííʼ	Эриогонум метельчатый
Noodah	Агава
Łeeʼdoolʼeezí	Заразиховые
Kinteel Bił Hahoodzo	Сан-Хуан (округ, Нью-Мексико)
Beeʼeldííl Dahsinil Bił Hahoodzo	Берналилло (округ, Нью-Мексико)
Aniłtʼánii	Сетчатокрылые
Kʼaalógii bijáád dį́įʼii	Нимфалиды
Nímasii yiyání	Колорадский жук
Awééʼchíʼí (chʼil)	Колокольчик
Taʼaghálii	Астрагал
Naaʼołí yiltʼąąʼí	Чина
Azeeʼ ndootʼeezhí łibáhígíí	Шандра обыкновенная
Hastóí tsiiyéélí	Ломонос
Chʼilátah atsʼos	Кипрей
Kʼish	Ольха серая
Dééłjáád	Щавель курчавый
Shį́náldzidí (chʼil bilátah hózhóón)	Львиный зев
Kʼįįʼ	Сумах
Naaztání	Гледичия трёхколючковая
Táłkááʼbéésh	Стрелолист
Tsinyaa tłʼoh	Мятлик
Tłʼééʼ yiigáhii	Ослинник
Tłʼoh deeskʼidí	Амарант запрокинутый
Ndootʼeezhí	Монарда
Wóóseekʼidii	Бражники
Dzílí bíláshgaan	Аистник обыкновенный
Díkʼǫ́ǫ́zhí (chʼil)	Лебеда
Tʼąąʼdoolghasí	Лапчатка гусиная
Teełikaní	Триостренник приморский
Láʼashdlaʼ	Девичий виноград пятилисточковый
Tséghániłchʼi	Портулак огородный
Zééʼiilwoʼii	Лисохвост
Chéchʼil ntłʼizí yiltʼąąʼí	Магония падуболистная
Tólchiintsoh	Чистец болотный
Tséyaa hataałí	Брюква
Tłʼohtsʼózí	Ситник
Tłʼoh dichʼíízh	Осока
Shashdą́ą́ʼ	Барбарис
Tłʼoh waaʼítsoh	Донник белый
Díkʼǫ́ǫ́zhí yiltʼąąʼí	Марь белая
Bįįh yildeeʼí	Физалис
Kʼaalógii bitʼaʼ ndikʼąʼ nahalinígíí	Голубянки
Hosh niteelí	Опунция
Teeł bitʼąąʼłánígíí	Камыш
Chʼał nineezí	Лягушка-бык
Tééh hóyáanii bíchį́į́htsahí	Нарвал
Mágí bíchį́į́htsohígíí	Павианы
Bįįh łikizhígíí (Béésh Bichʼahníí Bikéyahdę́ę́ʼígíí)	Лань
Tábąąh ayání	Африканский буйвол
Nátʼostsoh	Коровяк обыкновенный
Tólchiin (chʼil)	Мята полевая
Dibé diníí dinéʼiʼ	Испанцы
Táłkááʼ dah yikał	Жеруха
Binaʼadaałtzózí	Японцы
Kʼįįshzhíní	Черёмуха виргинская
Ahaditʼáán	Щавель приморский
Ostseʼ yiltʼąąʼí	Декурения Софии
Azeediilchʼílii	Люпин узколистный
Kʼįįʼ łitsooí	Магония ползучая
Dzidzé ditʼódí	Ирга ольхолистная
Gad yił aheełtʼéhígíí	Гребенщик
Łóóʼ bíchį́į́h nineezí	Меч-рыба
Łį́į́ʼ Ndahalinígíí	Лошадиные
Binááʼ Ádaałtsʼózí bichʼil łigaií	Пекинская капуста
Azeedíchʼííʼ	Красный перец
Kolíya Tááʼ Bikéyahą́ą	Три корейских государства
Łeehdoolʼeez łichííʼí	Свёкла (корнеплод)
Hashkʼaantsoh yiltʼeesígíí	Плантан
Iiʼnótʼį́į́	Инфекция
Chʼah Diʼilii Bikéyahdę́ę́ʼ mósí ałchinígíí	Манул
Jááłánii (bikágí ntłʼizígíí)	Двупарноногие
Iichʼąhii ntsxaaígíí	Павлиноглазка атлас
Łóóʼ ńdídzihígíí	Двоякодышащие
Chʼíshiibeezhii	Синицевые
Giní jáádnézí	Птица-секретарь
Hakʼaz néʼéshjaaʼ	Белая сова
Shádiʼááhdę́ę́ʼ jeeshóóʼ	Андский кондор
Chidí naatʼaʼítsoh beeʼeldǫǫh bikǫʼ neiyéhé	Бомбардировщик
Shash bighą́ąʼgi hadzíbáhí	Гризли
Kǫʼ naʼałbąąsii	Паровоз
Ndíyíliitsoh	Подсолнечник однолетний
Naaʼahóóhaiłkizhígíí	Цесарковые
Tłʼiish yighání	Медоед
Dadilhóni aheltłʼidígíí	Граната
Naakaii Łizhiní Bikéyahdę́ę́ʼ łééchąąʼí ałchiní	Гиеновидная собака
Aniłtʼánii (tʼááłaʼajínígoʼígíí)	Подёнки
Ayánítsoh bighą́ą́ʼaskʼidígíí	Гаур
Máaz yikááʼ nandahí Spirit	Спирит (марсоход)
Hakʼaz giníłgaii	Кречет
Tsétah jeeshóóʼ łibáhí	Белоголовый сип
Tééh łééchąąʼí łikizhígíí	Пятнистая гиена
Yaaʼ dóó chʼosh bíchį́į́h dadichʼízhí	Скребни
Beeʼeldǫǫh	Мушкет
Chʼosh bitsʼaʼígíí bigaan dahólónígíí	Плеченогие
Tʼąąʼdoolghasí (daadánígíí)	Эндивий
Dlǫ́ʼii (bílaʼashdlaʼii bilį́į́ʼ)	Фретка
Łóóʼtsoh łibáhígíí	Серый кит
Chʼah Diʼilii Bikéyahdę́ę́ʼ atsátsoh	Степной орёл
Yiisnááh	Плен
Dzeeh	Вапити
Tsinlátahgi tsídii nahatʼeʼígíí	Птицы-мыши
Nátʼoh (chʼil)	Табак обыкновенный
Tsin naaʼeeł bee daʼahijighánígíí	Линейный корабль
Tsísʼná yiyání	Щурковые
Bisóodi bizęęs dį́įʼii	Африканский бородавочник
Dlǫ́ʼiitsoh naalzheehígíí	Фосса
Nahachagii biyázhí	Тли
Naalkʼįhiitsoh	Шерстокрылы
Łóóʼ naatʼaʼí	Летучие рыбы
Hakʼaz ayání	Овцебык
Tsétah gah	Пищухи (млекопитающие)
Mąʼiitsoh bikʼos bineʼdę́ę́ʼ łizhinígíí	Гривистый волк
Iichʼąhiitsʼósí	Ручейники
Kéyah Dańlínídę́ę́ʼ atsátsoh	Филиппинский орёл
Tábąąstííntsoh bíchį́į́htsohígíí	Морские слоны
Łóóʼntsxaaí díníchʼahii	Гигантская акула
Chʼosh yighání	Земляной волк
Mágí bitseeʼ noodǫ́zígíí	Кошачий лемур
Táyiʼ chʼoshnézí	Немертины
Dlǫ́tsʼósí łibáhígíí	Линейчатый мунго
Tó naagoʼ	Капля
Dlǫ́ʼiitsoh Danilínígíí	Виверровые
Mágí bigaanézí	Гиббоновые
Bílaneezii	Ай-ай
Séí mąʼii	Корсак
Naalʼeełítsoh bitéél halchíʼí	Краснозобая казарка
Tłʼízí bideeʼ yisdizígíí	Винторогий козёл
Jádí	Вилорог
Wónikǫsí	Привиденьевые
Tééh łééchąąʼí noodǫ́zígíí	Полосатая гиена
Tsídiiłchxoní	Гоацин
Táłtłʼááh chʼoshtʼą́hí bikááʼtsʼinígíí	Панцирные моллюски
Mąʼii bighą́ąʼgi hadzíjiní	Чепрачный шакал
Naakaii Łizhiní Bikéyahdę́ę́ʼ mąʼiiłchííʼ	Эфиопский шакал
Tsétah dibé	Толсторог
Dibé dóó Tłʼízí Ndahalinígíí	Козьи
Mágí bíchį́į́h dootłʼizhígíí	Мандрил
Tó wónaanídę́ę́ʼ dibé ałchiní	Муфлон
Tsiighájíłchí	Повилика
Bįįhyázhí biwooʼnézí	Кабарга
Dzeeh łikizhígíí	Пятнистый олень
Tábąąh mósí ałchiní	Кошка-рыболов
Chį́į́h yee achʼiishíhii	Пилорылые скаты
Shádiʼááhdę́ę́ʼ hodíłchʼil mąʼii	Кустарниковая собака
Hakʼaz mágí	Японский макак
Tsé Biiʼ Ndzisgaii	Долина монументов
Mágí bíchį́į́h niilyoolígíí	Носач
Shádiʼááhdę́ę́ʼ tsídiitsoh	Обыкновенный нанду
Ayání dóó Béégashii Danilínígíí	Быки
Náátsʼózídę́ę́ʼ mósíłtsxooí ałchinígíí	Кошка Темминка
Łóóʼnteeltsoh	Обыкновенная луна-рыба
Gaanłáníchilí dóó Gaanłání doo yitʼíinii	Гидры
Atłʼóóh	Ткачество
Chʼoshkʼaaʼ	Щетинкочелюстные
Tábąąh bįįh	Водяной олень
Hodíłchʼil jeeshóóʼ	Королевский гриф
Dlǫ́ǫ́ʼ bitseetłʼooígíí	Шиншиллы
Achʼąąʼ adáʼatsʼiʼ	Вакцинация
Néʼéshjaaʼ bíńdáhii	Ястребиная сова
Bitseeʼ yee adiłhałii	Миссисипский аллигатор
Jádítsoh noodǫ́zígíí	Бонго (антилопа)
Níyolgi naatʼaʼígíí (tónteel tsídii)	Качурки
Tádídíín yiyání	Листоеды
Tsídiidaashiyishí	Ибисы
Yílnoodii (łóóʼ)	Барракуды
Shádiʼááhdę́ę́ʼ łéʼétsoh bitseeʼ ádinígíí	Агути
Chʼosh bitsʼaʼłáaʼii	Моноплакофоры
Naʼashǫ́ʼii łóóʼ hashkéhé	Плащеносная акула
Jeeshóóʼ	Калифорнийский кондор
Táłkááʼ chʼó	Поручейничек
Chʼosh dilwoʼígíí	Жуки-скакуны
Chʼosh doo yitʼíinii bee nílʼíní	Микроскоп
Tsin ditʼinii	Суслики
Joogii	Голубая сойка
Łeeyiʼ nahakʼízii	Медведки
Náátsʼózídę́ę́ʼ naalʼeełí	Мандаринка (птица)
Mąʼii bijaaʼabanígíí	Большеухая лисица
Tsídiitsoh bikʼos dootłʼizhí	Казуары
Atsiniltłʼish ííłʼíinii (naʼashǫ́ʼii łóóʼ)	Электрический угорь
Dįʼ	Тетеревиные
Łeeyiʼ tłʼiish áłtsʼíísígíí	Scolecophidia
Niicháadii (łóóʼ)	Иглобрюхие
Tééhoołtsódiichilí	Карликовый бегемот
Wóláchííʼ yildeełítsoh	Гигантский муравьед
Dibéʼniiʼí	Феб Сэя
Bináʼadaałtsózí bitsin naaʼeeł	Джонка
Níłtsą́goʼ (bideeneezígíí)	Усачи (жуки)
Tséʼédǫ́ʼii bitsiinézí	Скорпионницы
Tłʼohtahgi díłdánii yił aheełtʼéhii	Трёхперстки
Łóóʼyiniʼįįhí (tónteel tsídii)	Поморниковые
Shádiʼááhdę́ę́ʼ tó hóyáanii	Амазонский дельфин
Naʼashǫ́ʼiitsoh	Настоящие игуаны
Binaʼadaałtsózí dinéʼi	Восток (макрорегион)
Łóóʼ adishishí	Хвостоколовые
Tsin yąąh dzootʼihí	Поползневые
Atʼaʼ yiltʼąąʼí dah sidáhígíí (chʼosh ntsxaaígíí)	Пальмовый вор
Yółeehii	Удильщикообразные
Tiníléí	Аризонский ядозуб
Dijádídlǫ́ʼí	Рогатый жаворонок
Tłʼoh	Газон
Dinas	Толокнянка обыкновенная
Mąʼii bikʼiizgi hadzíjiní	Полосатый шакал
Yadiizį́įgo ayání	Геренук
Télii bijáád noodǫ́zí	Дикий осёл
Bitsʼáá bidaʼhodiʼniil	Тактика выжженной земли
Mágíłchííʼ	Золотистая игрунка
Dááʼadeeʼii	Колпицы
Łóóʼ hashkéhé bitsiiʼ dikʼání	Молотоголовые акулы
Taahilnoodii	Олушевые
Kʼíneedlíshii adiłhashígíí	Рогачи
Łééh yidi tóʼígíí	Водоносный горизонт
Naʼashǫ́ʼiitsoh naʼałkǫ́ʼígíí	Морская игуана
Tsídiisháshii	Свиристели
Naakétłʼáhí	Пима
Yaaʼ bitsʼaʼígíí	Coccoidea
Daateel	Челноклюв
Tééh łééchąąʼí ditsʼozígíí	Бурая гиена
Tsétaʼ łį́į́ʼ	Мустанг
Kénézí	Якановые
Neeshchʼííʼ	Кедровый орех
Naalʼeełítsoh yił aheełtʼéhii łizhin dóó łigaiígíí	Полулапчатый гусь
Mąʼii chʼil	Золотарник
Yaadaaʼnézí (tónteel tsídii)	Водорезы
Tsídii disxǫsígíí	Якамаровые
Náátsʼózídę́ę́ʼ mósíłchíiʼii ałchinígíí	Калимантанская кошка
Shádiʼááhdę́ę́ʼ tsétah mósí ałchinígíí	Андская кошка
Tsinlátahgi dlǫ́ʼiitsoh	Бинтуронг
Jeeshóóʼ łizhinígíí	Американская чёрная катарта
Naałʼashí	Пауки-птицееды
Dééłdą́ą́ʼ	Орляк обыкновенный
Hashkʼaan yildeełígíí (tsídii)	Тураковые
Łį́į́chilí	Шетландский пони
Daakʼį́į́ʼ	Кроншнепы
Mąʼiiłtsooí łibáhígíí	Серая лисица
Naʼashǫ́ʼiitsoh dootłʼizhígíí	Обыкновенная игуана
Chidí bikéíjį́ʼ adeizʼááhígíí	Пикап (кузов)
Bįįh bitseełgaiígíí	Белохвостый олень
Wónitłʼizí	Мокрицы
Díʼdikii (jádí)	Дикдики
Hakʼaz mąʼiitsoh	Мелвильский островной волк
Dark Ages	Тёмные века европейской истории
Ndikʼąʼ biyaʼ	Anthonomus grandis
Tłʼoh naadą́ą́ʼ biyaʼ	Долгоносик амбарный обыкновенный
Łeeyiʼ jááłániichilí	Пауроподы
Aniłtʼánii (bikʼosnézí)	Верблюдки
Dlóóʼ binaalniih	Бубонная чума
Naaʼołí biyaʼ	Зерновки
Ááhooshtʼįįh	Капитуляция
Tséʼédǫ́ʼii dishooí	Журчалки
Tééh tsisteeł	Chelonioidea
Bichʼah Dootłʼizhii	Миротворческие силы ООН
Dlǫ́ʼii łizhin dóó łitsooígíí	Харза
Chʼosh ałchozhii (chéłchaaʼ)	Кожееды
Łeʼesoołii (bitseeʼ naakiígíí)	Двухвостки
Dlǫ́ʼátsoh	Лесной сурок
Chʼééh digháhii dóó Tsisteeł	Черепахи
Tááʼyaʼniiltʼóshii	Кардиналовые
Łóóʼ bigaanłánígo bitsʼaʼígíí	Наутилиды
Łeʼesoołii (bitseeʼ tááʼígíí)	Щетинохвостки
Tłʼézhii	Слепни
Tániilʼáítsʼóóz	Равнокрылые стрекозы
Naashtʼézhí	Зуни (народ)
Aniłtʼániitsʼóóz	Муравьиные львы
Tó wónaanídę́ę́ʼ hazéí bíchį́į́hnézí	Тупайи
Hakʼaz gah	Арктический беляк
Bįįh łikizhígíí (Naakaii Dootłʼizhii Bikéyahdę́ę́ʼígíí)	Аксис
Nahashchʼidí (naaldeehii)	Американский барсук
Tsídii bichʼahtsooígíí	Двурогий калао
Shádiʼááhdę́ę́ʼ bisóodi diʼilígíí	Пекариевые
Náʼagéédí bizaʼazis hólóní	Сумчатые кроты
Bilagáana	Белые люди
Tłʼézhiiłbáhí	Тахины
Shash nátʼoh	Якорцы стелющиеся
Jádítsoh diłhiłígíí	Ньяла
Jádítsoh bideeʼ shiyishígíí	Чёрная антилопа
Dlǫ́ʼiitsoh łikizhígíí	Африканская цивета
Tsinaʼayąʼii yildeełí	Сумчатый муравьед
Tsétah tłʼízí	Снежная коза
Jááłániichilí bighádzígaiígíí	Симфилы
Gahchilí	Айдахский кролик
Tsiishgaii	Поползень-крошка
Cháʼoł bidahtsʼaaʼ	Арцеутобиум
Dééłgai bitsiiʼ halzhinígíí	Черношейный лебедь
Chʼosh nahachagii	Цикадки
Hóółtseiigi naʼastsʼǫǫsí	Песчанковые
Gaanłání	Цериантарии
Dibédą́ą́ʼ	Шефердия
Tádídíín yiyání łichíʼígíí	Лилейная трещалка
Laanaa Yáʼátʼéehgo Késhmish	We Wish You a Merry Christmas
Naʼazǫ́ǫzii	Осы-немки
Jáád neishoodí (naʼashjéʼii haalzheehígíí)	Дорожные осы
Naalʼeełí bidaatsʼózí	Крохали
Chį́į́shłigaií (bílaʼashdlaʼii bilį́į́ʼ)	Домашний гусь
Naalʼeełí łizhinígíí	Турпаны
Nahatʼeʼiitsoh Bikéyahdę́ę́ʼ naalʼeełítsoh łibáhígíí	Куриный гусь
Dahsánítsoh	Хохлатый дикобраз
Naʼastsʼǫǫsí bitseeʼ dichʼízhí	Иглистые мыши
Tsétah nahatʼeʼiitsoh	Скальные валлаби
Táłkááʼ dilwoʼí	Водомерки
Akáshtʼóózh biyaʼ	Сеноеды
Łeʼesoołii (bideeʼ ádinígíí)	Бессяжковые
Ąąʼąʼii	Сороки
Jádí bideeʼ dį́įʼii	Четырёхрогая антилопа
Táłtłʼááh chʼosh ntsxaaígíí	Японский краб-паук
Mósí ałchiní bitsiiʼtʼąhígíí	Суматранская кошка
Naakaii Łizhiní Bikéyahdę́ę́ʼ naalʼeełítsoh dibéłchíʼígíí	Нильский гусь
Hosh aditsahiitsoh	Карнегия
Tʼáá łichíʼígo náʼagéédí	Голый землекоп
Tsisteeł łizhinígíí	Угольная черепаха
Tééh jeeshóóʼ	Африканский гриф
Atʼąąʼ nahalinii	Листотелы
Ghą́ą́ʼnoodǫ́ǫzii (tsin yigházhígíí)	Пакарана
Łéʼétsoh beeniʼíhoniitaahígíí	Свинки
Naʼashǫ́ʼii dichʼízhii	Жабовидные ящерицы
Chéłchaaʼ bikʼosnézí	Trachelophorus giraffa
Ásaaʼ neiyéhii	Нарывники
Naʼashǫ́ʼiitsoh łitsooígíí	Обыкновенный конолоф
Shádiʼááhdę́ę́ʼ tiníléí	Мексиканский ядозуб
Sahdii Bisí (Tsé Nástánii)	Петрифайд-Форест (национальный парк)
Tsé Bighánílíní	Каньон Антилопы
Naakaii Dootłʼizhii bimósí ałchinígíí	Ржавая кошка
Kʼaabizhii	Маммиллярия
Wálázhini	Муравьи-жнецы
Dlǫ́ʼbéʼézhóóʼ	Триостренница
Ndilkal (chʼil)	Тыква вонючая
Chʼįdą́ą́ʼ	Краснокоренник
Jáád neishoodí (łeyiʼdi bighanígíí)	Сфексы
Chʼał bikʼos ádinígíí	Пурпурная лягушка
Níłtsą́goʼ	Pleocomidae
Jéí náyoogisii	Эхиноцереус
Tłʼohtah náshdóí	Leopardus pajeros
Tsídii naʼałkǫ́ʼígíí	Тупики
Tsisteeł diyogí	Бахромчатая черепаха
Łóóʼ adishishí ntsxaaígíí	Манта
Tónteel bibąąh hóyáanii	Беспёрая морская свинья
Naakaii Łizhiní Bikéyahdę́ę́ʼ tsétah dibé	Гривистый баран
Náhookǫsdę́ę́ʼ dlǫ́ʼii	Американская куница
Naalʼeełí naashchʼąąʼígíí	Каролинская утка
Tsinlátah nahatʼeʼiitsoh	Древесные кенгуру
Tsin naaʼeeł łóó beeʼháʼhaalʼééłiʼ	Траулер
Chʼosh biyaʼ	Веерокрылые
Táłtłʼááh chʼosh	Плавунцы
Hastiin John Goodwin	Гудвин, Джон Нобл
Gáagii dinéʼiʼ	Кроу (народ)
Shádiʼááhdę́ę́ʼ tábąąstííntsoh	Южный морской лев
Táłtłʼááh álééh	Большая голубая цапля
Tsísʼnáłtsooítsoh	Шершни
Táłtłʼááh naakaii náásééł yił aheełtʼéhii	Ротоногие
Náátsʼózídę́ę́ʼ tsiiłtsooí	Золотой фазан
Bisóodi Danilínígíí	Нежвачные
Gólízhii noodǫ́zígíí	Полосатый скунс
Tsinlátah naʼashǫ́ʼiitsoh	Iguana delicatissima
Tó bichʼosh (séigoʼ nahalinígíí)	Водяной скорпион обыкновенный
Naʼastsʼǫǫsí bijaaʼntsxaaígíí	Кроличий бандикут
Tsʼání	Западноамериканская сойка
Chʼééh digháhii bitsʼaʼ yilzhólí	Трёхкоготные черепахи
Tó Hajiilneehé	Тохаджилли
Chį́į́shghą́ʼiiłgaii	Каролинский поползень
Hastiin Diego de Landa	Диего де Ланда
Hastiin Biʼééʼ Łichíiʼii	Карсон, Кит
Tábąąstííntsoh (Akééháshį́į́dę́ę́ʼígíí)	Калифорнийский морской лев
Mósí bizaʼazis hólóní	Пятнистые сумчатые куницы
Tségad	Селагинелла
Naaʼołí	Бобы
Hashtłʼishdi chʼééh digháhii	Иловые черепахи
Yaaʼ nahachagiígíí	Блохи
Kéʼ łizhiní	Черноногие
Tábąąsdísí áłtsʼíísí	Пятнистый перевозчик
Náátsʼózídę́ę́ʼ toohjįʼ ndiigaii	Желтоклювая цапля
Dlǫ́ʼii łizhiní	Американский хорёк
Wóláchííʼ yildeełí łizhin dóó łigaígíí	Четырёхпалые муравьеды
Lókʼaatah bisóodi	Кустарниковая свинья
Hodíłchʼil tłʼízí	Суматранский серау
Hakʼaz Dineʼé Bikéyahdę́ę́ʼ tábąąstííntsoh	Сивуч
Dziłtah dlǫ́ʼii	Солонгой
Naayééʼ tsídiitsoh	Моа
Atseełtsoii	Краснохвостый сарыч
Tóniłhę́ęshii (dééł)	Американский журавль
Naaltsoos Mormon Wolyéhígíí	Книга Мормона
Téél halchíʼí	Странствующий дрозд
Dlǫ́ʼátah néʼéshjaaʼ	Кроличий сыч
Naʼashǫ́ʼii bijáád ádinígíí	Двуходки
Naʼatłʼoʼii (chʼosh)	Эмбии
Dííłdzid yiyání	Стафилиниды
Tsintah łéʼétsoh	Лесные хомяки
Kʼiishzhinii (tsin)	Граб каролинский
Tʼiisbáí	Тополь осинообразный
Yáhashjool yázhí	Индийский волчок
Tłʼéeʼgo mágí	Ночные обезьяны
Náʼagéédíchilí	Американский землеройковый крот
Tsʼíʼii jáádnézí	Комары-долгоножки
Chʼil ditsʼozíłchííʼ	Рамбутан
Mágíłtsooí bináázhiní	Обыкновенная беличья обезьяна
Taʼneeskʼání	Канталупа (растение)
Tsídiiłtsooí bitʼaʼ łizhinígíí	Американский чиж
Tsʼíʼii noodǫ́zí	Aedes albopictus
Anaasází	Анасази
Chʼééh digháhiitsoh	Слоновая черепаха
Tsineeshbízhii	Американская пищуха (птица)
Yeenaʼałkǫ́ʼíłániichilí	Ремипедии
Naʼnízhoozhí Bił Hahoodzo	Мак-Кинли (округ, Нью-Мексико)
Mąʼii Deeshgiizh Bił Hahoodzo	Сандовал (округ, Нью-Мексико)
Naatoohí Bił Hahoodzo	Цибола (округ, Нью-Мексико)
Tábąąstííntsoh łikizhígíí	Ларга (млекопитающее)
Ooljééʼ yiikááʼ nandahí	Список прилунений
Toohjįʼ noołnahii yázhí	Американская зелёная кваква
Báshdo	Барстоу (Калифорния)
Łóóʼ hashkéhé bíchį́į́hnézí	Акула-домовой
Tłʼiishtsiiʼí (łóóʼ)	Змееголовые
Chéłchaaʼ bideeneezígíí	Жук-геркулес
Déłí	Канадский журавль
Ąąʼąʼiiłbáhí	Голубая сорока
Tsétah chaaʼ	Аплодонтия
Sighóla	Сокорро (Нью-Мексико)
Chéłchaaʼ disxǫsígíí	Златки
Naalʼeełí dootłʼizhí	Голубокрылый чирок
Béíyózhin	Пайюты
Tsin naabąąs	Фургон (повозка)
Dlǫ́tsʼósí łichííʼígíí	Кольцехвостый мунго
2010 yihahígíí bílaʼashdlaʼii náóltahígíí	Перепись населения США (2010)
Jádídlǫ́ʼii	Домовый крапивник
Tséʼédǫ́ʼii	Настоящие мухи
Chʼagiitsoh	Желтоголовый трупиал
Gad niʼeełí	Можжевельник скальный
Níyolgi naʼałkǫ́ʼígíí (tónteel tsídii)	Нырковые буревестники
Tsinaʼayąʼii biyázhí	Зораптеры
Sóól dichʼíizhii	Клён голый
Tłʼízíʼilí	Ангорская коза
Naatooh Sikʼaiʼí	Грантс
Tsooʼtsʼiní (łóóʼ)	Аравановые
Tsinaʼayąʼii	Термиты
Náʼagéédí bíchį́į́h sǫʼ nahalinígíí	Звездонос
Naaléełchííʼ	Толстоклювый ара
Naaʼahóóhai disxǫsígíí	Моналы
Tsįyaatsiiłchííʼ	Красный тиранн
Náhookǫsdę́ę́ʼ tsétah dibé	Баран Далла
Naʼnízhoozhí	Гэллап (город)
Neeshchʼíínímazí	Лесной орех
Tsisteeł bikʼosneezígíí	Змеиношеие черепахи
Kilim	Килим
Táłtłʼááh wónitłʼizí	Водяной ослик
Naatsisʼáán bińdíshchííʼ	Сосна мягкая
Chąąneiłhizii	Карапузики
Nákʼeʼnáʼijiní	Канадский поползень
Ałtaʼneetsʼéhii	Дурнишник
Wáláchíʼétah nahachagiichilí	Муравьелюбы
Yáhashjool yił aheełtʼéhii	Солнечная цапля
Tsintah bisóoditsoh	Большая лесная свинья
Zééjíjinii	Хохлатая паламедея
Chʼał bideeʼ hólóní	Ceratophryinae
Dziłghą́ʼiʼ	Западные апачи
Naʼashǫ́ʼii hááʼáchʼiidí	Леопардовые ящерицы
Naalkʼįhíchilí (bizaʼazis hólónígíí)	Карликовый летучий кускус
Dlǫ́ʼii yił aheełtʼéhii łibáhígíí	Индийский серый мунго
Adijiłii yił aheełtʼéhí	Малые тенреки
Łóóʼ hashkéhé bitseeneezígíí	Обыкновенная морская лисица
Chį́į́shłigaií dóó Naalʼeełítsoh	Гусиные
Jádí biniiʼtsʼózí	Конгони
Tábąąh jádí	Обыкновенный водяной козёл
Jádí binááʼ dį́įʼii	Бубал Хантера
Tó wónaanídę́ę́ʼ dlǫ́ʼáyázhí	Европейский суслик
Ásáí Dineʼé Bikéyahdę́ę́ʼ mąʼiitsoh	Аравийский волк
Dlǫ́iitsoh bíchį́į́hdzísgaiígíí	Гималайская цивета
Aniłtʼánii yázhí	Листоблошки
Chʼał mágí nahalinii	Чакская филломедуза
Sǫʼ tsisteeł	Лучистая черепаха
Nahatʼeʼiitsoh Bikéyahdę́ę́ʼ tązhii	Кустарниковый большеног
Mąʼii dootłʼizhí	Североамериканский какомицли
Táłkááʼ dilwoʼítsʼóóz	Палочковидные водомерки
Łeʼesoołii (nahachaʼígíí)	Древнечелюстные
Tóidoozohii bidaaʼ łigaiígíí	Лысухи
Chéłchaaʼtsoh	Дупляки
Wódisxǫsí	Щитники-черепашки
Kʼaalógiitsoh disxǫsígíí	Морфо
Tsisteeł hashkéhé	Каймановые черепахи
Naʼastsʼǫǫsí bizaʼazis hólóní	Сумчатые мыши
Wáláchííʼ	Рыжая мирмика
Tsídiidą́ą́ʼ	Флокс
Wóniłchxoní	Настоящие щитники
Tsiikʼánii (tsídii)	Молотоглав
Nahatʼeʼii niłchxoní	Мускусная кенгуровая крыса
Náátsʼózídę́ę́ʼ tsiidootłʼizhii	Фазан аргус
Ábishjaaʼ (daadánígíí)	Съедобные грибы
Tábąąh bisóodiłchíiʼii	Кистеухая свинья
Tiníléítsoh naʼałkǫ́ʼígíí	Полосатый варан
Kézhoozhʼilí (tsin yigházhígíí)	Гребнепалые
Jádí bideeneezígíí	Ориксы
Beehai	Хикарилья
Mágíłbáhí	Голубая мартышка
Jaaʼditłʼoʼí naalkʼįhígíí (bizaʼazis hólónígíí)	Гигантский летучий кускус
Nahatʼeʼiitsoh yázhí	Филандеры
Séí tiníléítsoh	Варан Гульда
Dlǫ́ʼii yił aheełtʼéhítsʼózí	Стройный мангуст
Łóóʼ bigháhootʼíní	Стеклянные окуни
Tʼiis	Тополь пирамидальный
Chʼosh áłtʼą́ą́ʼígíí	Наземники
Dééłtsoh	Африканская большая дрофа
Shádiʼááhdę́ę́ʼ dahsání	Цепкохвостый дикобраз
Dlǫ́ʼii bitseenézí	Длиннохвостая ласка
Kéyahígíí nidineesdzaʼ	Пыльный котёл
Nahachagii dootłʼizhí	Кузнечиковые
Tsé Bíyah Aniiʼáhí	Чако (национальный исторический парк)
Nahatʼeʼiitsoh Bikéyahdę́ę́ʼ biyázhí neiyéhé	Лисий кузу
Naaʼahóóhaiłbáhí	Куропатки
Tsísʼnádą́ą́ʼ	Гайлардия
Jeeshóóʼ ałchozhígíí	Пальмовый гриф
Łóóʼ adiłdoní	Брызгуны
Dlǫ́ʼii yił aheełtʼéhii łitsxooígíí	Жёлтый мангуст
Naakaii Łizhiní Bikéyahdę́ę́ʼ nahatʼeʼii	Долгоног
Táłtłʼááh chʼosh chʼééh digháhii bitsʼaʼ ádinígíí	Голожаберные
Tiníléítsoh noodǫ́zígíí	Нильский варан
Naʼashǫ́ʼii bideewozhii	Шипохвосты
Chʼał ntsxaaígíí	Лягушка-голиаф
Tééh naaʼahóóhaitʼą́ʼí	Турачи (род птиц)
Naalʼeełí (bílaʼashdlaʼii bilį́į́ʼ)	Домашняя утка
Yáhashjool	Американская выпь
Dlǫ́ʼii yił aheełtʼéhii yázhí	Карликовый мангуст
Nahatʼeʼiitsoh Bikéyahdę́ę́ʼ tábąąstííntsoh	Австралийский морской лев
Mąʼiiłtsooí yázhí	Vulpes macrotis
Gałbáhí	Американские кролики
Tsékááʼgóó naagháhii (chʼosh)	Mantophasmatodea
Tłʼohtahilzhahí	Кариамовые
Táłtłʼááh tsxilghááhtsoh	Скрытожаберники
Dibé dághaaʼígíí	Японский сероу
Chʼééh digháhii bitsiiʼntsxaaígíí	Большеголовая черепаха
Tsékʼi naʼałkǫ́ʼii	Пиренейская выхухоль
Naʼastsʼǫǫsítsoh (chʼosh yildeełígíí)	Гаитянский щелезуб
Tsídiiłtsooí	Жёлтая древесница
Chʼagii	Красноплечий чёрный трупиал
Łéʼétsoh diwozhí	Обыкновенная гимнура
Łéʼétsoh bizaʼazis hólóní	Двугребнехвостая сумчатая мышь
Dlǫ́ʼiitsoh noodǫ́zígíí	Полосатая цивета
Tábąąstííntsoh łizhin dóó łigaiígíí	Полосатый тюлень
Jeeshóóʼ bitsiiłgaiígíí	Африканский белогорлый гриф
Tábąądijádí	Крикливый зуёк
Shádiʼááhdę́ę́ʼ niłchiis	Гризоны
Naʼazísí	Гоферовые
Łeeyiʼ chʼał dichʼízhí	Носатая жаба
Naakaii Dootłʼizhí Dabikéyah	Южная Азия
Sháńdíín bitsʼą́ą́dę́ę́ʼ atsiniltłʼish álʼį́	Солнечная батарея
Naʼashǫ́ʼii kááʼtsʼinígíí	Малый поясохвост
Atsá diłhiłígíí	Орёл-яйцеед
Bisóodi dághaaʼígíí	Бородатая свинья
Iichʼąhii biyázhí	Белокрылки
Dólii	Голубая сиалия
Tsiikʼánii (łóóʼ ooshgę́ęzhii)	Рохлевые скаты
Biniiʼdootłʼizh	Воробьиные сычи
Mágí biniiłgaígíí	Бледный саки
Wónaʼałtéhii	Ктыри
Tłʼoh azihii	Хвойник
Kʼaalógii bitʼaʼ disxǫsgo łikizhígíí	Риодиниды
Shádiʼááhdę́ę́ʼ gahniiʼí ntsxaaígíí	Мары (грызуны)
Łéʼétsoh bitseetłʼooígíí	Скальная крыса
Tsídii bizééʼ naashchʼąąʼí	Трагопаны
Tábąąsdísíłbáí	Бекасовидные веретенники
Dilzhę́ʼii	Стеллерова черноголовая голубая сойка
Mágí naashchʼąąʼígíí	Немейский тонкотел
Chʼosh naʼałkǫ́ʼí	Водолюбы
Tééh jádítsoh	Канны (антилопы)
Łeeyiʼ bitiiní	Полёвковые
Atsáłbáí	Мексиканский сокол
Dáádílítsoh	Индоокеанский малоглазый групер
Tsétah bįįhchilí	Пуду
Kiisʼáanii	Пуэбло
Jeeshóóʼ bitsiiłtsooí	Малая желтоголовая катарта
Dlǫ́ʼii noodǫ́zígíí	Африканская ласка
Tiníléítsoh dootłʼizhígíí	Зелёный варан
Yáázhłání (naaldlooshii)	Обыкновенный тенрек
Łéʼétsoh yił aheełtʼéhii	Восьмизубовые
Ghą́ą́ʼdiʼilii (tsin yigházhígíí)	Косматый хомяк
Lókʼaaʼ yigházhígíí	Тростниковые крысы
Tsídii bitʼaʼ dah adadootłʼizhígíí	Павлиньи фазаны
Dilchʼóshii	Юнко
Chį́į́hʼadeeʼii (łóóʼ)	Веслоносовые
Hazéíntsxaaígíí	Гигантские белки
Chʼałniiʼí (łóóʼ)	Батраховые
Dah Naatʼaʼí Bééhoʼdílzin	Клятва верности флагу США
Tónteel táshchozhii	Крачковые
Naʼastsʼǫǫsí noodǫ́zígíí	Полосатые травяные мыши
Tówoł	Таос
Kʼish biyaʼ dootłʼizhígíí	Листоед ольховый
Dóliiłchííʼ	Западная сиалия
Aniłtʼánii (nahakʼízígíí)	Стеблевые сверчки
Aniłtʼánii łizhinígíí	Вислокрылки
Mágí bichį́į́łgaígíí	Краснохвостая мартышка
Tábąąh chʼosh	Прибрежники
Naakaii Bikéyahdę́ę́ʼ bįįh yázhí	Мазамы
Naʼashǫ́ʼii dootłʼizhí (naaldeehii)	Ошейниковая пустынная игуана
Naʼashǫ́ʼiiłbáhí	Пустынная игуана
Dlǫ́tsʼósí noodǫ́zígíí	Мунго Грандидье
Łéʼétsoh gahjaaʼígíí	Воалаво
Chʼoshtsoh bíláshgaanʼilí	Kiwa hirsuta
Anáʼálwoʼ:Bee hadítʼéhígíí	Википедия:Справка
Táłtłʼááh chʼoshtsoh bideeneezí	Настоящие лангусты
Táshchozhiizhiin	Чёрный феб
Moháábii dinéʼiʼ	Мохаве (племя)
Néʼéshjaaʼkálii	Сыч-эльф
Tsídii bitʼaʼ hózhóón	Райские птицы (род)
Tiníléítsoh łikizhígíí	Гигантский варан
Tiníléítsoh bíchį́į́h dikʼání	Varanus albigularis
Tsé noolchʼóshiiłbáhí	Скальный длинноклювый крапивник
Chʼiyíítʼogii	Королевские тиранны
Dloziłgaii	Красные белки
Tsísʼná dootłʼizhí	Осы-блестянки
Halchíítah	Цветная пустыня
Wóósitsʼílí	Постельный клоп
Tsidiłdǫǫhii	Megascops
Łéʼétsoh binááʼ ádiní	Слепыши (род)
Tábąąh ndoochííʼ	Грушанка зелёноцветковая
Kǫʼ naʼałbąąsii hééł bee nágéhéʼ	Грузовой поезд
Tádídíín dootłʼizh áłtsʼíísí	Колокольчик одноцветковый
Jaaʼabaní	Летучие мыши
Chʼosh chʼééh digháhii bideeʼ dį́įʼii	Стебельчатоглазые
Niłchʼiʼ bee naalkaahiʼ	GOES
Tséʼédǫ́ʼii łibáhígíí	Серые мясные мухи
Dlozishzhiin	Белка Аберта
Aniłtʼánii (naakaii náásééł nahalinígíí)	Мантиспиды
Tsisteeł naʼazísí	Гоферы (черепахи)
Tségháhoodzání	Уиндоу-Рок
Tótaʼ	Фармингтон
Tséyiʼ (Chʼínílį́įgiʼígíí)	Каньон-де-Шей
Chʼoshtsoh bíláshgaantsohí (tónteelgiʼígíí)	Омары
Tábąąstííntsoh bighaaʼ díłchʼilígíí	Морские котики
Kʼaiʼbisii	Бурый короткоклювый дрозд
Dlǫ́ʼiiłtsooí	Японский соболь
Táshchozhii dootłʼizhí	Пурпурная лесная ласточка
Tsísʼnáłtsooí	Vespula
Jélii łóóʼ daʼhólzhaʼígíí	Сальпы
Gólízhii binághah dah łigaiígíí	Мексиканский скунс
Dloziłbáhí	Западная серая белка
Nahatʼeʼii jáádnézí	Пустынные тушканчики
Tsiiʼnteelí (łóóʼ)	Плоскоголововые
Chíshí	Чирикауа (племя)
Bikétłʼááh Hoolzhólígíí	Мозоленогие
Chíshii Kʼíneeshbizhii	Краснопоясничный пеночковый певун
Nááʼnoodǫ́ǫzii	Ярутка
Tóidoozohii dootłʼizhígíí	Султанки
Chʼagiiłbáhí	Коровьи трупиалы
Jáád neishoodítsʼóóz	Настоящие наездники
Bitsiichįįshgahí	Североамериканская ореховка
Naʼashǫ́ʼii naatʼaʼí	Летучие драконы
Iichʼąhii naashchʼąąʼígíí	Урания мадагаскарская
Wóóseetsʼiniiniłhiní	Пещерные кузнечики
Ałchʼįʼ beʼastłʼóní	Тамале (блюдо)
Tó bichʼosh (wónikǫsí nahalinígíí)	Ранатра
Biniiʼnoodǫ́zí (tsin yigázhígíí)	Равнинная вискаша
Tsísʼnátsoh diłhiłígíí	Пчёлы-плотники
Chʼil łigaii (Ałtsʼáʼáztiin)	Капуста (значения)
Aniłtʼánii (bideeneezígíí)	Аскалафы
Shádiʼááhdę́ę́ʼ chʼoshtsoh bíláshgaantsohí	Parastacidae
Gahjaaʼí bitseeneezígíí	Горные вискаши
Naaldlooshii Bikéshgaan Dahólónígíí	Копытные
Nóódaʼí	Юты (народ)
Táłkááʼ dilwoʼí yázhí	Велии
Táłtłááh chʼoshyog	Nereidae
Dlǫ́ʼii yił aheełtʼéhii diłhiłígíí	Южноафриканский мангуст
Gadtsagí	Можжевельник односемянный
Chʼosh bitsʼaʼ doolghasígíí	Морские гребешки
Hashkʼaan bichʼosh	Продоксиды
Chaatʼíní bichʼosh	Щавелевый листоед
Tádídíín yiyání łizhinígíí	Timarcha
Chʼałdą́ą́ʼ bichʼosh	Трещалки (род)
Niʼbéshjah	Аморфа
Tsékʼi Naʼasdzooí (Yootó Hahoodzo)	Эль-Морро
Tsídii bidaatsoh naashchʼąąʼí	Тукановые
Chʼał bikéshgaan hólóní	Шпорцевые лягушки
Tó bichʼosh (ałchozhígíí)	Гребляки
Tsékʼi yaʼiiʼáhii	Бражник табачный
Tsédááʼii	Панцирные клещи
Dahiitį́į́hildaaʼígíí	Лобелия пурпурная
Atʼaʼ éljołí nahalinígíí (táłtłʼááh chʼosh)	Сабеллиды
Tʼááłáhági átʼéego:Bééshbichʼahí	Категория:Германия
Tʼááłáhági átʼéego:Wááshindoon bikéyah ałhidadiidzooígíí	Категория:США
Táłtłʼááh kʼaaʼ (łóóʼ)	Свистульки (рыбы)
Tʼááłáhági átʼéego:Dibé diníí bikéyah	Категория:Испания
Tʼááłáhági átʼéego:Naakaii Bikéyah	Категория:Мексика
Wóódeʼełchíhii	Краевики
Naʼashǫ́ʼii diwozhígíí	Гигантский поясохвост
Choozhghalii	Цветные трупиалы
Tsinlátah mąʼii	Олинго
Tsiiyah wozhii	Луговые трупиалы
Chʼóyáázh nahalinígíí (táłtłʼááh chʼosh)	Spirobranchus giganteus
Naatsédlózii	Кукушки-подорожники
Tʼááłáhági átʼéego:Bidił daazdoígíí dóó daʼałtʼoʼígíí	Категория:Млекопитающие
Tʼááłáhági átʼéego:Naaldlooshii dadichʼízhii	Категория:Пресмыкающиеся
Tʼááłáhági átʼéego:Biyáázh Tsʼǫʼasánígíí	Категория:Земноводные
Tʼááłáhági átʼéego:Tsídii	Категория:Птицы
Tʼááłáhági átʼéego:Chʼosh doo yitʼíinii dláádí dóó Ábishjaaʼ	Категория:Грибы
Tʼááłáhági átʼéego:Chʼil	Категория:Растения
Tʼááłáhági átʼéego:Nátʼą́ą́ʼ náháneʼ	Категория:История
Tʼááłáhági átʼéego:Naʼalkaah	Категория:Наука
Béégashii bideetsohí	Ватусси
Dził Nááyisí	Сандия (горы)
Góóhníinii	Хавасупай
Azeeʼ ndootʼeezhítsoh	Монарда дудчатая
Tsísʼná disxǫsígíí	Euglossini
Łóóʼtsoh bizábąąh shiyishí	Южные киты
Kiisʼáanii Naakáí yikʼéʼ daʼdéísdlį́į́h	Восстание пуэбло
Tsin bizęęs	Полипорус
Dah yiskʼid	Насыпь
Aniłtʼánii łibáhígíí	Клопы-охотники
Wóótsʼóóz	Alydidae
Iichʼąhii	Моли
Roman dinéʼiʼ	Древний Рим
Maricopa dinéʼiʼ	Марикопа (народ)
Azeeʼ ndootʼeezhí	Монарда точечная
Shádiʼááhdę́ę́ʼ tsékʼi dlǫ́ǫ́ʼ	Моко
Naabeehó	Навахо-нейшен
Chʼoshtsoh bikágí diwozhí	Крабоиды
Dilzhʼíʼ	Явапаи
Dáádílí ntsxaaígíí	Гуаса
Waalibéí dinéʼiʼ	Валапай
Kégiizhí	Папаго
Chʼosh ałchozhii (iichʼąhii)	Моль платяная
Wóóchį́į́hnézí	Фонарницы
Tsiitsʼiin łichíʼítsoh	Лжекузнечиковые
Bitátʼahkin	Навахо (национальный монумент)
Anaashashi dinéʼiʼ	Тева
Tʼááłáhági átʼéego:Ałtsʼáʼáztiin	Категория:Многозначные термины
Tsintah bįįhchilí	Азиатские оленьки
Yiikʼiʼdaʼ hiiznáʼ	Наступление
Tsékʼi naʼazólii	Чаквеллы
Juan de Oñate	Оньяте, Хуан де
Hastiin Antonio de Espejo	Эспехо, Антонио де
Deezʼáahjįʼ	Валпи
Yaaʼííʼáhí (Bidááʼ Haʼaztʼiʼ Tsékooh)	Дезерт-Вью
Gad diltáłii	Можжевельник толстокорый
Tsétsohkʼįįʼ	Снежноягодник округлый
Atsá	Орлиные
Atsábéʼézhóóʼ	Бородач скученный
Ndilnaʼii	Folivora
Tsísʼnáyázhí	Галиктиды
Chʼałtʼą́hí	Пипы
Iichʼąhiiłgai bitʼaʼnézí	Совка агриппина
Beeʼaghádaʼdildlaadí	Рентгеновский сканер
Wóótʼą́hí	Подкорники
Chʼil naʼatłʼoʼiitsʼóóz	Ломонос лигустиколистный
Tsédédééh	Мирабилис многоцветковый
Jááłánii bitsiitsʼiin łichííʼígíí	Калифорнийская сколопендра
Jááłánii noodǫ́zígíí	Scolopendra polymorpha
Chʼil łizhiní	Колеогине
Báshdodi chidí naatʼaʼí ńdinibįįhígi	Барстоу-Даггетт (аэропорт)
Tʼááłáhági átʼéego:Stubs	Категория:Незавершённые статьи
Tʼááłáhági átʼéego:Chidí naatʼaʼí	Категория:Воздушные суда
Bee álnééhí:User uk-2	Шаблон:User uk-2
Tʼááłáhági átʼéego:Wikipedia bots	Категория:Участники:Боты
Tónteel zhį́ʼii	Баклановые
Niłtsínii bikétłʼóól dijoolí (daadánígíí)	Турнепс
Tsídii bitseeʼ naashchʼąąʼí	Павлины
Bee álnééhí:Tl	Шаблон:Tl
Tʼááłáhági átʼéego:Bee Hazʼáanii	Категория:Право
Tʼááłáhági átʼéego:Kéyah daʼnaaznilígíí dóó kéyah biłhaʼdaʼhaasdzoígíí	Категория:Страны
Wikiibíídiiya:Dahwéetʼaahígíí	Википедия:Администраторы
Wikiibíídiiya:Botígíí beehazʼą́ąnii	Википедия:Бот
Ííjip	Египет
Jiłhazhí	Каркас сетчатый
Dlodziłgaii bitseeʼ (tłʼoh)	Многобородник монпелиенский
Bee álnééhí:Bot	Шаблон:Bot
Deeteel Bikéyah	Канада
Wikiibíídiiya:Baa haneʼ	Википедия:Описание
Tʼááłáhági átʼéego:Béésh bichʼahníí bikéyah	Категория:Страны Европы
Tʼááłáhági átʼéego:Wikiibíídiiya yee Hadítʼéhígíí	Категория:Классификация по главным темам
Tʼááłáhági átʼéego:Choyoołʼįįhí Bizaad	Категория:Википедия:Участники по языкам
Anáʼálwoʼ:Wikiibíídiiya beehazʼą́ąnii	Википедия:Правила и указания
Tséłnííʼjí (chʼil)	Адиантум венерин волос
Bee álnééhí:Softredirect	Шаблон:Soft redirect
Chʼosh chʼééh digháhii	Брюхоногие
Diné Bizaad yee Nidaazbaaʼígíí	Шифровальщики навахо
Tʼááłáhági átʼéego:Saad	Категория:Языки
Wikiibíídiiya:General disclaimer	Википедия:Отказ от ответственности
Tʼááłáhági átʼéego:Noindexed pages	Категория:Неиндексируемые страницы
Wikiibíídiiya:Statistics	Википедия:Статистика
Nahatʼeʼiitsoh	Кенгуру
Łóóʼ hashkéhéchilí	Химерообразные
Tʼááłáhági átʼéego:Living people	Категория:Ныне живущие
Tʼááłáhági átʼéego:Béésh bee akʼeʼelchíhí tʼáá bí nitsékeesígíí	Категория:Цифровые вычисления
Bee álnééhí:Bots	Шаблон:Bots
Tʼááłáhági átʼéego:Naaltsoos	Категория:Книги
Bee álnééhí:Wikisource	Шаблон:Викитека
Bee álnééhí:Babel	Шаблон:Babel
Bee álnééhí:Commons	Шаблон:Commons
Bee álnééhí:Reflist	Шаблон:Примечания
Bee álnééhí:Stub	Шаблон:Заготовка
Bee álnééhí:User af-1	Шаблон:User af-1
Bee álnééhí:User als-1	Шаблон:User als-1
Bee álnééhí:User ar-1	Шаблон:User ar-1
Bee álnééhí:User az	Шаблон:User az
Bee álnééhí:User eo-1	Шаблон:User eo-1
Bee álnééhí:See also	Шаблон:См. также
Bee álnééhí:User da-2	Шаблон:User da-2
Bee álnééhí:User da	Шаблон:User da
Bee álnééhí:User ca-1	Шаблон:User ca-1
Bee álnééhí:User ca-4	Шаблон:User ca-4
Bee álnééhí:User be-2	Шаблон:User be-2
Bee álnééhí:User da-1	Шаблон:User da-1
Bee álnééhí:User cs-1	Шаблон:User cs-1
Bee álnééhí:User bg-1	Шаблон:User bg-1
Bee álnééhí:User eo-3	Шаблон:User eo-3
Bee álnééhí:User de	Шаблон:User de
Bee álnééhí:User de-1	Шаблон:User de-1
Bee álnééhí:User eu	Шаблон:User eu
Bee álnééhí:User et-1	Шаблон:User et-1
Bee álnééhí:User el	Шаблон:User el
Bee álnééhí:User es	Шаблон:User es
Bee álnééhí:User de-3	Шаблон:User de-3
Bee álnééhí:User en-3	Шаблон:User en-3
Bee álnééhí:User el-1	Шаблон:User el-1
Bee álnééhí:User en-1	Шаблон:User en-1
Bee álnééhí:User en-2	Шаблон:User en-2
Bee álnééhí:User fa-1	Шаблон:User fa-1
Bee álnééhí:User eo-2	Шаблон:User eo-2
Bee álnééhí:User en-4	Шаблон:User en-4
Bee álnééhí:User fi	Шаблон:User fi
Bee álnééhí:User en-0	Шаблон:User en-0
Bee álnééhí:User es-4	Шаблон:User es-4
Bee álnééhí:User en	Шаблон:User en
Bee álnééhí:User de-2	Шаблон:User de-2
Bee álnééhí:User es-1	Шаблон:User es-1
Bee álnééhí:User fa	Шаблон:User fa
Bee álnééhí:User fi-1	Шаблон:User fi-1
Bee álnééhí:User fr-1	Шаблон:User fr-1
Bee álnééhí:User ia-2	Шаблон:User ia-2
Bee álnééhí:User hi-1	Шаблон:User hi-1
Bee álnééhí:User hr	Шаблон:User hr
Bee álnééhí:User he-2	Шаблон:User he-2
Bee álnééhí:User he-1	Шаблон:User he-1
Bee álnééhí:User hu	Шаблон:User hu
Bee álnééhí:User id-3	Шаблон:User id-3
Bee álnééhí:User io-3	Шаблон:User io-3
Bee álnééhí:User it-3	Шаблон:User it-3
Bee álnééhí:User grc-1	Шаблон:User grc-1
Bee álnééhí:User ja-4	Шаблон:User ja-4
Bee álnééhí:User sk	Шаблон:User sk
Bee álnééhí:User tr-2	Шаблон:User tr-2
Bee álnééhí:User fr-2	Шаблон:User fr-2
Bee álnééhí:User tr	Шаблон:User tr
Bee álnééhí:User ja	Шаблон:User ja
Bee álnééhí:User ja-1	Шаблон:User ja-1
Bee álnééhí:User it-1	Шаблон:User it-1
Bee álnééhí:User hr-1	Шаблон:User hr-1
Bee álnééhí:User fr	Шаблон:User fr
Bee álnééhí:User he	Шаблон:User he
Tʼááłáhági átʼéego:Chʼosh bijáád hastánígíí	Категория:Насекомые
Tʼááłáhági átʼéego:Choyoołʼįįhí uk	Категория:User uk
Tʼááłáhági átʼéego:Choyoołʼįįhí uk-N	Категория:User uk-N
Tʼááłáhági átʼéego:Chʼiyáán	Категория:Пища
Bee álnééhí:User sv	Шаблон:User sv
Bee álnééhí:User it	Шаблон:User it
Bee álnééhí:User uk	Шаблон:User uk
Bee álnééhí:User es-2	Шаблон:User es-2
Tʼááłáhági átʼéego:Choyoołʼįįhí ms	Категория:User ms
Tʼááłáhági átʼéego:Choyoołʼįįhí fr-1	Категория:User fr-1
Bee álnééhí:Image label	Шаблон:Метка изображения
Bee álnééhí:User ms	Шаблон:User ms
Tʼááłáhági átʼéego:Atsá dóó Giní Ndahalinígíí	Категория:Соколообразные
Bee álnééhí:User hi-3	Шаблон:User hi-3
Tʼááłáhági átʼéego:Choyoołʼįįhí en-4	Категория:User en-4
Tʼááłáhági átʼéego:Choyoołʼįįhí en	Категория:User en
Tʼááłáhági átʼéego:Choyoołʼįįhí zh	Категория:User zh
Tʼááłáhági átʼéego:Choyoołʼįįhí zh-N	Категория:User zh-N
Tʼááłáhági átʼéego:Choyoołʼįįhí en-2	Категория:User en-2
Bee álnééhí:User eo	Шаблон:User eo
Bee álnééhí:User zh	Шаблон:User zh
Bee álnééhí:User ru-4	Шаблон:User ru-4
Bee álnééhí:User sr	Шаблон:User sr
Bee álnééhí:GeoTemplate	Шаблон:GeoTemplate
Bee álnééhí:User nl-1	Шаблон:User nl-1
Bee álnééhí:User nl-2	Шаблон:User nl-2
Tʼááłáhági átʼéego:Néʼéshjaaʼ	Категория:Совообразные
Tʼááłáhági átʼéego:Choyoołʼįįhí hi	Категория:User hi
Tʼááłáhági átʼéego:Choyoołʼįįhí ms-N	Категория:User ms-N
Tʼááłáhági átʼéego:Dził	Категория:Горы
Bee álnééhí:User ru	Шаблон:User ru
Tʼááłáhági átʼéego:Kéyah yádiłhił biiʼ dahólónígíí	Категория:Планеты Солнечной системы
Tʼááłáhági átʼéego:Kéyah dah siʼánígíí	Категория:Америка
Tʼááłáhági átʼéego:Choyoołʼįįhí bizaad-Templates	Категория:Шаблоны участников:По языкам
Bee álnééhí:Archive	Шаблон:Архив
Bee álnééhí:User eo-4	Шаблон:User eo-4
Bee álnééhí:PD-US-gov	Шаблон:PD-USGov
Tʼááłáhági átʼéego:Siláołtsooí	Категория:Вооружённые силы
Tʼááłáhági átʼéego:Naʼashǫ́ʼii	Категория:Ящерицы
Bee álnééhí:User pt-1	Шаблон:User pt-1
Bee álnééhí:Tb	Шаблон:Ответ
Bee álnééhí:Pt elements	Шаблон:Периодическая система элементов
Bee álnééhí:User oc-4	Шаблон:User oc-4
Bee álnééhí:User pl	Шаблон:User pl
Bee álnééhí:User nl	Шаблон:User nl
Bee álnééhí:User no-2	Шаблон:User no-2
Bee álnééhí:Image label end	Шаблон:Image label end
Bee álnééhí:Userpage	Шаблон:Userpage
Bee álnééhí:Emergency-bot-shutoff	Шаблон:Аварийное выключение бота
Bee álnééhí:User pl-1	Шаблон:User pl-1
Bee álnééhí:Image label small	Шаблон:Image label small
Bee álnééhí:User fr-3	Шаблон:User fr-3
Bee álnééhí:User lt	Шаблон:User lt
Bee álnééhí:User nds-1	Шаблон:User nds-1
Tʼááłáhági átʼéego:Hosh	Категория:Кактусовые
Bee álnééhí:User tr-4	Шаблон:User tr-4
Bee álnééhí:User is-1	Шаблон:User is-1
Bee álnééhí:User is-2	Шаблон:User is-2
Bee álnééhí:User ce	Шаблон:User ce
Bee álnééhí:User ar-2	Шаблон:User ar-2
Bee álnééhí:User ar-3	Шаблон:User ar-3
Bee álnééhí:User is	Шаблон:User is
Bee álnééhí:User ar	Шаблон:User ar
Bee álnééhí:User az-3	Шаблон:User az-3
Bee álnééhí:User en-5	Шаблон:User en-5
Tʼááłáhági átʼéego:Choyoołʼįįhí ja-N	Категория:User ja-N
Bee álnééhí:User als	Шаблон:User als
Bee álnééhí:@	Шаблон:@
Tʼááłáhági átʼéego:Tłʼoh	Категория:Злаки
Bee álnééhí:Ałtsʼáʼáztiin	Шаблон:Неоднозначность
Bee álnééhí:User no-3	Шаблон:User no-3
Bee álnééhí:User ksh	Шаблон:User ksh
Bee álnééhí:User no	Шаблон:User no
Bee álnééhí:User yue-1	Шаблон:User zh-yue-1
Bee álnééhí:Chʼiyáánbiiʼ	Шаблон:Питательный состав
Bee álnééhí:User sv-2	Шаблон:User sv-2
Bee álnééhí:User it-2	Шаблон:User it-2
Tʼááłáhági átʼéego:Kǫʼ naʼałbąąsii	Категория:Железнодорожный транспорт
Bee álnééhí:User pt-3	Шаблон:User pt-3
Bee álnééhí:User pt-2	Шаблон:User pt-2
Bee álnééhí:User ro-4	Шаблон:User ro-4
Bee álnééhí:User ro	Шаблон:User ro
Bee álnééhí:User hy-4	Шаблон:User hy-4
Bee álnééhí:User fr-4	Шаблон:User fr-4
Bee álnééhí:User lv	Шаблон:User lv
Bee álnééhí:User bg	Шаблон:User bg
Bee álnééhí:User la-1	Шаблон:User la-1
Tʼááłáhági átʼéego:Templates/doc	Категория:Шаблоны:Документация
Tʼááłáhági átʼéego:Choyoołʼįįhí yue	Категория:User zh-yue
Tʼááłáhági átʼéego:Choyoołʼįįhí mzn	Категория:User mzn
Tʼááłáhági átʼéego:Choyoołʼįįhí at	Категория:User de-at
Tʼááłáhági átʼéego:Choyoołʼįįhí az	Категория:User az
Tʼááłáhági átʼéego:Choyoołʼįįhí be	Категория:User be
Tʼááłáhági átʼéego:Choyoołʼįįhí nb-N	Категория:User nb-N
Tʼááłáhági átʼéego:Choyoołʼįįhí bs	Категория:User bs
Tʼááłáhági átʼéego:Choyoołʼįįhí ce	Категория:User ce
Tʼááłáhági átʼéego:Choyoołʼįįhí hr	Категория:User hr
Tʼááłáhági átʼéego:Choyoołʼįįhí sk	Категория:User sk
Tʼááłáhági átʼéego:Choyoołʼįįhí sl	Категория:User sl
Tʼááłáhági átʼéego:Choyoołʼįįhí eo	Категория:User eo
Tʼááłáhági átʼéego:Choyoołʼįįhí et	Категория:User et
Tʼááłáhági átʼéego:Choyoołʼįįhí fr	Категория:User fr
Tʼááłáhági átʼéego:Choyoołʼįįhí gl	Категория:User gl
Tʼááłáhági átʼéego:Choyoołʼįįhí cy	Категория:User cy
Tʼááłáhági átʼéego:Choyoołʼįįhí hu-N	Категория:User hu-N
Tʼááłáhági átʼéego:Choyoołʼįįhí id	Категория:User id
Tʼááłáhági átʼéego:Choyoołʼįįhí ia	Категория:User ia
Tʼááłáhági átʼéego:Choyoołʼįįhí ga	Категория:User ga
Tʼááłáhági átʼéego:Choyoołʼįįhí ja	Категория:User ja
Tʼááłáhági átʼéego:Choyoołʼįįhí km	Категория:User km
Tʼááłáhági átʼéego:Choyoołʼįįhí rn	Категория:User rn
Tʼááłáhági átʼéego:Choyoołʼįįhí la	Категория:User la
Tʼááłáhági átʼéego:Choyoołʼįįhí li	Категория:User li
Tʼááłáhági átʼéego:Choyoołʼįįhí lt	Категория:User lt
Tʼááłáhági átʼéego:Choyoołʼįįhí mk	Категория:User mk
Tʼááłáhági átʼéego:Choyoołʼįįhí mg	Категория:User mg
Tʼááłáhági átʼéego:Choyoołʼįįhí mwl	Категория:User mwl
Tʼááłáhági átʼéego:Choyoołʼįįhí mn	Категория:User mn
Tʼááłáhági átʼéego:Choyoołʼįįhí nn	Категория:User nn
Tʼááłáhági átʼéego:Choyoołʼįįhí oc	Категория:User oc
Tʼááłáhági átʼéego:Choyoołʼįįhí pt	Категория:User pt
Tʼááłáhági átʼéego:Choyoołʼįįhí ro	Категория:User ro
Tʼááłáhági átʼéego:Choyoołʼįįhí sh	Категория:User sh
Tʼááłáhági átʼéego:Choyoołʼįįhí sv	Категория:User sv
Tʼááłáhági átʼéego:Choyoołʼįįhí sw	Категория:User sw
Tʼááłáhági átʼéego:Choyoołʼįįhí sa	Категория:User sa
Tʼááłáhági átʼéego:Choyoołʼįįhí th	Категория:User th
Tʼááłáhági átʼéego:Choyoołʼįįhí ta	Категория:User ta
Tʼááłáhági átʼéego:Choyoołʼįįhí az-3	Категория:User az-3
Tʼááłáhági átʼéego:Choyoołʼįįhí be-3	Категория:User be-3
Tʼááłáhági átʼéego:Choyoołʼįįhí cs-3	Категория:User cs-3
Tʼááłáhági átʼéego:Choyoołʼįįhí sl-3	Категория:User sl-3
Tʼááłáhági átʼéego:Choyoołʼįįhí et-3	Категория:User et-3
Tʼááłáhági átʼéego:Choyoołʼįįhí fr-3	Категория:User fr-3
Tʼááłáhági átʼéego:Choyoołʼįįhí hi-3	Категория:User hi-3
Tʼááłáhági átʼéego:Choyoołʼįįhí it-3	Категория:User it-3
Tʼááłáhági átʼéego:Choyoołʼįįhí ja-3	Категория:User ja-3
Tʼááłáhági átʼéego:Choyoołʼįįhí li-3	Категория:User li-3
Tʼááłáhági átʼéego:Choyoołʼįįhí lt-3	Категория:User lt-3
Tʼááłáhági átʼéego:Choyoołʼįįhí mk-3	Категория:User mk-3
Tʼááłáhági átʼéego:Choyoołʼįįhí nl-3	Категория:User nl-3
Tʼááłáhági átʼéego:Choyoołʼįįhí no-3	Категория:User no-3
Tʼááłáhági átʼéego:Choyoołʼįįhí pl-3	Категория:User pl-3
Tʼááłáhági átʼéego:Choyoołʼįįhí sh-3	Категория:User sh-3
Tʼááłáhági átʼéego:Choyoołʼįįhí tr-3	Категория:User tr-3
Tʼááłáhági átʼéego:Choyoołʼįįhí ar-3	Категория:User ar-3
Tʼááłáhági átʼéego:Choyoołʼįįhí an-1	Категория:User an-1
Tʼááłáhági átʼéego:Choyoołʼįįhí be-1	Категория:User be-1
Tʼááłáhági átʼéego:Choyoołʼįįhí cs-1	Категория:User cs-1
Tʼááłáhági átʼéego:Choyoołʼįįhí da-1	Категория:User da-1
Tʼááłáhági átʼéego:Choyoołʼįįhí sl-1	Категория:User sl-1
Tʼááłáhági átʼéego:Choyoołʼįįhí et-1	Категория:User et-1
Tʼááłáhági átʼéego:Choyoołʼįįhí fi-1	Категория:User fi-1
Tʼááłáhági átʼéego:Choyoołʼįįhí cy-1	Категория:User cy-1
Tʼááłáhági átʼéego:Choyoołʼįįhí hi-1	Категория:User hi-1
Tʼááłáhági átʼéego:Choyoołʼįįhí ia-1	Категория:User ia-1
Tʼááłáhági átʼéego:Choyoołʼįįhí ga-1	Категория:User ga-1
Tʼááłáhági átʼéego:Choyoołʼįįhí lv-1	Категория:User lv-1
Tʼááłáhági átʼéego:Choyoołʼįįhí li-1	Категория:User li-1
Tʼááłáhági átʼéego:Choyoołʼįįhí lt-1	Категория:User lt-1
Tʼááłáhági átʼéego:Choyoołʼįįhí mk-1	Категория:User mk-1
Tʼááłáhági átʼéego:Choyoołʼįįhí nl-1	Категория:User nl-1
Tʼááłáhági átʼéego:Choyoołʼįįhí oc-1	Категория:User oc-1
Tʼááłáhági átʼéego:Choyoołʼįįhí pl-1	Категория:User pl-1
Tʼááłáhági átʼéego:Choyoołʼįįhí ro-1	Категория:User ro-1
Tʼááłáhági átʼéego:Choyoołʼįįhí sh-1	Категория:User sh-1
Tʼááłáhági átʼéego:Choyoołʼįįhí sa-1	Категория:User sa-1
Tʼááłáhági átʼéego:Choyoołʼįįhí tr-1	Категория:User tr-1
Tʼááłáhági átʼéego:Choyoołʼįįhí ar-1	Категория:User ar-1
Tʼááłáhági átʼéego:Choyoołʼįįhí be-4	Категория:User be-4
Tʼááłáhági átʼéego:Choyoołʼįįhí cs-4	Категория:User cs-4
Tʼááłáhági átʼéego:Choyoołʼįįhí et-4	Категория:User et-4
Tʼááłáhági átʼéego:Choyoołʼįįhí fr-4	Категория:User fr-4
Tʼááłáhági átʼéego:Choyoołʼįįhí hu-4	Категория:User hu-4
Tʼááłáhági átʼéego:Choyoołʼįįhí id-4	Категория:User id-4
Tʼááłáhági átʼéego:Choyoołʼįįhí it-4	Категория:User it-4
Tʼááłáhági átʼéego:Choyoołʼįįhí lt-4	Категория:User lt-4
Tʼááłáhági átʼéego:Choyoołʼįįhí mk-4	Категория:User mk-4
Tʼááłáhági átʼéego:Choyoołʼįįhí oc-4	Категория:User oc-4
Tʼááłáhági átʼéego:Choyoołʼįįhí pl-4	Категория:User pl-4
Tʼááłáhági átʼéego:Choyoołʼįįhí ar-4	Категория:User ar-4
Tʼááłáhági átʼéego:Choyoołʼįįhí als-2	Категория:User als-2
Tʼááłáhági átʼéego:Choyoołʼįįhí mzn-2	Категория:User mzn-2
Tʼááłáhági átʼéego:Choyoołʼįįhí be-2	Категория:User be-2
Tʼááłáhági átʼéego:Choyoołʼįįhí bs-2	Категория:User bs-2
Tʼááłáhági átʼéego:Choyoołʼįįhí ce-2	Категория:User ce-2
Tʼááłáhági átʼéego:Choyoołʼįįhí cs-2	Категория:User cs-2
Tʼááłáhági átʼéego:Choyoołʼįįhí da-2	Категория:User da-2
Tʼááłáhági átʼéego:Choyoołʼįįhí sk-2	Категория:User sk-2
Tʼááłáhági átʼéego:Choyoołʼįįhí sl-2	Категория:User sl-2
Tʼááłáhági átʼéego:Choyoołʼįįhí et-2	Категория:User et-2
Tʼááłáhági átʼéego:Choyoołʼįįhí fr-2	Категория:User fr-2
Tʼááłáhági átʼéego:Choyoołʼįįhí cy-2	Категория:User cy-2
Tʼááłáhági átʼéego:Choyoołʼįįhí hu-2	Категория:User hu-2
Tʼááłáhági átʼéego:Choyoołʼįįhí ia-2	Категория:User ia-2
Tʼááłáhági átʼéego:Choyoołʼįįhí it-2	Категория:User it-2
Tʼááłáhági átʼéego:Choyoołʼįįhí ja-2	Категория:User ja-2
Tʼááłáhági átʼéego:Choyoołʼįįhí rn-2	Категория:User rn-2
Tʼááłáhági átʼéego:Choyoołʼįįhí la-2	Категория:User la-2
Tʼááłáhági átʼéego:Choyoołʼįįhí lt-2	Категория:User lt-2
Tʼááłáhági átʼéego:Choyoołʼįįhí mk-2	Категория:User mk-2
Tʼááłáhági átʼéego:Choyoołʼįįhí mwl-2	Категория:User mwl-2
Tʼááłáhági átʼéego:Choyoołʼįįhí nl-2	Категория:User nl-2
Tʼááłáhági átʼéego:Choyoołʼįįhí pl-2	Категория:User pl-2
Tʼááłáhági átʼéego:Choyoołʼįįhí sh-2	Категория:User sh-2
Tʼááłáhági átʼéego:Choyoołʼįįhí sv-2	Категория:User sv-2
Tʼááłáhági átʼéego:Choyoołʼįįhí tr-2	Категория:User tr-2
Tʼááłáhági átʼéego:Choyoołʼįįhí ar-2	Категория:User ar-2
Tʼááłáhági átʼéego:Choyoołʼįįhí at-N	Категория:User de-at-N
Tʼááłáhági átʼéego:Choyoołʼįįhí an-N	Категория:User an-N
Tʼááłáhági átʼéego:Choyoołʼįįhí hy-N	Категория:User hy-N
Tʼááłáhági átʼéego:Choyoołʼįįhí be-N	Категория:User be-N
Tʼááłáhági átʼéego:Choyoołʼįįhí cs-N	Категория:User cs-N
Tʼááłáhági átʼéego:Choyoołʼįįhí ko-N	Категория:User ko-N
Tʼááłáhági átʼéego:Choyoołʼįįhí hr-N	Категория:User hr-N
Tʼááłáhági átʼéego:Choyoołʼįįhí sl-N	Категория:User sl-N
Tʼááłáhági átʼéego:Choyoołʼįįhí et-N	Категория:User et-N
Tʼááłáhági átʼéego:Choyoołʼįįhí fr-N	Категория:User fr-N
Tʼááłáhági átʼéego:Choyoołʼįįhí gl-N	Категория:User gl-N
Tʼááłáhági átʼéego:Choyoołʼįįhí id-N	Категория:User id-N
Tʼááłáhági átʼéego:Choyoołʼįįhí is-N	Категория:User is-N
Tʼááłáhági átʼéego:Choyoołʼįįhí it-N	Категория:User it-N
Tʼááłáhági átʼéego:Choyoołʼįįhí ku-N	Категория:User ku-N
Tʼááłáhági átʼéego:Choyoołʼįįhí lv-N	Категория:User lv-N
Tʼááłáhági átʼéego:Choyoołʼįįhí li-N	Категория:User li-N
Tʼááłáhági átʼéego:Choyoołʼįįhí lt-N	Категория:User lt-N
Tʼááłáhági átʼéego:Choyoołʼįįhí mk-N	Категория:User mk-N
Tʼááłáhági átʼéego:Choyoołʼįįhí mg-N	Категория:User mg-N
Tʼááłáhági átʼéego:Choyoołʼįįhí nl-N	Категория:User nl-N
Tʼááłáhági átʼéego:Choyoołʼįįhí no-N	Категория:User no-N
Tʼááłáhági átʼéego:Choyoołʼįįhí nn-N	Категория:User nn-N
Tʼááłáhági átʼéego:Choyoołʼįįhí ru-N	Категория:User ru-N
Tʼááłáhági átʼéego:Choyoołʼįįhí sh-N	Категория:User sh-N
Tʼááłáhági átʼéego:Choyoołʼįįhí sw-N	Категория:User sw-N
Tʼááłáhági átʼéego:Choyoołʼįįhí ta-N	Категория:User ta-N
Tʼááłáhági átʼéego:Choyoołʼįįhí ar-N	Категория:User ar-N
Tʼááłáhági átʼéego:Choyoołʼįįhí cs-5	Категория:User cs-5
Bee álnééhí:User yue	Шаблон:User zh-yue
Tʼááłáhági átʼéego:Choyoołʼįįhí eu-3	Категория:User eu-3
Tʼááłáhági átʼéego:Choyoołʼįįhí eu-N	Категория:User eu-N
Tʼááłáhági átʼéego:Choyoołʼįįhí af	Категория:User af
Tʼááłáhági átʼéego:Choyoołʼįįhí af-1	Категория:User af-1
Tʼááłáhági átʼéego:Choyoołʼįįhí af-2	Категория:User af-2
Tʼááłáhági átʼéego:Choyoołʼįįhí af-3	Категория:User af-3
Tʼááłáhági átʼéego:Choyoołʼįįhí af-4	Категория:User af-4
Tʼááłáhági átʼéego:Choyoołʼįįhí af-N	Категория:User af-N
Tʼááłáhági átʼéego:Choyoołʼįįhí als	Категория:User als
Tʼááłáhági átʼéego:Choyoołʼįįhí als-1	Категория:User als-1
Tʼááłáhági átʼéego:Choyoołʼįįhí an	Категория:User an
Tʼááłáhági átʼéego:Choyoołʼįįhí ar	Категория:User ar
Tʼááłáhági átʼéego:Choyoołʼįįhí ast	Категория:User ast
Tʼááłáhági átʼéego:Choyoołʼįįhí az-1	Категория:User az-1
Tʼááłáhági átʼéego:Choyoołʼįįhí az-2	Категория:User az-2
Tʼááłáhági átʼéego:Choyoołʼįįhí az-4	Категория:User az-4
Tʼááłáhági átʼéego:Choyoołʼįįhí az-N	Категория:User az-N
Tʼááłáhági átʼéego:Choyoołʼįįhí ba	Категория:User ba
Tʼááłáhági átʼéego:Choyoołʼįįhí ba-1	Категория:User ba-1
Tʼááłáhági átʼéego:Choyoołʼįįhí ba-2	Категория:User ba-2
Tʼááłáhági átʼéego:Choyoołʼįįhí bar	Категория:User bar
Tʼááłáhági átʼéego:Choyoołʼįįhí bar-1	Категория:User bar-1
Tʼááłáhági átʼéego:Choyoołʼįįhí bg	Категория:User bg
Tʼááłáhági átʼéego:Choyoołʼįįhí bg-1	Категория:User bg-1
Tʼááłáhági átʼéego:Choyoołʼįįhí bg-2	Категория:User bg-2
Tʼááłáhági átʼéego:Choyoołʼįįhí bg-3	Категория:User bg-3
Tʼááłáhági átʼéego:Choyoołʼįįhí bg-4	Категория:User bg-4
Tʼááłáhági átʼéego:Choyoołʼįįhí bg-N	Категория:User bg-N
Tʼááłáhági átʼéego:Choyoołʼįįhí bn	Категория:User bn
Tʼááłáhági átʼéego:Choyoołʼįįhí bn-2	Категория:User bn-2
Tʼááłáhági átʼéego:Choyoołʼįįhí ca	Категория:User ca
Tʼááłáhági átʼéego:Choyoołʼįįhí ca-1	Категория:User ca-1
Tʼááłáhági átʼéego:Choyoołʼįįhí ca-2	Категория:User ca-2
Tʼááłáhági átʼéego:Tádídíín deiyání	Категория:Листоеды
Tʼááłáhági átʼéego:Choyoołʼįįhí ca-3	Категория:User ca-3
Tʼááłáhági átʼéego:Choyoołʼįįhí ca-4	Категория:User ca-4
Tʼááłáhági átʼéego:Choyoołʼįįhí ca-N	Категория:User ca-N
Tʼááłáhági átʼéego:Choyoołʼįįhí ce-N	Категория:User ce-N
Tʼááłáhági átʼéego:Choyoołʼįįhí cs	Категория:User cs
Tʼááłáhági átʼéego:Choyoołʼįįhí csb	Категория:User csb
Tʼááłáhági átʼéego:Choyoołʼįįhí csb-1	Категория:User csb-1
Tʼááłáhági átʼéego:Choyoołʼįįhí da	Категория:User da
Tʼááłáhági átʼéego:Choyoołʼįįhí sk-N	Категория:User sk-N
Tʼááłáhági átʼéego:Choyoołʼįįhí da-3	Категория:User da-3
Tʼááłáhági átʼéego:Choyoołʼįįhí da-4	Категория:User da-4
Tʼááłáhági átʼéego:Choyoołʼįįhí de	Категория:User de
Tʼááłáhági átʼéego:Choyoołʼįįhí de-2	Категория:User de-2
Tʼááłáhági átʼéego:Choyoołʼįįhí de-3	Категория:User de-3
Tʼááłáhági átʼéego:Choyoołʼįįhí de-4	Категория:User de-4
Tʼááłáhági átʼéego:Choyoołʼįįhí de-N	Категория:User de-N
Tʼááłáhági átʼéego:Choyoołʼįįhí el	Категория:User el
Tʼááłáhági átʼéego:Choyoołʼįįhí el-1	Категория:User el-1
Tʼááłáhági átʼéego:Choyoołʼįįhí el-2	Категория:User el-2
Tʼááłáhági átʼéego:Choyoołʼįįhí el-3	Категория:User el-3
Tʼááłáhági átʼéego:Choyoołʼįįhí el-4	Категория:User el-4
Tʼááłáhági átʼéego:Choyoołʼįįhí el-N	Категория:User el-N
Tʼááłáhági átʼéego:Choyoołʼįįhí en-0	Категория:User en-0
Tʼááłáhági átʼéego:Choyoołʼįįhí en-3	Категория:User en-3
Tʼááłáhági átʼéego:Choyoołʼįįhí en-5	Категория:User en-5
Tʼááłáhági átʼéego:Choyoołʼįįhí en-N	Категория:User en-N
Tʼááłáhági átʼéego:Choyoołʼįįhí eo-1	Категория:User eo-1
Tʼááłáhági átʼéego:Choyoołʼįįhí eo-2	Категория:User eo-2
Tʼááłáhági átʼéego:Choyoołʼįįhí eo-3	Категория:User eo-3
Tʼááłáhági átʼéego:Choyoołʼįįhí eo-4	Категория:User eo-4
Tʼááłáhági átʼéego:Choyoołʼįįhí eo-N	Категория:User eo-N
Tʼááłáhági átʼéego:Choyoołʼįįhí es	Категория:User es
Tʼááłáhági átʼéego:Choyoołʼįįhí es-1	Категория:User es-1
Tʼááłáhági átʼéego:Choyoołʼįįhí es-2	Категория:User es-2
Tʼááłáhági átʼéego:Choyoołʼįįhí es-3	Категория:User es-3
Tʼááłáhági átʼéego:Choyoołʼįįhí es-4	Категория:User es-4
Bee álnééhí:User es-5	Шаблон:User es-5
Tʼááłáhági átʼéego:Choyoołʼįįhí es-N	Категория:User es-N
Tʼááłáhági átʼéego:Choyoołʼįįhí eu	Категория:User eu
Tʼááłáhági átʼéego:Choyoołʼįįhí eu-1	Категория:User eu-1
Tʼááłáhági átʼéego:Choyoołʼįįhí fa	Категория:User fa
Tʼááłáhági átʼéego:Choyoołʼįįhí fa-1	Категория:User fa-1
Tʼááłáhági átʼéego:Choyoołʼįįhí fa-2	Категория:User fa-2
Tʼááłáhági átʼéego:Choyoołʼįįhí fa-3	Категория:User fa-3
Tʼááłáhági átʼéego:Choyoołʼįįhí fa-N	Категория:User fa-N
Tʼááłáhági átʼéego:Choyoołʼįįhí fi	Категория:User fi
Tʼááłáhági átʼéego:Choyoołʼįįhí fi-2	Категория:User fi-2
Tʼááłáhági átʼéego:Gólízhii	Категория:Скунсовые
Tʼááłáhági átʼéego:Choyoołʼįįhí fi-3	Категория:User fi-3
Tʼááłáhági átʼéego:Choyoołʼįįhí fi-4	Категория:User fi-4
Tʼááłáhági átʼéego:Choyoołʼįįhí fi-N	Категория:User fi-N
Tʼááłáhági átʼéego:Choyoołʼįįhí fy	Категория:User fy
Tʼááłáhági átʼéego:Choyoołʼįįhí fy-1	Категория:User fy-1
Tʼááłáhági átʼéego:Choyoołʼįįhí ga-2	Категория:User ga-2
Tʼááłáhági átʼéego:Choyoołʼįįhí ga-3	Категория:User ga-3
Tʼááłáhági átʼéego:Choyoołʼįįhí ga-4	Категория:User ga-4
Tʼááłáhági átʼéego:Choyoołʼįįhí grc	Категория:User grc
Tʼááłáhági átʼéego:Choyoołʼįįhí grc-1	Категория:User grc-1
Tʼááłáhági átʼéego:Choyoołʼįįhí grc-2	Категория:User grc-2
Tʼááłáhági átʼéego:Choyoołʼįįhí grc-3	Категория:User grc-3
Tʼááłáhági átʼéego:Choyoołʼįįhí gsw	Категория:User gsw
Tʼááłáhági átʼéego:Choyoołʼįįhí he	Категория:User he
Tʼááłáhági átʼéego:Choyoołʼįįhí he-1	Категория:User he-1
Tʼááłáhági átʼéego:Choyoołʼįįhí he-2	Категория:User he-2
Tʼááłáhági átʼéego:Choyoołʼįįhí he-3	Категория:User he-3
Tʼááłáhági átʼéego:Choyoołʼįįhí he-4	Категория:User he-4
Tʼááłáhági átʼéego:Choyoołʼįįhí he-N	Категория:User he-N
Tʼááłáhági átʼéego:Choyoołʼįįhí hr-1	Категория:User hr-1
Tʼááłáhági átʼéego:Choyoołʼįįhí hr-2	Категория:User hr-2
Tʼááłáhági átʼéego:Choyoołʼįįhí hr-3	Категория:User hr-3
Tʼááłáhági átʼéego:Choyoołʼįįhí hr-4	Категория:User hr-4
Tʼááłáhági átʼéego:Choyoołʼįįhí hsb	Категория:User hsb
Tʼááłáhági átʼéego:Choyoołʼįįhí hsb-1	Категория:User hsb-1
Tʼááłáhági átʼéego:Choyoołʼįįhí hsb-3	Категория:User hsb-3
Tʼááłáhági átʼéego:Choyoołʼįįhí hu	Категория:User hu
Tʼááłáhági átʼéego:Choyoołʼįįhí hu-1	Категория:User hu-1
Tʼááłáhági átʼéego:Choyoołʼįįhí hu-3	Категория:User hu-3
Tʼááłáhági átʼéego:Choyoołʼįįhí hy	Категория:User hy
Tʼááłáhági átʼéego:Choyoołʼįįhí hy-1	Категория:User hy-1
Tʼááłáhági átʼéego:Choyoołʼįįhí hy-2	Категория:User hy-2
Tʼááłáhági átʼéego:Choyoołʼįįhí hy-3	Категория:User hy-3
Tʼááłáhági átʼéego:Choyoołʼįįhí hy-4	Категория:User hy-4
Tʼááłáhági átʼéego:Choyoołʼįįhí id-1	Категория:User id-1
Tʼááłáhági átʼéego:Choyoołʼįįhí id-2	Категория:User id-2
Tʼááłáhági átʼéego:Choyoołʼįįhí id-3	Категория:User id-3
Tʼááłáhági átʼéego:Choyoołʼįįhí io	Категория:User io
Tʼááłáhági átʼéego:Choyoołʼįįhí io-1	Категория:User io-1
Tʼááłáhági átʼéego:Choyoołʼįįhí is	Категория:User is
Tʼááłáhági átʼéego:Choyoołʼįįhí is-1	Категория:User is-1
Tʼááłáhági átʼéego:Choyoołʼįįhí is-2	Категория:User is-2
Tʼááłáhági átʼéego:Choyoołʼįįhí als-N	Категория:User als-N
Bee álnééhí:User la-3	Шаблон:User la-3
Tʼááłáhági átʼéego:Choyoołʼįįhí pt-3	Категория:User pt-3
Tʼááłáhági átʼéego:Choyoołʼįįhí pl-N	Категория:User pl-N
Tʼááłáhági átʼéego:Choyoołʼįįhí pt-1	Категория:User pt-1
Tʼááłáhági átʼéego:Choyoołʼįįhí ka-1	Категория:User ka-1
Bee álnééhí:Hooʼááłígíí	Участник:Box/Администратор
Tʼááłáhági átʼéego:Choyoołʼįįhí it	Категория:User it
Tʼááłáhági átʼéego:Choyoołʼįįhí it-1	Категория:User it-1
Tʼááłáhági átʼéego:Choyoołʼįįhí ja-1	Категория:User ja-1
Tʼááłáhági átʼéego:Choyoołʼįįhí ka	Категория:User ka
Tʼááłáhági átʼéego:Choyoołʼįįhí ka-2	Категория:User ka-2
Tʼááłáhági átʼéego:Choyoołʼįįhí ka-3	Категория:User ka-3
Tʼááłáhági átʼéego:Choyoołʼįįhí ka-N	Категория:User ka-N
Tʼááłáhági átʼéego:Choyoołʼįįhí kl	Категория:User kl
Tʼááłáhági átʼéego:Choyoołʼįįhí km-1	Категория:User km-1
Tʼááłáhági átʼéego:Choyoołʼįįhí ko	Категория:User ko
Tʼááłáhági átʼéego:Wááshindoon bikéyah bił haʼdaʼhaasdzoígíí	Категория:Штаты США
Tʼááłáhági átʼéego:Choyoołʼįįhí ko-1	Категория:User ko-1
Tʼááłáhági átʼéego:Choyoołʼįįhí ko-2	Категория:User ko-2
Tʼááłáhági átʼéego:Choyoołʼįįhí ko-3	Категория:User ko-3
Tʼááłáhági átʼéego:Choyoołʼįįhí ksh	Категория:User ksh
Tʼááłáhági átʼéego:Choyoołʼįįhí ksh-1	Категория:User ksh-1
Tʼááłáhági átʼéego:Choyoołʼįįhí ksh-2	Категория:User ksh-2
Tʼááłáhági átʼéego:Choyoołʼįįhí ksh-3	Категория:User ksh-3
Tʼááłáhági átʼéego:Choyoołʼįįhí ksh-4	Категория:User ksh-4
Tʼááłáhági átʼéego:Choyoołʼįįhí ksh-N	Категория:User ksh-N
Tʼááłáhági átʼéego:Choyoołʼįįhí ku	Категория:User ku
Tʼááłáhági átʼéego:Choyoołʼįįhí la-1	Категория:User la-1
Tʼááłáhági átʼéego:Choyoołʼįįhí la-3	Категория:User la-3
Tʼááłáhági átʼéego:Choyoołʼįįhí la-4	Категория:User la-4
Tʼááłáhági átʼéego:Choyoołʼįįhí lb	Категория:User lb
Tʼááłáhági átʼéego:Choyoołʼįįhí lb-1	Категория:User lb-1
Tʼááłáhági átʼéego:Choyoołʼįįhí lb-2	Категория:User lb-2
Tʼááłáhági átʼéego:Dibé Nitsaa Hahoodzodi kin naaznilígíí	Категория:Города Колорадо
Bee álnééhí:User sh	Шаблон:User sh
Tʼááłáhági átʼéego:Choyoołʼįįhí nn-2	Категория:User nn-2
Bee álnééhí:User gl	Шаблон:User gl
Tʼááłáhági átʼéego:Choyoołʼįįhí ru-1	Категория:User ru-1
Bee álnééhí:User af-4	Шаблон:User af-4
Yaaʼ bijáád hastánígíí	Пухоеды и вши
Bee álnééhí:User sv-1	Шаблон:User sv-1
Tʼááłáhági átʼéego:Chʼil bikétłʼóól daadánígíí	Категория:Корнеплоды
Tʼááłáhági átʼéego:Choyoołʼįįhí lv	Категория:User lv
Tʼááłáhági átʼéego:Choyoołʼįįhí mn-1	Категория:User mn-1
Tʼááłáhági átʼéego:Choyoołʼįįhí mn-2	Категория:User mn-2
Tʼááłáhági átʼéego:Choyoołʼįįhí mn-3	Категория:User mn-3
Tʼááłáhági átʼéego:Choyoołʼįįhí mn-N	Категория:User mn-N
Nahasdzáán bimagnetic field	Магнитное поле Земли
Tsiiʼyiishbizhí dinéʼiʼ	Китайцы
Tʼááłáhági átʼéego:Choyoołʼįįhí als-3	Категория:User als-3
Bee álnééhí:User id	Шаблон:User id
Tʼááłáhági átʼéego:Choyoołʼįįhí nds	Категория:User nds
Tʼááłáhági átʼéego:Choyoołʼįįhí nds-1	Категория:User nds-1
Tʼááłáhági átʼéego:Choyoołʼįįhí nds-2	Категория:User nds-2
Tʼááłáhági átʼéego:Choyoołʼįįhí nds-3	Категория:User nds-3
Tʼááłáhági átʼéego:Choyoołʼįįhí nds-4	Категория:User nds-4
Tʼááłáhági átʼéego:Choyoołʼįįhí nds-N	Категория:User nds-N
Tʼááłáhági átʼéego:Choyoołʼįįhí nds-nl	Категория:User nds-nl
Bee álnééhí:User oc-1	Шаблон:User oc-1
Tʼááłáhági átʼéego:Choyoołʼįįhí es-5	Категория:User es-5
Tʼááłáhági átʼéego:Kéyah Ałhidadiidzooígíí dóó Ahiih Yikaígíí	Категория:Международные организации
Tʼááłáhági átʼéego:Chʼosh bijáád dahólónígíí	Категория:Членистоногие
Tʼááłáhági átʼéego:Tó	Категория:Вода
Tʼááłáhági átʼéego:Tsáʼásziʼ dóó Noodah	Категория:Агавовые
Tʼááłáhági átʼéego:Bidił daazdoígíí dóó daʼalghałígíí	Категория:Хищные
Tʼááłáhági átʼéego:Choyoołʼįįhí tt-N	Категория:User tt-N
Tʼááłáhági átʼéego:Choyoołʼįįhí nn-1	Категория:User nn-1
Tʼááłáhági átʼéego:Choyoołʼįįhí nb	Категория:User nb
Bee álnééhí:User ka-1	Шаблон:User ka-1
Bee álnééhí:User ab-3	Шаблон:User ab-3
Bee álnééhí:User ab	Шаблон:User ab
Bee álnééhí:User af	Шаблон:User af
Tʼááłáhági átʼéego:Naakaii Łizhiní Bikéyah	Категория:Страны Африки
Bee álnééhí:User ka-3	Шаблон:User ka-3
Bee álnééhí:User da-3	Шаблон:User da-3
Bee álnééhí:User pt-4	Шаблон:User pt-4
Bee álnééhí:User grc-4	Шаблон:User grc-4
Bee álnééhí:User sl-3	Шаблон:User sl-3
Bee álnééhí:User ka-4	Шаблон:User ka-4
Bee álnééhí:User ja-2	Шаблон:User ja-2
Bee álnééhí:User ko-2	Шаблон:User ko-2
Bee álnééhí:User ko-1	Шаблон:User ko-1
Bee álnééhí:User cs	Шаблон:User cs
Bee álnééhí:User ru-2	Шаблон:User ru-2
Bee álnééhí:User es-3	Шаблон:User es-3
Bee álnééhí:User ja-3	Шаблон:User ja-3
Bee álnééhí:User eu-1	Шаблон:User eu-1
Bee álnééhí:User ko-3	Шаблон:User ko-3
Tʼááłáhági átʼéego:Tsin bineestʼąʼ dadíkʼǫ́zhígíí	Категория:Цитрусовые
Tʼááłáhági átʼéego:Choyoołʼįįhí pt-2	Категория:User pt-2
Tʼááłáhági átʼéego:Choyoołʼįįhí pt-4	Категория:User pt-4
Tʼááłáhági átʼéego:Choyoołʼįįhí pt-N	Категория:User pt-N
Tʼááłáhági átʼéego:Choyoołʼįįhí qu	Категория:User qu
Tʼááłáhági átʼéego:Choyoołʼįįhí qu-1	Категория:User qu-1
Tʼááłáhági átʼéego:Choyoołʼįįhí qu-2	Категория:User qu-2
Tʼááłáhági átʼéego:Choyoołʼįįhí qu-3	Категория:User qu-3
Tʼááłáhági átʼéego:Choyoołʼįįhí ro-2	Категория:User ro-2
Tʼááłáhági átʼéego:Choyoołʼįįhí ro-3	Категория:User ro-3
Tʼááłáhági átʼéego:Choyoołʼįįhí ro-4	Категория:User ro-4
Tʼááłáhági átʼéego:Choyoołʼįįhí ro-N	Категория:User ro-N
Tʼááłáhági átʼéego:Choyoołʼįįhí ru	Категория:User ru
Tʼááłáhági átʼéego:Choyoołʼįįhí ru-2	Категория:User ru-2
Tʼááłáhági átʼéego:Choyoołʼįįhí ru-3	Категория:User ru-3
Tʼááłáhági átʼéego:Choyoołʼįįhí ru-4	Категория:User ru-4
Tʼááłáhági átʼéego:Choyoołʼįįhí sk-1	Категория:User sk-1
Tʼááłáhági átʼéego:Choyoołʼįįhí sk-3	Категория:User sk-3
Tʼááłáhági átʼéego:Choyoołʼįįhí sk-4	Категория:User sk-4
Tʼááłáhági átʼéego:Choyoołʼįįhí sr	Категория:User sr
Tʼááłáhági átʼéego:Choyoołʼįįhí sr-1	Категория:User sr-1
Tʼááłáhági átʼéego:Choyoołʼįįhí sr-2	Категория:User sr-2
Tʼááłáhági átʼéego:Choyoołʼįįhí sr-3	Категория:User sr-3
Tʼááłáhági átʼéego:Choyoołʼįįhí sr-4	Категория:User sr-4
Tʼááłáhági átʼéego:Choyoołʼįįhí sr-N	Категория:User sr-N
Tʼááłáhági átʼéego:Choyoołʼįįhí sv-1	Категория:User sv-1
Tʼááłáhági átʼéego:Choyoołʼįįhí sv-3	Категория:User sv-3
Tʼááłáhági átʼéego:Choyoołʼįįhí sv-4	Категория:User sv-4
Tʼááłáhági átʼéego:Choyoołʼįįhí sv-N	Категория:User sv-N
Tʼááłáhági átʼéego:Choyoołʼįįhí th-N	Категория:User th-N
Tʼááłáhági átʼéego:Choyoołʼįįhí tr	Категория:User tr
Tʼááłáhági átʼéego:Choyoołʼįįhí tr-4	Категория:User tr-4
Tʼááłáhági átʼéego:Choyoołʼįįhí tr-N	Категория:User tr-N
Tʼááłáhági átʼéego:Choyoołʼįįhí tt	Категория:User tt
Tʼááłáhági átʼéego:Choyoołʼįįhí tt-1	Категория:User tt-1
Tʼááłáhági átʼéego:Choyoołʼįįhí tt-2	Категория:User tt-2
Tʼááłáhági átʼéego:Choyoołʼįįhí tt-3	Категория:User tt-3
Tʼááłáhági átʼéego:Choyoołʼįįhí uk-1	Категория:User uk-1
Tʼááłáhági átʼéego:Choyoołʼįįhí uk-2	Категория:User uk-2
Tʼááłáhági átʼéego:Choyoołʼįįhí uk-3	Категория:User uk-3
Tʼááłáhági átʼéego:Choyoołʼįįhí uk-4	Категория:User uk-4
Tʼááłáhági átʼéego:Choyoołʼįįhí vi	Категория:User vi
Tʼááłáhági átʼéego:Choyoołʼįįhí vi-1	Категория:User vi-1
Tʼááłáhági átʼéego:Choyoołʼįįhí vi-2	Категория:User vi-2
Tʼááłáhági átʼéego:Choyoołʼįįhí vi-N	Категория:User vi-N
Tʼááłáhági átʼéego:Choyoołʼįįhí yue-1	Категория:User zh-yue-1
Tʼááłáhági átʼéego:Choyoołʼįįhí yue-N	Категория:User zh-yue-N
Bee álnééhí:User ro-1	Шаблон:User ro-1
Tʼááłáhági átʼéego:Tsin ííʼáhígíí	Категория:Деревья
Bee álnééhí:User th	Шаблон:User th
Bee álnééhí:User nds-2	Шаблон:User nds-2
Bee álnééhí:User ca	Шаблон:User ca
Bee álnééhí:Ch'osh	Шаблон:Членистоногие
Tʼááłáhági átʼéego:Mágí: Diné Ndahalinígíí	Категория:Человекообразные обезьяны
Tʼááłáhági átʼéego:Mágí	Категория:Приматы
Bee álnééhí:LivingP	Шаблон:Blp
Bee álnééhí:User sv-3	Шаблон:User sv-3
Bee álnééhí:User hy-1	Шаблон:User hy-1
Bee álnééhí:User hsb-1	Шаблон:User hsb-1
Bee álnééhí:User hsb	Шаблон:User hsb
Tʼááłáhági átʼéego:Naʼiiniʼ	Категория:Коммерция
Bee álnééhí:User hsb-2	Шаблон:User hsb-2
Bee álnééhí:User af-3	Шаблон:User af-3
Tʼááłáhági átʼéego:Naaki góneʼ yéigo daʼahijoogą́ą́ʼ	Категория:Вторая мировая война
Tʼááłáhági átʼéego:Mósí dóó Náshdóí	Категория:Кошачьи
Bee álnééhí:User nds	Шаблон:User nds
Kʼíneedlíshii	Eleodes
Tʼááłáhági átʼéego:Tó Kéyah Bináhaazyínígíí	Категория:Островные государства
Bee álnééhí:User ar-4	Шаблон:User ar-4
Bee álnééhí:User az-2	Шаблон:User az-2
Bee álnééhí:User be	Шаблон:User be
Bee álnééhí:User ca-2	Шаблон:User ca-2
Bee álnééhí:User ca-3	Шаблон:User ca-3
Bee álnééhí:User cs-3	Шаблон:User cs-3
Bee álnééhí:User da-4	Шаблон:User da-4
Bee álnééhí:User el-2	Шаблон:User el-2
Bee álnééhí:User et-3	Шаблон:User et-3
Bee álnééhí:User fa-2	Шаблон:User fa-2
Bee álnééhí:User fa-3	Шаблон:User fa-3
Bee álnééhí:User fa-4	Шаблон:User fa-4
Bee álnééhí:User fi-2	Шаблон:User fi-2
Bee álnééhí:User fi-3	Шаблон:User fi-3
Bee álnééhí:User ga-2	Шаблон:User ga-2
Bee álnééhí:User he-3	Шаблон:User he-3
Bee álnééhí:User he-4	Шаблон:User he-4
Bee álnééhí:User hu-1	Шаблон:User hu-1
Bee álnééhí:User hy	Шаблон:User hy
Bee álnééhí:User ka	Шаблон:User ka
Bee álnééhí:User ko	Шаблон:User ko
Bee álnééhí:User ku	Шаблон:User ku
Bee álnééhí:User la-2	Шаблон:User la-2
Bee álnééhí:User lb-2	Шаблон:User lb-2
Bee álnééhí:User li-1	Шаблон:User li-1
Bee álnééhí:User mk-1	Шаблон:User mk-1
Bee álnééhí:User nn-2	Шаблон:User nn-2
Bee álnééhí:User no-1	Шаблон:User no-1
Bee álnééhí:User pl-2	Шаблон:User pl-2
Bee álnééhí:User pt	Шаблон:User pt
Bee álnééhí:User ro-2	Шаблон:User ro-2
Bee álnééhí:User ru-1	Шаблон:User ru-1
Bee álnééhí:User sa-1	Шаблон:User sa-1
Bee álnééhí:User sk-1	Шаблон:User sk-1
Bee álnééhí:User sk-2	Шаблон:User sk-2
Bee álnééhí:User sk-3	Шаблон:User sk-3
Bee álnééhí:User sr-1	Шаблон:User sr-1
Bee álnééhí:User tr-1	Шаблон:User tr-1
Bee álnééhí:User tr-3	Шаблон:User tr-3
Bee álnééhí:User uk-1	Шаблон:User uk-1
Bee álnééhí:User uk-4	Шаблон:User uk-4
Bee álnééhí:User zh-1	Шаблон:User zh-1
Bee álnééhí:User zh-2	Шаблон:User zh-2
Bee álnééhí:User zh-3	Шаблон:User zh-3
Bee álnééhí:User zh-4	Шаблон:User zh-4
Tʼááłáhági átʼéego:Naakaii Łizhiní Bikéyahdę́ę́ʼ Ndaaldeehii	Категория:Фауна Африки
Kʼįįʼ báhádzidígíí	Токсикодендрон лаковый
Tʼááłáhági átʼéego:Choyoołʼįįhí nl	Категория:User nl
Tʼááłáhági átʼéego:Choyoołʼįįhí nn-3	Категория:User nn-3
Tʼááłáhági átʼéego:Choyoołʼįįhí no-1	Категория:User no-1
Tʼááłáhági átʼéego:Choyoołʼįįhí no-2	Категория:User no-2
Tʼááłáhági átʼéego:Choyoołʼįįhí no	Категория:User no
Tʼááłáhági átʼéego:Choyoołʼįįhí nds-nl-1	Категория:User nds-nl-1
Tʼááłáhági átʼéego:Choyoołʼįįhí zh-1	Категория:User zh-1
Tʼááłáhági átʼéego:Choyoołʼįįhí zh-4	Категория:User zh-4
Tʼááłáhági átʼéego:Choyoołʼįįhí zh-3	Категория:User zh-3
Tʼááłáhági átʼéego:Choyoołʼįįhí zh-2	Категория:User zh-2
Tʼááłáhági átʼéego:Chʼał	Категория:Бесхвостые
Tʼááłáhági átʼéego:Atłʼóóh	Категория:Ткацкое дело
Tʼááłáhági átʼéego:Mąʼii yił Ałhidanoolinígíí Yázhí	Категория:Енотовые
Tʼááłáhági átʼéego:Dlǫ́ʼiitsoh Danilínígíí	Категория:Виверровые
Tʼááłáhági átʼéego:Chéłchaaʼ	Категория:Жесткокрылые
Tʼááłáhági átʼéego:Naakáí dootłʼizhí dóó Bééshbichʼahii dabizaad ndahalinígíí	Категория:Индоевропейские языки
Tʼááłáhági átʼéego:Hazéí	Категория:Беличьи
Tʼááłáhági átʼéego:Chidí naatʼaʼí ńdinibįįhígi	Категория:Аэропорты
Tʼááłáhági átʼéego:Áʼádaatʼéhígíí	Категория:Химические элементы
Bee álnééhí:User als-4	Шаблон:User als-4
Tʼááłáhági átʼéego:Articles by class	Категория:Википедия:Статьи по качеству
Bee álnééhí:User de-4	Шаблон:User de-4
Chʼoshtsoh bíláshgaantsohí (tónílį́įgiʼígíí)	Astacoidea
Tʼááłáhági átʼéego:Abeʼ bitsʼą́ą́dóó ádaalyaaígíí	Категория:Молочные продукты
Tʼááłáhági átʼéego:Tsin dóó chʼil bineestʼąʼ	Категория:Фрукты
Tʼááłáhági átʼéego:Kʼaalógii dóó Iichʼąhii	Категория:Чешуекрылые
Tʼááłáhági átʼéego:Chʼosh bijáád ádaadinígíí	Категория:Моллюски
Tʼááłáhági átʼéego:Shádiʼááhdę́ę́ʼ Mágí	Категория:Широконосые обезьяны
Tʼááłáhági átʼéego:Gáagii dóó Joogii Ndahalinígíí	Категория:Врановые
Tʼááłáhági átʼéego:Mąʼii dóó Łééchąąʼí	Категория:Псовые
Tʼááłáhági átʼéego:Ayání dóó Béégashii	Категория:Быки
Tʼááłáhági átʼéego:Tó Wónaanídę́ę́ʼ Mágí	Категория:Мартышковые
Tʼááłáhági átʼéego:Naayízí dóó taʼneeskʼání	Категория:Тыквенные
Tʼááłáhági átʼéego:Dlǫ́ʼii Ndahalinígíí	Категория:Куньи
Tʼááłáhági átʼéego:Łóóʼtsoh biwooʼ dantłʼizígíí	Категория:Зубатые киты
Tʼááłáhági átʼéego:Łóóʼtsoh biwooʼ daditsʼózígíí	Категория:Усатые киты
Tʼááłáhági átʼéego:Naaldeehii	Категория:Животные
Tʼááłáhági átʼéego:Shádiʼááhdę́ę́ʼ Ndaaldeehii	Категория:Фауна Южной Америки
Tʼááłáhági átʼéego:Bizaʼazis Dahólónígíí	Категория:Сумчатые
Tʼááłáhági átʼéego:Chʼosh chʼééh diikáhii	Категория:Брюхоногие
Tʼááłáhági átʼéego:Chʼosh bitsʼaʼígíí	Категория:Двустворчатые
Tʼááłáhági átʼéego:Gah	Категория:Зайцеобразные
Tʼááłáhági átʼéego:Łóóʼtsoh dóó Tééh hóyáanii	Категория:Китообразные
Bee álnééhí:User fy-1	Шаблон:User fy-1
Bee álnééhí:User id-4	Шаблон:User id-4
Bee álnééhí:User uk-3	Шаблон:User uk-3
Bee álnééhí:User bn-2	Шаблон:User bn-2
Tʼááłáhági átʼéego:Eʼeʼaahjí Tónteel bikáaʼgi Kéyah dah Ndaaʼeełígíí	Категория:Острова Тихого океана
Tʼááłáhági átʼéego:Łóóʼ Bigaan Dahólónígíí	Категория:Головоногие
Tʼááłáhági átʼéego:Chʼééh digháhii dóó Tsisteeł	Категория:Черепахи
Dah diníilghaazh	Жареный хлеб
Tʼááłáhági átʼéego:Béésh	Категория:Металлы
Tʼááłáhági átʼéego:Naayééʼ	Категория:Динозавры
Tʼááłáhági átʼéego:Choyoołʼįįhí pl	Категория:User pl
Tʼááłáhági átʼéego:Chʼosh bikágí dantłʼizí	Категория:Ракообразные
Tʼááłáhági átʼéego:Jaaʼabaní	Категория:Рукокрылые
Tʼááłáhági átʼéego:Tłʼiish	Категория:Змеи
Tʼááłáhági átʼéego:Shádiʼááhjí kéyah yistinígíí	Категория:Антарктида
Tʼááłáhági átʼéego:Beʼekʼid	Категория:Озёра
Kʼíshíshjį́į́zh	Токсикодендрон укореняющийся
Bee álnééhí:User sl	Шаблон:User sl
Bee álnééhí:User ce-3	Шаблон:User ce-3
Tʼááłáhági átʼéego:Bįįh	Категория:Олени
Tʼááłáhági átʼéego:Łóóʼ hashkéhé	Категория:Акулы
Tʼááłáhági átʼéego:Łóóʼ ooshgę́ęzhii	Категория:Хрящевые рыбы
Bee álnééhí:User hsb-3	Шаблон:User hsb-3
Tʼááłáhági átʼéego:Chidí	Категория:Автомобиль
Bee álnééhí:User ga-1	Шаблон:User ga-1
Bee álnééhí:User af-2	Шаблон:User af-2
Chąąshtʼezhiitsoh	Морковь посевная
Tséyooʼáałii	Долгоносики
Tʼááłáhági átʼéego:Łį́į́ʼ Ndahalinígíí	Категория:Лошади
Tʼááłáhági átʼéego:Naabeehó	Категория:Нация навахо
Tʼááłáhági átʼéego:Wóʼatsʼǫǫsii Ádaatʼéhígíí	Категория:Полужесткокрылые
Tʼááłáhági átʼéego:Tsin Deigházhígíí	Категория:Грызуны
Bee álnééhí:User hr-2	Шаблон:User hr-2
Bee álnééhí:User sl-1	Шаблон:User sl-1
Tʼááłáhági átʼéego:Choyoołʼįįhí ab	Категория:User ab
Tʼááłáhági átʼéego:Choyoołʼįįhí ab-3	Категория:User ab-3
Tʼááłáhági átʼéego:Choyoołʼįįhí ab-N	Категория:User ab-N
Tʼááłáhági átʼéego:Choyoołʼįįhí ka-4	Категория:User ka-4
Bee álnééhí:User pl-3	Шаблон:User pl-3
Bee álnééhí:User pl-4	Шаблон:User pl-4
Bee álnééhí:User an-1	Шаблон:User an-1
Bee álnééhí:User vi-4	Шаблон:User vi-4
Bee álnééhí:User vi-2	Шаблон:User vi-2
Bee álnééhí:User vi-1	Шаблон:User vi-1
Bee álnééhí:User tt-3	Шаблон:User tt-3
Bee álnééhí:User tt-2	Шаблон:User tt-2
Bee álnééhí:User tt-1	Шаблон:User tt-1
Bee álnééhí:User sw	Шаблон:User sw
Bee álnééhí:User sr-4	Шаблон:User sr-4
Bee álnééhí:User sr-3	Шаблон:User sr-3
Bee álnééhí:User sr-2	Шаблон:User sr-2
Bee álnééhí:User sl-2	Шаблон:User sl-2
Bee álnééhí:User sh-3	Шаблон:User sh-3
Bee álnééhí:User sh-1	Шаблон:User sh-1
Bee álnééhí:User qu-3	Шаблон:User qu-3
Bee álnééhí:User qu-2	Шаблон:User qu-2
Bee álnééhí:User qu-1	Шаблон:User qu-1
Bee álnééhí:User nds-3	Шаблон:User nds-3
Bee álnééhí:User nb	Шаблон:User nb
Bee álnééhí:User mn-4	Шаблон:User mn-4
Bee álnééhí:User mn-3	Шаблон:User mn-3
Bee álnééhí:User mn-2	Шаблон:User mn-2
Bee álnééhí:User mn-1	Шаблон:User mn-1
Bee álnééhí:User mn	Шаблон:User mn
Bee álnééhí:User mk-3	Шаблон:User mk-3
Bee álnééhí:User mk-2	Шаблон:User mk-2
Bee álnééhí:User mk	Шаблон:User mk
Bee álnééhí:User mg	Шаблон:User mg
Bee álnééhí:User lv-1	Шаблон:User lv-1
Bee álnééhí:User lt-4	Шаблон:User lt-4
Bee álnééhí:User lt-3	Шаблон:User lt-3
Bee álnééhí:User lt-1	Шаблон:User lt-1
Bee álnééhí:User la-4	Шаблон:User la-4
Bee álnééhí:User ksh-4	Шаблон:User ksh-4
Bee álnééhí:User ksh-3	Шаблон:User ksh-3
Bee álnééhí:User ksh-2	Шаблон:User ksh-2
Bee álnééhí:User ksh-1	Шаблон:User ksh-1
Bee álnééhí:User ka-2	Шаблон:User ka-2
Bee álnééhí:User it-4	Шаблон:User it-4
Bee álnééhí:User io-1	Шаблон:User io-1
Bee álnééhí:User id-2	Шаблон:User id-2
Bee álnééhí:User ia-1	Шаблон:User ia-1
Bee álnééhí:User hr-3	Шаблон:User hr-3
Bee álnééhí:User grc-3	Шаблон:User grc-3
Bee álnééhí:User grc-2	Шаблон:User grc-2
Bee álnééhí:User ga	Шаблон:User ga
Bee álnééhí:User fi-4	Шаблон:User fi-4
Bee álnééhí:User et-4	Шаблон:User et-4
Bee álnééhí:User et-2	Шаблон:User et-2
Bee álnééhí:User et	Шаблон:User et
Bee álnééhí:User el-4	Шаблон:User el-4
Bee álnééhí:User el-3	Шаблон:User el-3
Bee álnééhí:User cy-2	Шаблон:User cy-2
Bee álnééhí:User cy-1	Шаблон:User cy-1
Bee álnééhí:User csb-1	Шаблон:User csb-1
Bee álnééhí:User cs-4	Шаблон:User cs-4
Bee álnééhí:User bs-2	Шаблон:User bs-2
Bee álnééhí:User bg-4	Шаблон:User bg-4
Bee álnééhí:User bg-3	Шаблон:User bg-3
Bee álnééhí:User bg-2	Шаблон:User bg-2
Bee álnééhí:User be-3	Шаблон:User be-3
Bee álnééhí:User be-1	Шаблон:User be-1
Bee álnééhí:User ba-2	Шаблон:User ba-2
Bee álnééhí:User an	Шаблон:User an
Bee álnééhí:User tt	Шаблон:User tt
Bee álnééhí:User ro-3	Шаблон:User ro-3
Tʼááłáhági átʼéego:Dlǫ́ʼii yił Aheedaałtʼéhígíí	Категория:Мангустовые
Bee álnééhí:User mk-4	Шаблон:User mk-4
Bee álnééhí:User nds-4	Шаблон:User nds-4
Tʼááłáhági átʼéego:Hoozdo Hahoodzodi chidí naatʼaʼí ńdinibįįhígi	Категория:Аэропорты штата Аризона
Tʼááłáhági átʼéego:Yootó Hahoodzodi chidí naatʼaʼí ńdinibįįhígi	Категория:Аэропорты штата Нью-Мексико
Tʼááłáhági átʼéego:Beeʼeldííldahsinil	Категория:Альбукерке
Tʼááłáhági átʼéego:Tábąąstííntsoh	Категория:Ластоногие
Tʼááłáhági átʼéego:Táłkáaʼgi Tsídii	Категория:Гусеобразные
Tʼááłáhági átʼéego:Tsísʼná dóó Wáláchííʼ	Категория:Стебельчатобрюхие
Tʼááłáhági átʼéego:Chʼosh bijáád tseebíhígíí	Категория:Паукообразные
Tʼááłáhági átʼéego:Shash	Категория:Медвежьи
Tʼááłáhági átʼéego:Tsin deiłkaałii	Категория:Дятловые
Tʼááłáhági átʼéego:Tsékooh	Категория:Каньоны
Tó bichʼoshtsoh	Belostomatidae
Tʼááłáhági átʼéego:Chʼosh bijáád neeznánígíí	Категория:Десятиногие ракообразные
Tʼááłáhági átʼéego:Bílaʼashdlaʼii bilį́į́ʼ danilínígíí	Категория:Домашние животные
Tʼááłáhági átʼéego:Dziil / Atsiniltłʼish álʼį́	Категория:Энергия
Tʼááłáhági átʼéego:Shádiʼááh biyaadi dóó Kéyah Yistinígíí bikáaʼgi Ndaaldeehii	Категория:Фауна Антарктиды
Tʼááłáhági átʼéego:Nahatʼeʼiitsoh Bikéyahdę́ę́ʼ Ndaaldeehii	Категория:Фауна Австралии
Tʼááłáhági átʼéego:Naakaii Dootłʼizhii Dabikéyahdę́ę́ʼ Ndaaldeehii	Категория:Фауна Южной Азии
Tʼááłáhági átʼéego:Tsʼíʼii dóó Tséʼédǫ́ʼii	Категория:Двукрылые
Bee álnééhí:User ko-4	Шаблон:User ko-4
Tʼááłáhági átʼéego:Tązhii dóó Naaʼahóóhai Ndahalinígíí	Категория:Курообразные
Tʼááłáhági átʼéego:Tééh łééchąąʼí	Категория:Гиеновые
Tʼááłáhági átʼéego:Wónitłʼizí	Категория:Равноногие
Tʼááłáhági átʼéego:Kǫʼ naʼałbąąsii ninádaaltłiʼígi	Категория:Железнодорожные станции
Tʼááłáhági átʼéego:Daʼałtʼoʼígíí biyęęzhii deiłchíhígíí	Категория:Однопроходные
Tʼááłáhági átʼéego:Tó Wónaanídę́ę́ʼ Jeeshóóʼ	Категория:Грифовые
Tʼááłáhági átʼéego:Nahachagii dóó Nahakʼízii	Категория:Прямокрылые
Tʼááłáhági átʼéego:Chéłchaaʼ bigaantéłígíí	Категория:Пластинчатоусые
Tʼááłáhági átʼéego:Tábąąsdísí	Категория:Бекасовые
Tʼááłáhági átʼéego:Séigoʼ	Категория:Скорпионы
Tʼááłáhági átʼéego:Táłtłʼááhdę́ę́ʼ dóó tónteel biyiʼdę́ę́ʼ chʼiyáán	Категория:Морепродукты
Tʼááłáhági átʼéego:Tsin naaʼeeł	Категория:Суда и корабли
Tʼááłáhági átʼéego:Naʼashjéʼii	Категория:Пауки
Tʼááłáhági átʼéego:Jááłánii	Категория:Многоножки
Tʼááłáhági átʼéego:Chʼosh doo yitʼíinii	Категория:Микроорганизмы
Tʼááłáhági átʼéego:Bisóodi	Категория:Свиньи
Tʼááłáhági átʼéego:Choyoołʼįįhí ba-4	Категория:User ba-4
Tʼááłáhági átʼéego:Choyoołʼįįhí ba-N	Категория:User ba-N
Tʼááłáhági átʼéego:Choyoołʼįįhí no-4	Категория:User no-4
Tʼááłáhági átʼéego:Azeeʼ	Категория:Лекарственные растения
Tʼááłáhági átʼéego:Choyoołʼįįhí nl-4	Категория:User nl-4
Tʼááłáhági átʼéego:Naʼastsʼǫǫsí dóó Łéʼétsoh	Категория:Мышиные
Bee álnééhí:User cs-2	Шаблон:User cs-2
Bee álnééhí:Image label begin	Шаблон:Image label begin
Tʼááłáhági átʼéego:Yootó Hahoodzodi kin naaznilígíí	Категория:Города Нью-Мексико
Tʼááłáhági átʼéego:Choyoołʼįįhí mn-4	Категория:User mn-4
Tʼááłáhági átʼéego:Choyoołʼįįhí fa-4	Категория:User fa-4
Tʼááłáhági átʼéego:Biishchʼid Dahólónígíí	Категория:Плацентарные
Tʼááłáhági átʼéego:Kiisʼáanii	Категория:Пуэбло
Bee álnééhí:User nn-3	Шаблон:User nn-3
Bee álnééhí:User vi	Шаблон:User vi
Tʼááłáhági átʼéego:Choyoołʼįįhí en-1	Категория:User en-1
Tʼááłáhági átʼéego:Choyoołʼįįhí de-1	Категория:User de-1
Tʼááłáhági átʼéego:Choyoołʼįįhí da-N	Категория:User da-N
Tʼááłáhági átʼéego:Choyoołʼįįhí gl-2	Категория:User gl-2
Yaaʼ bijáád tseebíhígíí	Ixodida
Bee álnééhí:User ay-4	Шаблон:User ay-4
Gáagii bitłʼohchin	Лук склонённый
Dahsání	Североамериканский дикобраз
Tsiiyázhí (dééł)	Трубачи
Bee álnééhí:User nl-4	Шаблон:User nl-4
Bee álnééhí:User no-4	Шаблон:User no-4
Bee álnééhí:User nn-1	Шаблон:User nn-1
Bee álnééhí:User lt-2	Шаблон:User lt-2
Bee álnééhí:User ru-3	Шаблон:User ru-3
Bee álnééhí:User be-4	Шаблон:User be-4
Bee álnééhí:User az-1	Шаблон:User az-1
Bee álnééhí:User nl-3	Шаблон:User nl-3
Bee álnééhí:User nn	Шаблон:User nn
Bee álnééhí:User az-4	Шаблон:User az-4
Bee álnééhí:User li	Шаблон:User li
Bee álnééhí:User hy-2	Шаблон:User hy-2
Bee álnééhí:User ce-2	Шаблон:User ce-2
Bee álnééhí:User ba-1	Шаблон:User ba-1
Bee álnééhí:User sv-4	Шаблон:User sv-4
Bee álnééhí:User ce-1	Шаблон:User ce-1
Bee álnééhí:User hu-2	Шаблон:User hu-2
Bee álnééhí:User hr-4	Шаблон:User hr-4
Bee álnééhí:User als-3	Шаблон:User als-3
Bee álnééhí:User ba	Шаблон:User ba
Bee álnééhí:User sh-2	Шаблон:User sh-2
Bee álnééhí:User hu-4	Шаблон:User hu-4
Bee álnééhí:User hu-3	Шаблон:User hu-3
Bee álnééhí:User ga-3	Шаблон:User ga-3
Bee álnééhí:User ce-4	Шаблон:User ce-4
Bee álnééhí:User qu	Шаблон:User qu
Bee álnééhí:User ga-4	Шаблон:User ga-4
Bee álnééhí:User ba-3	Шаблон:User ba-3
Bee álnééhí:User hy-3	Шаблон:User hy-3
Bee álnééhí:User id-1	Шаблон:User id-1
Bee álnééhí:Bidił daazdoígíí dóó da'ałt'o'ígíí	Шаблон:Современные отряды млекопитающих
Kʼaalógii	Булавоусые чешуекрылые
Saad (Ałtsʼáʼáztiin)	Язык (значения)
Akétłʼóól łichxííʼí yázhí	Редька посевная
Bee álnééhí:Nobots	Шаблон:Nobots
Tsé nahalinii (łóóʼ)	Бородавчатки
Bee álnééhí:User cs-5	Шаблон:User cs-5
Bee álnééhí:User ba-4	Шаблон:User ba-4
Tʼááłáhági átʼéego:Choyoołʼįįhí als-4	Категория:User als-4
Bee álnééhí:Ch'osh6	Шаблон:Отряды насекомых
Special:RecentChanges	Служебная:Свежие правки
Tʼááłáhági átʼéego:Choyoołʼįįhí ja-4	Категория:User ja-4
Gaantsʼosí dóó Sǫʼ łóóʼ biyaʼ	Мизостомиды
Ábishjaaʼ łóóʼ	Dendrogramma
