Africa	Африка
Lithuania	Литва
Italia	Италия
Asia	Азия
Meyi	Май
Russia	Россия
Azerbaijan	Азербайджан
San Marino (dziko)	Сан-Марино
South Africa	Южно-Африканская Республика
Algeria	Алжир
Yesu Kristu	Иисус Христос
Chilatini	Латинский язык
Napoleon	Наполеон I
Zomera	Растения
Tanzania	Танзания
Zambia	Замбия
Zimbabwe	Зимбабве
Malaŵi	Малави
Mozambique	Мозамбик
Sudan	Судан
Uetersen	Итерзен
Augustus	Октавиан Август
Baibulo	Библия
True Jesus Church	Церковь истинного Иисуса
Chingerezi	Английский язык
Dong Hoi	Донгхой
Category:Templates	Категория:Википедия:Шаблоны
Lilongwe	Лилонгве
Lusaka	Лусака
Wikipedia:Sandbox	Википедия:Песочница
Zichyújfalu	Зичиуйфалу
Mwezi	Месяц
Tsamba Lalikulu	Заглавная страница
Lake Malawi	Ньяса
Category:Candidates for speedy deletion	Категория:Википедия:К быстрому удалению
Chitsamunda	Колониализм
Boma	Правительство
Category:Kuimba	Категория:Музыка
Alexander Macedon	Александр Македонский
Chigiriki	Греческий язык
Chiarabu	Арабский язык
Wikipedia:Community Portal	Википедия:Форум
Bien Hoa	Бьенхоа
Chinenero ya ndzika	Официальный язык
Moshchena	Мощёная
Paltoga	Палтога
ISO 3166-1	ISO 3166-1
Akhristadelfia	Христадельфиане
Chilankhulo cha Chichewa	Ньянджа
Wolembedwa ndi Yohane	Евангелие от Иоанна
Template:Commons Categories	Шаблон:Commonscat
Aroma	Послание к Римлянам
Matenda a Ebola	Геморрагическая лихорадка Эбола
Category:Boma	Категория:Правительство
Joyce Banda	Банда, Джойс
Kwacha ya Zambia	Замбийская квача
Nsadsi	Ятрофа куркас
KwaZulu-Natal	Квазулу-Натал
Chinangwa	Маниок съедобный
Western Cape	Западно-Капская провинция
Eastern Cape	Восточно-Капская провинция
Mpumalanga	Мпумаланга
Northern Cape	Северо-Капская провинция
Gauteng	Гаутенг
Limpopo	Лимпопо (провинция)
Wikipedia:Chithandizo cha Kulemba pa Wikipedia	Википедия:Как править статьи
Free State	Фри-Стейт
Ndya	Мелия ацедарах
North West (South Africa)	Северо-Западная провинция (ЮАР)
Nimu	Ним (дерево)
Akafula	Пигмеи
Ezekieli	Книга пророка Иезекииля
Bingu wa Mutharika	Мутарика, Бингу ва
Hastings Kamuzu Banda	Банда, Хастингс
Blantyre	Блантайр
Banovci (Nijemci)	Бановци (Ниемци)
Kasungu	Касунгу (город)
Trpinja	Трпинья
Kwacha ya Malaŵi	Малавийская квача
Mulungu dalitsa Malaŵi	Гимн Малави
Zomba, Malaŵi	Зомба
Anggun	Анггун
Cham'mwanba	Моринга масличная
Bakili Muluzi	Мулузи, Бакили
Katekisma wa Heidelberg	Гейдельбергский катехизис
Senjele	Слоновая трава
Limbe	Лимбе (значения)
Mwanza	Мванза (значения)
Stand and Sing of Zambia, Proud and Free	Гимн Замбии
Mzuzu	Мзузу
Baskin-Robbins	Baskin-Robbins
Nandalo	Голубиный горох
John Chilembwe	Чилембве, Джон
Mfula	Марула
Pigazzano	Пигаццано
Chipata	Чипата
Katunga	Свинорой
Kwacha	Квача
Category:Russia	Категория:Россия
Category:South Africa	Категория:ЮАР
Category:Zomera	Категория:Растения
Pongamia pinnata	Каранджа
Category:Akhristu	Категория:Христианство
Mtsinje wa Shire	Шире (река)
Category:Stubs	Категория:Незавершённые статьи
Category:Categories	Категория:Википедия:Категории, объединённые по внутренним признакам
Category:Wikipedia bots	Категория:Участники:Боты
Wikipedia:Administrators	Википедия:Администраторы
Koya	Койя
Template:Bot	Шаблон:Bot
Template:Documentation	Шаблон:Doc
Category:Wikipedians by language	Категория:Википедия:Участники по языкам
Sung Jae-gi	Сон Джэги
Template:Softredirect	Шаблон:Soft redirect
Template:Delete	Шаблон:К быстрому удалению
Category:Chilankhulo	Категория:Языки
Category:Wikipedia	Категория:Википедия
Wikipedia:Statistics	Википедия:Статистика
Template:-	Шаблон:-
Template:Col-break	Шаблон:Столбец
Template:Col-begin	Шаблон:Столбцы
Template:Col-end	Шаблон:Столбцы/конец
Wikipedia:Vital articles	Википедия:Список статей, которые должны быть во всех языковых версиях
Category:Africa	Категория:Африка
Category:Baibulo	Категория:Библия
Category:Miyezi	Категория:Месяцы
Template:Babel	Шаблон:Babel
Template:Provinces of South Africa	Шаблон:Провинции ЮАР
Template:Commons	Шаблон:Commons
Template:Stub	Шаблон:Заготовка
Template:See also	Шаблон:См. также
Template:User da	Шаблон:User da
Template:User be-2	Шаблон:User be-2
Template:User da-1	Шаблон:User da-1
Template:User cs-1	Шаблон:User cs-1
Template:User bg-1	Шаблон:User bg-1
Template:User eo-3	Шаблон:User eo-3
Template:User de	Шаблон:User de
Template:User de-1	Шаблон:User de-1
Template:User de-3	Шаблон:User de-3
Template:User en-3	Шаблон:User en-3
Template:User en-1	Шаблон:User en-1
Template:User en-2	Шаблон:User en-2
Template:User en-0	Шаблон:User en-0
Template:User en	Шаблон:User en
Template:User es-1	Шаблон:User es-1
Template:User fr-1	Шаблон:User fr-1
Template:User it-3	Шаблон:User it-3
Template:User sk	Шаблон:User sk
Template:User tr	Шаблон:User tr
Template:User ja-1	Шаблон:User ja-1
Template:User it-1	Шаблон:User it-1
Template:User hr-1	Шаблон:User hr-1
Category:MaBoma a South Africa	Категория:Провинции Южно-Африканской Республики
Category:User uk	Категория:User uk
Category:User uk-N	Категория:User uk-N
Template:Mod	Шаблон:Mod
Template:Pn	Шаблон:Уточнить страницу
Template:User uk	Шаблон:User uk
Template:User es-2	Шаблон:User es-2
Template:Welcome	Шаблон:Приветствие
Category:User fr-1	Категория:User fr-1
Template:Collapsible list	Шаблон:Collapsible list
Template:Location map	Шаблон:ПозКарта
Category:User en	Категория:User en
Category:User en-2	Категория:User en-2
Template:Infobox	Шаблон:Карточка
Template:User ru-4	Шаблон:User ru-4
Template:User nl-2	Шаблон:User nl-2
Template:Infobox settlement	Шаблон:НП
Template:User ru	Шаблон:User ru
Template:PoSA Commons	Шаблон:Commonscat-inline
Template:Both	Шаблон:Both
Template:User pl-1	Шаблон:User pt-1
Template:User no-2	Шаблон:User no-2
Template:Purge	Шаблон:Очистить кэш
Template:Infobox Continent	Шаблон:Материк
Template:Coord	Шаблон:Coord
Category:User be	Категория:User be
Category:User hr	Категория:User hr
Category:User sk	Категория:User sk
Category:User sl	Категория:User sl
Category:User eo	Категория:User eo
Category:User fr	Категория:User fr
Category:User ja	Категория:User ja
Category:User mk	Категория:User mk
Category:User pt	Категория:User pt
Category:User sv	Категория:User sv
Category:User sw	Категория:User sw
Category:User it-3	Категория:User it-3
Category:User cs-1	Категория:User cs-1
Category:User da-1	Категория:User da-1
Category:User sl-1	Категория:User sl-1
Category:User mk-1	Категория:User mk-1
Category:User be-2	Категория:User be-2
Category:User nl-2	Категория:User nl-2
Category:User ru-N	Категория:User ru-N
Category:User bg	Категория:User bg
Category:User bg-1	Категория:User bg-1
Category:User cs	Категория:User cs
Category:User da	Категория:User da
Category:User sk-N	Категория:User sk-N
Category:User de	Категория:User de
Category:User en-0	Категория:User en-0
Category:User en-3	Категория:User en-3
Category:User en-N	Категория:User en-N
Category:User eo-3	Категория:User eo-3
Category:User es	Категория:User es
Category:User es-1	Категория:User es-1
Category:User es-2	Категория:User es-2
Category:User hr-1	Категория:User hr-1
Category:User it	Категория:User it
Category:User it-1	Категория:User it-1
Category:User ja-1	Категория:User ja-1
Template:User sv-1	Шаблон:User sv-1
Category:Maiko a ku Africa	Категория:Страны Африки
Category:User pt-N	Категория:User pt-N
Category:User ru	Категория:User ru
Category:User ru-4	Категория:User ru-4
Category:User sv-1	Категория:User sv-1
Category:User tr	Категория:User tr
Category:User tr-N	Категория:User tr-N
Category:User uk-4	Категория:User uk-4
Category:Malaŵi	Категория:Малави
Category:Mozambique	Категория:Мозамбик
Template:User mk-1	Шаблон:User mk-1
Template:User no-1	Шаблон:User no-1
Template:User pt	Шаблон:User pt
Template:User uk-4	Шаблон:User uk-4
Category:Zambia	Категория:Замбия
Category:User nl	Категория:User nl
Category:User no-1	Категория:User no-1
Category:User no-2	Категория:User no-2
Category:User no	Категория:User no
Category:ZiPani za ndale	Категория:Политические партии
Template:User sl-1	Шаблон:User sl-1
Trojany	Трояны (Мазовецкое воеводство)
Category:User en-1	Категория:User en-1
Category:User de-1	Категория:User de-1
Category:User da-N	Категория:User da-N
Special:RecentChanges	Служебная:Свежие правки
Module:HtmlBuilder	Модуль:HtmlBuilder
Module:Coordinates	Модуль:Coordinates
