افريقا	Африка
جاپان	Япония
سوېلي امريکا	Южная Америка
ناروې	Норвегия
د آيرلېنډ جمهوريت	Ирландия
هنگري	Венгрия
اسپانیا	Испания
د امریکا متحده ایالتونه	Соединённые Штаты Америки
بلجیم	Бельгия
لوگزامبورگ	Люксембург
ځمکه	Земля
ژوند	Жизнь
انسان	Человек разумный
فېنلانډ	Финляндия
سويډن	Швеция
ډېنمارک	Дания
پولنډ	Польша
لېتوانيا	Литва
اېټاليا	Италия
سويس	Швейцария
اتريش	Австрия
يونان	Греция
تورکيه	Турция
بير	Пиво
پرتگال	Португалия
اروپا	Европа
آسيا	Азия
شمالي امريکا	Северная Америка
انټارکټيکا	Антарктида
ويکيپېډيا	Википедия
هالنډ	Нидерланды
نيويارک (ښار)	Нью-Йорк
واشنگټن ډي سي	Вашингтон (округ Колумбия)
برلين	Берлин
سولگر	Компьютер
څوریخ	Цюрих
انټرنټ	Интернет
باراک حسين اوباما	Обама, Барак
لندن	Лондон
قاهره	Каир
مڼه	Яблоко
پاريس	Париж
گووگل	Google (компания)
اتلانتيک سمندر	Атлантический океан
غلی سمندر	Тихий океан
کالېفورنیا	Калифорния
دونۍ	Понедельник
جنوري	Январь
فبروري	Февраль
مارچ	Март
مريخ	Марс
کېنيا	Кения
اېتوپیا	Эфиопия
گانا	Гана
اپرېل	Апрель
مې	Май
جون	Июнь
جولای	Июль
اگسټ	Август
سپټمبر	Сентябрь
اکتوبر	Октябрь
نومبر	Ноябрь
ډيسمبر	Декабрь
درې نۍ	Вторник
شورو	Среда
زيارت	Четверг
جمعه	Пятница
خالي	Суббота
يونۍ	Воскресенье
زمری	Лев
فرانسه	Франция
سپی	Собака
بريتانيا	Великобритания
پيشو	Кошка
چين د خلکو جمهوريت	Китайская Народная Республика
فرانسوي ژبه	Французский язык
اېتنول	Этанол
برازیل	Бразилия
روسیه	Россия
نهنگ	Китообразные
څلوريځ (مېچپوهنه)	Квадрат
بوینگ ۷۴۷	Boeing 747
ويکيمېډيا بنسټ	Фонд Викимедиа
آلمان	Германия
بېلاروس	Белоруссия
آلماني ژبه	Немецкий язык
آيسلېنډ	Исландия
الله	Бог
اېسټونيا	Эстония
زحل	Сатурн
الوتکه	Самолёт
جگړه	Война
جورج واکر بوش	Буш, Джордж Уокер
اوکراین	Украина
چېک جمهوريت	Чехия
سلواکيا	Словакия
سلووانیا	Словения
مولدوا	Молдавия
رومانیا	Румыния
بلغاریا	Болгария
د مقدونيې ولسمشريزه	Республика Македония
البانیا	Албания
کروواسيا	Хорватия
آزربايجان	Азербайджан
اندورا	Андорра
گرجستان	Грузия
قزاقستان	Казахстан
مالټا	Мальта
مانتېنېگرو	Черногория
واټيکان ښار	Ватикан
سان مارینو	Сан-Марино
بروکسل	Брюссельский столичный регион
بېلیز	Белиз
باربادوس	Барбадос
اندونيزيا	Индонезия
ولفگانگ امادیوس موزارت	Моцарт, Вольфганг Амадей
لیودویگ وان بیتهووین	Бетховен, Людвиг ван
تورکي ژبه	Турецкий язык
سویلي افریقا	Южно-Африканская Республика
الجزاير	Алжир
اوزبکستان	Узбекистан
تاشکند	Ташкент
اوبه	Вода
تلويزون	Телевидение
چېلي	Чили
عيسی	Иисус Христос
گاليليو گاليلی	Галилей, Галилео
عطارد	Меркурий
پېښليک	История
ژبه	Язык
زورواکي	Диктатура
مشتري	Юпитер
میشل باشله	Бачелет, Мишель
ستورپوهنه	Астрономия
سينگاپور	Сингапур
پوهنه	Наука
تکړښت	Спорт
اډولف هټلر	Гитлер, Адольф
فېس بوک	Facebook
ويکيلېکس	WikiLeaks
لومړنۍ نړېواله جگړه	Первая мировая война
دويمه نړېواله جگړه	Вторая мировая война
گړيال	Часы
شچېچېن	Щецин
شمېرپوهنه	Математика
لاتين ژبه	Латинский язык
بحرین	Бахрейн
ارمنستان	Армения
مېخي ليکدود	Клинопись
هیگزبوسون	Бозон Хиггса
سربيا	Сербия
سپوږمۍ	Луна
استنبول	Стамбул
آسټراليا	Австралия
پنځپوهنه	Физика
ارجنټاین	Аргентина
مخابرات	Электросвязь
پيرو	Перу
ژونپوهنه	Биология
شمالي کوريا	Корейская Народно-Демократическая Республика
کمبودیا	Камбоджа
قرآن	Коран
ډانگسر	Динозавры
ژوپوهنه	Зоология
اسلام	Ислам
ناک	Груша
بوټپوهنه	Ботаника
لېخ والېسا	Валенса, Лех
اروپايي اتحاديه	Европейский союз
WWW	Всемирная паутина
شعر	Поэзия
کمپيوټري ويروس	Компьютерный вирус
ليمو	Лимон
گل	Цветок
ناپليون بوناپارت	Наполеон I
لمر	Солнце
آسمان	Небо
وېکټور هوگو	Гюго, Виктор
اقيانوسيه	Океания
لمريز غونډال	Солнечная система
هايډروجن	Водород
انگېلا مېرکل	Меркель, Ангела
لوړغږی	Громкоговоритель
ورځ	Сутки
شپه	Ночь
کال	Год
پېړۍ	Век
اوسلو	Осло
جنسي اړيکې	Секс
دوبۍ	Дубай (эмират)
آکسيجن	Кислород
سياره	Планета
سندارا	Музыка
مسکو	Москва
چاډ	Чад
الومېنيم	Алюминий
هند	Индия
اوسپنه	Железо
لوېديځ	Запад
گوگړ	Сера
ساموا	Самоа
ختيځ	Восток
وېليم شېکسپيير	Шекспир, Уильям
نكل	Басня
مارشال ټاپووان	Маршалловы Острова
مغولستان	Монголия
سترنج	Шахматы
چنگېز خان	Чингисхан
آس	Домашняя лошадь
امسټرډام	Амстердам
وسله	Оружие
ژوي	Животные
سورينام	Суринам
گويانا	Гайана
اېکوادور	Эквадор
ځمکني توتان	Земляника
بوديزم	Буддизм
بولېویا	Боливия
تامبه	Медь
بوټی	Растения
سېنټ لوسیا	Сент-Люсия
ليونارډو ډاوېنچي	Леонардо да Винчи
چڼاس	Грибы
جمايکا	Ямайка
گرېنادا	Гренада
گواتمالا	Гватемала
هندوراس	Гондурас
ډومنيکان جمهوريت	Доминиканская Республика
اهلي خوگ	Домашняя свинья
شمالي قطبي سمندر	Северный Ледовитый океан
هایتي	Республика Гаити
اېلسلوادور	Сальвадор
ايران	Иран
عراق	Ирак
کوسټاریکا	Коста-Рика
اسرائيل	Израиль
پاناما	Панама
يمن	Йемен
اردن	Иордания
نیکاراگوا	Никарагуа
قرغزستان	Киргизия
کوېټ	Кувейт
لاووس	Лаос
لېبنان	Ливан
مالديپ	Мальдивы
امريکا لويه وچه	Америка
ميانمار	Мьянма
نيپال	Непал
عمان	Оман
پاکستان	Пакистан
قطر	Катар
سعودي عربستان	Саудовская Аравия
سریلانکا	Шри-Ланка
جوزف سټالين	Сталин, Иосиф Виссарионович
سوريه	Сирия
اپلاتون	Платон
تاجيکستان	Таджикистан
د چين جمهوريت	Китайская Республика
يوټيوب	YouTube
ارستو	Аристотель
تايلنډ	Таиланд
اورگاډی	Поезд
آرسېنيک	Мышьяк
راډيو	Радио
تورکمنستان	Туркмения
عربي متحده امارات	Объединённые Арабские Эмираты
چارلس چاپلين	Чаплин, Чарльз
سوېلي کوريا	Республика Корея
سمپسنز	Симпсоны
افغانستان	Афганистан
بنگله دېش	Бангладеш
فرانتس کافکا	Кафка, Франц
مالي	Мали
سوقرات	Сократ
آنگولا	Ангола
بوتان	Бутан
ټويټر	Твиттер
برونای	Бруней
تانزانیه	Танзания
پاره	Ртуть
فلېپين	Филиппины
د منځنی افريقا ولسمشريزه	Центральноафриканская Республика
آيزاک نيوټن	Ньютон, Исаак
آلبرټ آينشټاين	Эйнштейн, Альберт
تونس	Тунис
زېمبيا	Замбия
زېمبابوې	Зимбабве
بېجنگ	Пекин
سوېلي سوډان	Южный Судан
بېنين	Бенин
بوتسوانا	Ботсвана
بورکینا فاسو	Буркина-Фасо
بروندي	Бурунди
کانگو جمهوريت	Республика Конго
جېبوتي	Джибути
پولونيم	Полоний
باډن ورټمبرگ	Баден-Вюртемберг
اریتره	Эритрея
فيودور ميخايلوويچ داستاېفسکي	Достоевский, Фёдор Михайлович
گابن	Габон
مهاتما گاندي	Махатма Ганди
گامبيا	Гамбия
عاج ساحل	Кот-д’Ивуар
کامرون	Камерун
لايبېريا	Либерия
لېبيا	Ливия
مادغاسکر	Мадагаскар
مالاوي	Малави
موریتانيا	Мавритания
ماوریتوس	Маврикий
مراکش	Марокко
موزمبيق	Мозамбик
نېمبیا	Намибия
نایجېر	Нигер
نايجېريا	Нигерия
راونډا	Руанда
سېنېگال	Сенегал
سیشل	Сейшельские Острова
سېرالیون	Сьерра-Леоне
سومالیا	Сомали
سوډان	Судан
سوازيلانډ	Свазиленд
شنه زرغونه	Радуга
استقلاب	Обмен веществ
ملگري ملتونه	Организация Объединённых Наций
دانتې الیگيري	Данте Алигьери
ځمکپېژندنه	Геология
ځمکپوهنه	География
زړه	Сердце
ماغزه	Головной мозг
پراگ	Прага
شين	Синий цвет
سپين زر	Серебро
يورانيم	Уран (элемент)
پلوتونيم	Плутоний
ممبای	Мумбаи
گوا	Гоа
مهاراشترا	Махараштра
زارلاند	Саар
براندنبورگ	Бранденбург
برېمن (ايالت)	Бремен (земля)
بيت المقدس	Иерусалим
هندي سمندر	Индийский океан
کلراډو	Колорадо
ژمی	Зима
پسرلی	Весна
دوبی	Лето
منی	Осень
اسامه بن لادن	Усама бен Ладен
اوپرا	Опера
کلکته	Калькутта
ډېلي	Дели
بند پایان	Членистоногие
اسلام آباد	Исламабад
پيسې	Деньги
خوځندکې	Насекомые
ولادمير ايليچ لېنين	Ленин, Владимир Ильич
نېكولو مكياوېلې	Макиавелли, Никколо
مايکروسافټ وېنډوز	Windows
مانيلا	Манила
توکيو	Токио
استانه	Астана
بغداد	Багдад
هندي ژبه	Хинди
اوردو ژبه	Урду
واليبال	Волейбол
وين	Вена
ډبلن	Дублин
بوډاپسټ	Будапешт
د مسيح حقيقي کليسا	Церковь истинного Иисуса
انگرېزي ژبه	Английский язык
بانگکوک	Бангкок
کوالالامپور	Куала-Лумпур
ديپلوماسي	Дипломатия
کيېف	Киев
كونسكوولا	Коньсковоля
2012	2012 год
2013	2013 год
خواړه	Пища
اېلېکټرون	Электрон
رغاويز اوښتون	Промышленная революция
د روم ټولواکمني	Римская империя
مايکروسافټ	Microsoft
پروټون	Протон
کوروف	Курув
کيميا	Химия
نيوټرون	Нейтрон
صنعا	Сана
آرنولد شوارزنېگر	Шварценеггер, Арнольд
فوټبال	Футбол
آيفون	IPhone
مايکل جېکسن	Джексон, Майкл
انتوان دي سينت اکسيوپيري	Сент-Экзюпери, Антуан де
سور	Красный цвет
هوا	Атмосфера Земли
پېرى	Джинн
ربات	Рабат
الجزيره	Алжир (город)
ترابلس	Триполи
تهران	Тегеран
جکارتا	Джакарта
انقره	Анкара
رياض	Эр-Рияд
فوټ	Фут
وېشنيزه:د ويکيپېډيا کينډۍ	Категория:Википедия:Шаблоны
د مشق	Дамаск
لوم	Ломе
دوها	Доха
دودوما	Додома
ښوونځی	Школа
پوهنتون	Университет
د پوهنغونډ په اړه	Википедия:Добро пожаловать в Википедию
آسټراليا (لويه وچه)	Австралия (континент)
ورونپاسی	Ноутбук
الجبر	Алгебра
دونگ هوی هوايي ډگر	Донгхой (аэропорт)
آر دړه	Материнская плата
كوريتيبا	Куритиба
پنجاب (پاکستان)	Пенджаб (Пакистан)
وېشنيزه:د افغانستان پېښليک	Категория:История Афганистана
توماس شېن کانېري	Коннери, Шон
كنفيوشيوس	Конфуций
کوربن بليو	Блю, Корбин
وېشنيزه:شمېرپوهنه	Категория:Математика
کينډۍ:د هېواد مالومات ایران	Шаблон:Флагификация/Иран
وېشنيزه:د ایران تاریخ	Категория:История Ирана
امريکايي ډالر	Доллар США
عيسويت	Христианство
لويه وچه	Континент
مرغه	Птицы
پلازمېنه	Столица
کينډۍ:اسلام	Шаблон:Ислам
مياشت (موده)	Месяц
مصطفی کمال اتاتورک	Ататюрк, Мустафа Кемаль
کينډۍ:تانبه	Шаблон:Портал
هوانگ شيان فان	Хуан Сяньфань
بقراط	Гиппократ
الماس	Алмаз
پوهنغونډ	Энциклопедия
RAM	Запоминающее устройство с произвольным доступом
لومړی مخ	Заглавная страница
کانډنسر	Электрический конденсатор
باسکټبال	Баскетбол
کرېکټ	Крикет
اوراسيا	Евразия
د هېتیانو واکمنۍ	Хетты
وينه لږی	Анемия
کېپ ټاون	Кейптаун
قراقرم	Каракорум (горная система)
هندوکش	Гиндукуш
ميترو	Метрополитен
کنځری	Кизильник
پيکاسو	Пикассо, Пабло
بس	Автобус
ټرام	Трамвай
بابل	Вавилон
آنتون پاولوف چيخوف	Чехов, Антон Павлович
چارلېز ډيکېنز	Диккенс, Чарльз
سپارتا	Спарта
موينجو دېړو	Мохенджо-Даро
سمرقند	Самарканд
بخارا	Бухара
چې گوارا	Че Гевара, Эрнесто
کابل	Кабул
گوېټه	Гёте, Иоганн Вольфганг фон
مهبل	Влагалище женщины
فلسفه	Философия
د مقدس ویټوس کليسا	Собор Святого Вита
چای	Чай
کمونيزم	Коммунизм
انارشيزم	Анархизм
پانگولي	Капитализм
لېبراليزم	Либерализм
فاشېزم	Фашизм
ولسپالنه	Национализм
حافظ شېرازي	Хафиз Ширази
هېوادپالنه	Патриотизм
هیواد	Страна
ولس	Нация
هيلري کلنټن	Клинтон, Хиллари
د برتانيې موزيم	Британский музей
ژان ژاک روسو	Руссо, Жан-Жак
هومر	Гомер
الكساندر هومبولدت	Гумбольдт, Александр фон
کوارک	Кварк
اېډوارډ ټېللر	Теллер, Эдвард
تور زېړی	Гепатит B
اتيزم	Атеизм
نيلز بوهر	Бор, Нильс
ژونکيميا	Биохимия
ژونپنځپوهنه	Биофизика
چاپېريالپوهنه	Экология
بارسلونا فوټبال کلب	Барселона (футбольный клуб)
واگ	Политика
ووبپوهنه	Гистология
عربي ټولنه	Лига арабских государств
ولسواکي	Демократия
نجيب محفوظ	Махфуз, Нагиб
د سره صليب او سرې مياشتې نړيوال غورځنگ	Международное движение Красного Креста и Красного Полумесяца
نړيوالتوب	Глобализация
ناټو	Организация Североатлантического договора
جين	Ген
حکومت	Правительство
نوبل جايزه	Нобелевская премия
چېن شي هوانگ	Цинь Шихуанди
منځنی ختيځ	Средний Восток
رنځپوهنه	Патология
رابندرانات ټاگور	Тагор, Рабиндранат
لېو نيكولايوويچ تولستوى	Толстой, Лев Николаевич
مارک ټوېن	Марк Твен
ايډيالوژي	Идеология
ادا لولېس	Лавлейс, Ада
مارکسيزم	Марксизм
ولسمشريزه	Республика
دولت	Государство
گوند	Политическая партия
بډمنټن	Бадминтон
يوري الکسويچ گاگارين	Гагарин, Юрий Алексеевич
ابن بطوطه	Ибн Баттута
اباسين (سيند)	Инд
فرانز جوزیف هایدن	Гайдн, Йозеф
غوږ	Ухо
سترگه	Глаз
سندره	Песня
اوښ	Верблюды
تی لرونکی ځناوران	Млекопитающие
مېږی	Муравьи
مارگريت تاچر	Тэтчер, Маргарет
ډي آکسي رايبونيوکليک اسيد	Дезоксирибонуклеиновая кислота
ژباړه	Перевод
ښامار	Дракон
مور	Мать
پلار	Отец
لېږدچارې	Транспорт
روسي ژبه	Русский язык
ولادمير پوتين	Путин, Владимир Владимирович
حقوق	Право
اساسي قانون	Конституция
د بشري حقونو نړېواله اعلاميه	Всеобщая декларация прав человека
د روغتيا نړيوال سازمان	Всемирная организация здравоохранения
د سوداگرۍ نړيوال سازمان	Всемирная торговая организация
پرېولنځی	Туалет
طبيعت	Природа
سادرملنه	Психиатрия
ژونکه	Клетка
وينه	Кровь
هډوانه	Скелет
سږي	Лёгкие
ساييز غونډال	Дыхательная система
رومانيايي ژبه	Румынский язык
بلغاريايي ژبه	Болгарский язык
ښوونپوهنه	Дидактика
روزنپوهنه	Педагогика
يمال	Лавина
رېږدله	Землетрясение
طبيعي پوهنې	Естествознание
ابن سينا بلخي	Ибн Сина
وېنسټون چرچل	Черчилль, Уинстон
نېلسن مانډېلا	Мандела, Нельсон
انزايم	Ферменты
امينو اسيد	Аминокислоты
ورېځ	Облака
سولپوهنه	Логика
مېچپوهنه	Геометрия
وټپوهنه	Экономика (наука)
پانگه (وټپوهنه)	Капитал
ارز	Валюта
رغاوه	Промышленность
ورکړېنه	Налог
ژبپوهنه	Лингвистика
يوناني ابېڅې	Греческий алфавит
ادبپوهنه	Литература
وېشنيزه:فرانسه	Категория:Франция
ناول	Роман
سره گيدړه	Обыкновенная лисица
اوستراوا	Острава
کوروش ۲	Кир II Великий
ټولنه	Общество
تمدن	Цивилизация
زده کړه	Образование
هوگو چاوېز	Чавес, Уго
واده	Брачный союз
وگړنيز حقوق	Права человека
توکمپالنه	Расизм
گوډ تېمور	Тамерлан
عمر بن خطاب	Умар ибн аль-Хаттаб
پوځ	Военное дело
سلیمان ۱	Сулейман I
قهوه	Кофе
د آمو سيند	Амударья
شيدې	Молоко
ارغنداب رود	Аргандаб
غر	Гора
هري رود	Теджен (река)
هلمند رود	Гильменд (река)
توكبنسټ	База данных
کابل سيند	Кабул (река)
صلاح الدين ايوبي	Салах ад-Дин
اشوک	Ашока
جلال الدين محمد اکبر	Акбар I Великий
هانگ کانگ	Гонконг
کراچۍ	Карачи
د ريال مادريد فوټبال کلب	Реал Мадрид (футбольный клуб)
سيول	Сеул
شانگهای	Шанхай
د ماد واکمني	Мидийцы
اقليدس	Евклид
بايټ	Байт
محمد بن موسی خوارزمي	Аль-Хорезми
ناروېژي ژبه	Норвежский язык
نوم چومسكي	Хомский, Ноам
چيکی ژبه	Чешский язык
کارل مارکس	Маркс, Карл
موسی	Моисей
پوهه	Знание
هندويزم	Индуизм
اټوم	Атом
يوناني ژبه	Греческий язык
چليز غونډال	Операционная система
تاج محل	Тадж-Махал
بنسټپالنه	Фундаментализм
برېښليک	Электронная почта
پاړسي ژبه	Персидский язык
مذهب	Религия
اېمپاير سټېټ ودانۍ	Эмпайр-стейт-билдинг
سېگمونډ فرايډ	Фрейд, Зигмунд
جاينيزم	Джайнизм
گيورگ ويلهېلم فرېدرېش هېگل	Гегель, Георг Вильгельм Фридрих
باکو	Баку
تاجکي ژبه	Таджикский язык
اوزبکي ژبه	Узбекский язык
تورکمني ژبه	Туркменский язык
يهوديت	Иудаизм
آزربايجاني ژبه	Азербайджанский язык
ابن خلدون	Ибн Хальдун
امانوېل کانت	Кант, Иммануил
سکيزم	Сикхизм
فرېدرېک وېلهېلم نېتشي	Ницше, Фридрих
بشکیک	Бишкек
دوشنبه	Душанбе
اينه	Печень
پښتورگی	Почка (анатомия)
ادم سمېت	Смит, Адам
احساس	Эмоция
ساپوهنه	Психология
آند	Мышление (психология)
مهاوېرا	Махавира
سمندر	Океан
ملکه وېکټوريا	Виктория (королева Великобритании)
محمد	Мухаммед
اخلاق	Этика
پوهنپوهنه	Эпистемология
سچين رمېش ټنډولکر	Тендулкар, Сачин
عبدالکلام	Абдул Калам
بي بي سي	Би-би-си
شاهرخ خان	Хан, Шахрух
سلمان خان	Хан, Салман
محمد الغزالي	Абу Хамид аль-Газали
عامر خان	Хан, Аамир
اميتاببچن	Баччан, Амитабх
شيعه	Шииты
گېډه	Брюшко
زرتشتيت	Зороастризм
تصوف	Суфизм
ژبه (اناتومي)	Язык (анатомия)
پانکراس	Поджелудочная железа
غاړه	Шея
کمزوره شوي یورانیم	Обеднённый уран
هولي	Холи
زړه پوهنه	Кардиология
ډېوېډ بکهم	Бекхэм, Дэвид
کيم جونگ ايل	Ким Чен Ир
وېشنيزه:وېنزوېلا	Категория:Венесуэла
روبېرت موگابي	Мугабе, Роберт
خاپوړن	Пресмыкающиеся
کوتره	Голубиные
باکټريا	Бактерии
ونه	Дерево
دوه ژوندوي	Земноводные
اوښتون	Революция
انگور	Виноград (ягода)
گبين	Мёд
کچالو	Картофель
سابه	Овощи
ټکنالوجي	Технология
انجينري	Инженерное дело
خبريالي	Журналистика
ورځپاڼه	Газета
غږلېږدی	Телефон
هڅوب	Культура
سانسکریت ژبه	Санскрит
د زړه او رگونو غونډال	Кровообращение
د پارکېنسون ناروغي	Болезнь Паркинсона
گارډيان	The Guardian
انډيپېنډنټ	The Independent
درملگري	Медицина
مقننه قوه	Законодательная власть
مالگه	Поваренная соль
مايکروسافټ آفېس	Microsoft Office
وېشنيزه:رومانیا	Категория:Румыния
کيمياوي توکی	Химический элемент
ابن باجه	Ибн Баджа
هورمون	Гормоны
اپارتايد	Апартеид
لوبه	Игра
جودو	Дзюдо
مقناطيس	Магнит
فلم	Фильм
ساهيالي	Мультипликация
کرنه	Сельское хозяйство
غږ	Звук
نانو تکنالوژي	Нанотехнология
ښيښه	Стекло
وخت	Время
ليکپاڼه	Бумага
کازمېکي وړانگې	Космические лучи
جوار	Кукуруза сахарная
انځورکښنه	Живопись
تشیالیونی	Космонавт
انځوراخيستنه	Фотография
برېښنايي ټېکنالوژي	Электроника
فريکونسي	Частота
لاهور	Лахор
د خپلواکو هېوادونو لړليک	Алфавитный список стран и территорий
ابوريحان بيروني	Аль-Бируни
څېړۍ	Дуб
سرطان	Злокачественная опухоль
کولرا	Холера
غنم	Пшеница
ناروغي	Болезнь
گرېگوري کليز	Григорианский календарь
نیکوتین	Никотин
روغتيا	Здоровье
ملاريا	Малярия
انټيبايوټيک	Антибиотики
پنسلين	Бензилпенициллин
نېمونيا	Пневмония
گوزڼ	Полиомиелит
اېډز	ВИЧ-инфекция
نری رنځ	Туберкулёз
ډايبېټېز مېلېټوز	Сахарный диабет
صليبي جگړې	Крестовые походы
منځنۍ پېړۍ	Средние века
عثماني پېر	Османская империя
د کورنيو توليداتو ټوليز ارزښت	Валовой внутренний продукт
برېښنا	Электричество
یان آموس کمېنسکي	Коменский, Ян Амос
اټومي برېښناکوټ	Ядерная энергия
د بړاس ماشين	Паровая машина
توره (وسله)	Меч
هستوي وسلې	Ядерное оружие
شوبله	Танк
هرمان ون رومپوې	Ромпёй, Херман Ван
تورتوت	Ежевика
ناريال	Кокосовая пальма
انار	Гранат обыкновенный
مالټه	Апельсин
A New Etymological Vocabulary of Pashto	Киви (фрукт)
گراڅ	Грац
ډېبټ کارډ	Дебетовая карта
انجلينا جولي	Джоли, Анджелина
عربي ژبه	Арабский язык
کانډوم	Презерватив
تيرانوسور	Тираннозавр
تریسراتوپس	Трицератопсы
ستگوسور	Стегозавры
کارکارودونتوسور	Кархародонтозавры
وچکښ	Карандаш
برنو	Брно
هوجينتاو	Ху Цзиньтао
د شوروي سوسياليستي جمهوريتونو اتحاد	Союз Советских Социалистических Республик
انځورۍ	Фотоаппарат
اېچ آی وي	Вирус иммунодефицита человека
يومکی	Лопатка
ځاني سولگر	Персональный компьютер
بروس لي	Ли, Брюс
هايپوتايرايډيزم	Гипотиреоз
نړۍ	Мир (Земля)
د روم جمهوريت	Римская республика
ټریلوبیټ	Трилобиты
گردکه	Окружность
گرځنده غږلېږدی	Сотовый телефон
اوښمرغه	Страус
ويټامين اې	Витамин A
بغ	Цаплевые
پيونگيانگ	Пхеньян
د لور موندنې نړيوال غونډال	GPS
د هېوادونو لړليک د کورنيو توليداتو د ټوليز ارزښت له مخې	Список стран по ВВП (номинал)
جگتورن	Капитан (воинское звание)
سمندري غڼې	Морские пауки
لړم	Скорпионы
ما اينگ جيو	Ма Инцзю
سمندري لړمان	Ракоскорпионы
انټرنټ لټوونکی ماشين	Поисковая машина
بخارست	Бухарест
لوور	Лувр
تیرانا	Тирана
ويکټوريا بېکهم	Бекхэм, Виктория
درېڅنډی	Треугольник
سټيف جوبز	Джобс, Стив
معمر القذافي	Каддафи, Муаммар
پړانگ	Тигр
لومړی خوان کارلوس	Хуан Карлос I
مېچې	Вермишель
لمسنالۍ	Тачпад
سامسونگ	Samsung
سولگرپوهنه	Информатика
ټولنپوهنه	Социология
گاگره	Бетон
جغرافي کوراډينېټونو سيستم	Географические координаты
پڼې	Лёгкая обувь
بهايي	Бахаи
بانک	Банк
د وينا ازادي	Свобода слова
اډېل	Адель (певица)
د نش ميزان	Равновесие Нэша
هوږه	Чеснок
وگړپوهنه	Антропология
بادرنگ	Огурец обыкновенный
ارنېست مېلر هېمېنگوې	Хемингуэй, Эрнест
عشق آباد	Ашхабад
ټاپو	Остров
تور (رنگ)	Чёрный цвет
پياز	Лук репчатый
رسمي ژبه	Официальный язык
لرغونپوهنه	Археология
بالکان	Балканский полуостров
سلاوي ژبې	Славянские языки
سر	Голова
ولسي لاره	Государственный гимн
تماسي عدسيه	Контактные линзы
الفرېډ نوبل	Нобель, Альфред
ږمنځ	Расчёска
لیلا داونز	Даунс, Лила
موسم	Времена года
راولپنډۍ ولسوالۍ	Равалпинди (округ)
ډبرين سکاره	Ископаемый уголь
يارمخچۍ	Малый жаворонок
نينورشک	Новонорвежский язык
بوکمول	Букмол
کونگ	Совообразные
شمزۍ لرونکي ژوي	Позвоночные
نړېوال تشيال تمځای	Международная космическая станция
ISO 3166-1	ISO 3166-1
کجوره	Финик пальчатый
څټک	Молоток
اروپايي کاغۍ	Сорока
چابکۍ	Таракановые
كوچنى شاهزاده	Маленький принц
شمالي باز	Ястреб-тетеревятник
غضروفی کبان	Хрящевые рыбы
ځنگلي سار	Обыкновенный канюк
سيلاني کارغه	Грач
لويديځي کاغۍ	Галка
شودپۍ	Белая трясогузка
اېشېريکيا کولي	Кишечная палочка
توتکۍ	Деревенская ласточка
گنگو	Шафран (пряность)
ترکاڼک	Дятловые
شامتوره	Обыкновенный скворец
کوشانيان	Кушанское царство
کومکۍ	Вяхирь
جوک	Коноплянка
آتروپين	Атропин
شين شارک	Синяя акула
اورني سمندر	Огненная саламандра
سپوږمکۍ	Искусственный спутник Земли
شينغاړی	Варакушка
تورياڼۍ	Стрижиные
لونگ	Гвоздичное дерево
زيره	Тмин обыкновенный
وژونکی نهنگ	Косатка (млекопитающее)
سپېرکونده	Хохлатый жаворонок
منځنۍ آسيا	Центральная Азия
شمالي افريقا	Северная Африка
مرکزي افريقا	Центральная Африка
ختيځه اروپا	Восточная Европа
لوېديځه اروپا	Западная Европа
افريقايي اوراسيا	Афроевразия
د فلسفې تاريخ	История философии
زي نړیواله جگړه (فلم)	Война миров Z
مړز	Обыкновенный перепел
مروری	Ромашка аптечная
چې زېټ ۸۰۵ برېن توپک	CZ 805
کمول (مارغه)	Аистовые
اوبدانه	Текстиль
توکي	Благо (экономика)
سپوږميز ليږديز کليز	Исламский календарь
ميلوش زېمان	Земан, Милош
اېف-۱۵	McDonnell Douglas F-15 Eagle
ليوکېمي	Лейкоз
ديموکراتيک گوند ( د امريکا متحده ایالتونه)	Демократическая партия (США)
ټيکاله	Жаворонковые
شاتو مچی	Медоносная пчела
خاورين چينجی	Lumbricus terrestris
ولسمشر	Президент
باشه	Сапсан
رودولف کلاوزيوس	Клаузиус, Рудольф Юлиус Эммануэль
تورغوږی	Каракал
ډېل	Dell
زايلومېټازولين	Ксилометазолин
شمېرنی	Калькулятор
شاه محمود هوتک	Мир Махмуд-шах
امير عبدالرحمان خان	Абдур-Рахман (эмир Афганистана)
ټکټکی	Вертишейки
د عربستان ټاپووزمه	Аравийский полуостров
امير دوست محمد خان	Дост Мухаммед
بېریف بې-۲۰۰	Бе-200
پهلوي ژبه	Среднеперсидский язык
وری	Овен (знак зодиака)
جېهلم ولسوالۍ	Джелам (округ)
ملاله يوسفزۍ	Юсуфзай, Малала
جومات	Мечеть
بلوڅی ژبه	Белуджский язык
د کتاب نړيواله کره شمېره	Международный стандартный книжный номер
د کندهار نړيوال هوايي ډگر	Кандагар (аэропорт)
د مغولو پاچايي	Империя Великих Моголов
گړدود	Диалект
ایرانی ژبی	Иранские языки
هېما مالېني	Хема Малини
لاس	Кисть (анатомия)
خلکو شمېر	Население
د پاکستان ژبې	Языки Пакистана
پاڼه	Лист
لوبگر	Актёр
هاليووډ	Голливуд
محمد حسنی مبارک	Мубарак, Хосни
دينپوهنه	Богословие
پابلو نرودا	Пабло Неруда
زیوس	Зевс
موساد	Моссад
یغنابی ژبه	Ягнобский язык
انجيل	Евангелие
الېکسانډر گراهام بېل	Белл, Александр Грейам
ستورپېژندنه	Астрология
ساز	Музыкальные инструменты
ويټني هيوسټن	Хьюстон, Уитни
سابون	Мыло
موشوفتسی	Мошовце
شکيرا	Шакира
محمود احمدي نژاد	Ахмадинежад, Махмуд
كېښكلى ټيكلى (CD)	Компакт-диск
چورلکه	Вертолёт
القاعده	Аль-Каида
محمد فاتح	Мехмед II
اناستاسيا	Анастейша
فرات	Евфрат
البېرټ کامو	Камю, Альбер
د فارس خليج	Персидский залив
قطب نما	Компас
ټولنيزې پوهنې	Общественные науки
ټاپووزمه	Полуостров
نوی کال	Новый год
اېف-۱۴	Grumman F-14 Tomcat
ويټامين	Витамины
تورات	Тора
كرم	Кочанная капуста
متل	Пословица
هينداره	Зеркало
لرغونې پاړسي	Древнеперсидский язык
عربان	Арабы
براډ پېت	Питт, Брэд
کړکۍ	Окно
اکدي ژبه	Аккадский язык
څارندوی	Полиция
ولسي جرگه	Парламент
اوساکا	Осака
د کېمبرېج پوهنتون	Кембриджский университет
اجرايي قوه	Исполнительная власть
تعمید غسل	Крещение
ډډون	Инфляция
سابندي	Бронхиальная астма
عمر خيام	Омар Хайям
وله	Ива
محمد علي کلي	Али, Мохаммед
خاوره	Почва
اينځر	Инжир
ليکوال	Писатель
د توهوکو سونامي او رېږدله ۲۰۱۱	Землетрясение в Японии (2011)
واتسلاف هاول	Гавел, Вацлав
د ورېښم لار	Великий шёлковый путь
جېن آسټن	Остин, Джейн
کوردي ژبه	Курдские языки
زرۍ	Тысячелетие
علمی نوم	Биноминальная номенклатура
هنرېک ايبسن	Ибсен, Генрик
ماموت	Мамонты
څلورڅنډی	Четырёхугольник
د سرکوزي والگی	Свиной грипп
اوزون	Озон
جذام	Лепра
مخ (اناتومي)	Лицо
خپلواکي	Независимость
ښوون	Олива европейская
سليمان	Соломон
یاهو!	Yahoo!
کرښه (مېچپوهنه)	Прямая
فرعون	Фараон
کلاشېنکوف اې کې ۴۷	Автомат Калашникова
څپه	Волна
د وینې سره کرویات	Эритроциты
سند	Синд
فرانسېس بیکن	Бэкон, Фрэнсис
معمولي مندته	Абрикос
نيکول کېډمېن	Кидман, Николь
هايکو	Хайку
عثمان بن عفان	Усман ибн Аффан
وگړشمېرنه	Демография
ځمکواکي	Феодализм
اوبړۍ	Водоросли
نتالي پورټمېن	Портман, Натали
هېرټا مولر	Мюллер, Герта
مکډونالډز	McDonald’s
يوکوهوما	Иокогама
گړپوهنه	Морфология (лингвистика)
ويليم فاکنر	Фолкнер, Уильям
هندواڼه	Арбуз обыкновенный
پخلی	Кулинария
بادي ژرنده	Ветряная мельница
د حماس اسلامي غورځنگ	ХАМАС
آيت الله روح الله خميني	Хомейни, Рухолла Мусави
ليزر	Лазер
تبه	Лихорадка
تيد	Тейде
کوچنی وټه	Микроэкономика
رجب طيب اردوغان	Эрдоган, Реджеп Тайип
خزدکپوهنه	Энтомология
تبر	Топор
علي بن ابي طالب	Али ибн Абу Талиб
گورجی سپی	Сеттер (собака)
لویه وټه	Макроэкономика
انسولين	Инсулин
بازارموندنه	Маркетинг
سرشمېرنه	Перепись населения
ابن رشد	Ибн Рушд
لسيزه	Десятилетие
بادام	Миндаль
څښاک	Напиток
نيانډرټال	Неандерталец
الهي کمېډي	Божественная комедия
ووب	Ткань (биология)
امير شېر علي خان	Шир-Али
پروېز مشرف	Мушарраф, Первез
لوط	Лот (Библия)
دهاډرونو ستر تعجیل کوونکي ماشین	Большой адронный коллайдер
يحيی	Иоанн Креститель
دیلما روسف	Русеф, Дилма
ساندرا بللاک	Буллок, Сандра
جراحي	Хирургия
بياتي	Ножницы
نفرتيتي	Нефертити
لمونځ	Молитва
سکايپ	Skype
غږپوهنه	Фонология
هارولډ پينټر	Пинтер, Гарольд
د حزب الله اسلامی غورځنگ	Хезболла
باو	Сифилис
د آشور واکمني	Ассирия
ودانۍ	Здание
سوني	Sony
باريس ولاديميروويچ پاسترناک	Пастернак, Борис Леонидович
کونستانتين اېدواردوويچ تسيولکوفسکي	Циолковский, Константин Эдуардович
سينما	Кинотеатр
بودجه	Бюджет
څپواټن	Длина волны
داوود	Давид
کنگل هاکي	Хоккей с шайбой
کوردستان	Курдистан
د موس مقياس	Шкала Мооса
بواسيرونه	Геморрой
سلواغه (مياشت)	Бахман (месяц)
ليندۍ (مياشت)	Азар (месяц)
مرغومی (مياشت)	Дей (месяц)
کب (مياشت)	Эсфанд
هېنريک سېنکېويچ	Сенкевич, Генрик
ککرۍ پتنگ	Мёртвая голова (бабочка)
كوكايين	Кокаин
فینیکیان	Финикия
شهادت	Шахада
تله (مياشت)	Мехр
د بابل ځوړند بڼ	Висячие сады Семирамиды
حاکميت	Суверенитет
خديجه بنت خويلد	Хадиджа бинт Хувайлид
ام سلمه هند بنت ابي اميه	Умм Салама бинт Абу Умайя
نیلي نهنگ	Синий кит
څېړنه	Исследование
سولي پرودممه	Сюлли-Прюдом
اوبپوهنه	Гидрология
بوکر	Конус
د مورنۍ ژبې نړيواله ورځ	Международный день родного языка
سهيونېزم	Сионизм
د طالبانو اسلامي غورځنگ	Талибан
اناکزیمېنډر	Анаксимандр
کورکمن	Куркума длинная
د مسلمانانو د شمېر له مخې د هېوادونو لړليک	Ислам по странам
ځنگلي پيشو	Камышовый кот
عبدالله گل	Гюль, Абдулла
ختيځپوهنه	Ориентализм
کرېشنا	Кришна
ساباوري	Анимизм
ليکچه	Тетрадь
مالیه	Финансы
وچکالي	Засуха
تور مرچ	Перец чёрный
ياقوت	Рубин
کشمير	Кашмир
ټولپوښتنه	Референдум
كپېړ	Настоящие крокодилы
مولانا جلال الدين محمد بلخي	Джалаладдин Руми
کارغه	Вороны
پلزن	Пльзень
توکمپوهنه	Этнология
مټ	Плечо (часть тела)
زمرد	Изумруд
وحشي پيشو	Лесной кот
شکرخوره	Колибри
فدراسيون	Федеративное государство
شونډکيز چرگ	Индейки
انسلم	Ансельм Кентерберийский
حامد کرزی	Карзай, Хамид
یان هوس	Гус, Ян
کورني آلو	Слива домашняя
اندرس بېرينگ برېويک	Брейвик, Андерс Беринг
شينټاغی	Сизоворонковые
احمد سلمان رشدي	Рушди, Салман
افسانه	Легенда
داریوش ۱	Дарий I
توت	Шелковица
لسبېله ولسوالۍ	Ласбела (округ)
اېنټروپي	Энтропия
ټوبه ټيک سېنگ ولسوالۍ	Тоба-Тек-Сингх (округ)
گجرات ولسوالۍ	Гуджрат (округ)
هرات	Герат (город)
کودتا	Государственный переворот
کندهار	Кандагар
تړمه ييزه پراختیا	Коэффициент теплового расширения
غشی	Стрела
غږتاندی	Микрофон
امجد خان	Хан, Амджад
ابن عربي	Ибн Араби
وری (مياشت)	Фарвардин
اپيم	Опиум
وږی (مياشت)	Шахривар
اوسيريس	Осирис
ازاد بازار	Свободный рынок
اوکاړه ولسوالۍ	Окара (округ)
احمد شاه دراني	Ахмад-шах Дуррани
اسراييل لرغونتون	Музей Израиля
جي اس ام	GSM
غويی (مياشت)	Ордибехешт
زمری (مياشت)	Мордад
غبرگولی (مياشت)	Хордад
اېشواريه رای	Рай, Айшвария
چنگاښ (مياشت)	Тир (месяц)
نوغپوهنه	Генеалогия
مېلټون فرايډمېن	Фридман, Милтон
بانکنوټ	Банкнота
نړيواله جنايي محکمه	Международный уголовный суд
رادار	Радиолокационная станция
د اسلامي همکاريو سازمان	Организация исламского сотрудничества
سياسي وټه	Политическая экономия
د بابل واکمني	Вавилония
جبران خليل جبران	Джебран Халиль Джебран
روبي وېليمز	Уильямс, Робби
د سږو سرطان	Рак лёгкого
مهايانا	Махаяна
امريتسر	Амритсар
اس ـ ۳۰۰	С-300
مير تشيال تمځی	Мир (орбитальный комплекс)
خانيوال ولسوالۍ	Ханевал (округ)
لنډه کيسه	Новелла
د لبنان جگړه ۲۰۰۶	Вторая ливанская война
گرځندويي	Туризм
شاعر	Поэт
بادي توربین	Ветрогенератор
یوسېفینه پرویس	Пройсс, Йозефина
يو گونديز حکومت	Однопартийная система
مصري ژبه	Египетский язык
هارون	Аарон
ایبولا ناروغۍ	Геморрагическая лихорадка Эбола
ژونځمکپوهنه	Биогеография
غونډ	Полк
سور كانگرو	Большой рыжий кенгуру
هارپي	Южноамериканская гарпия
ابسيډين	Обсидиан
وېشنيزه:حکومت	Категория:Правительство
د کيلو کلاس اوبتل	Подводные лодки проекта 877 «Палтус»
سپايس گرلز	Spice Girls
مېزپاسی سولگر	Настольный компьютер
پاراستامول	Парацетамол
عبدالله بن عبدالعزیز آل سعود	Абдалла ибн Абдул-Азиз Аль Сауд
سيد على خامنه‌اى	Али Хаменеи
امام علي رحمانوف	Рахмон, Эмомали
اودو فوګت	Фойгт, Удо
اسلام کريموف	Каримов, Ислам Абдуганиевич
راجا پروېز اشرف	Ашраф, Раджа Первез
گيودو ويسترويلي	Вестервелле, Гидо
پښتو ژبه	Пушту
عرب سمندرگی	Аравийское море
گرمټ	Дрель
دیو جانس کلبی	Диоген
کورنت توغندی	Корнет (ПТРК)
هېرويين	Героин
کوفین	Кофеин
اندروجن	Андрогены
سيمټيکس	Семтекс
راوړنې	Импорт
ببرک کارمل	Кармаль, Бабрак
حفيظ الله امين	Амин, Хафизулла
يوسف عبدالله القرضاوي	Аль-Кардави, Юсуф
تريخی	Жёлчный пузырь
انتوني هوپکينز	Хопкинс, Энтони
مرکزي بانک	Центральный банк
جيپور	Джайпур
سيبري پړانگ	Амурский тигр
القلويد	Алкалоиды
آدم	Адам
ترور	Тётка
یوسيف ۲	Иосиф II
تره	Дядя
ويلهلم لودويگ گايگر	Гейгер, Вильгельм
کریستوف والڅ	Вальц, Кристоф
ډورن بورېس اندرېويچ	Дорн, Борис Андреевич
عبدالاحد مومند	Моманд, Абдул Ахад
وړانگپوهنه	Радиология
اليگارشي	Олигархия
زړه گراف	Электрокардиография
د افغانستان رپی	Флаг Афганистана
ايسيس	Исида
ځوانکې	Акне
اېترنټ	Ethernet
چکوتره	Помело (фрукт)
بشري پوهنې	Гуманитарные науки
ټپوس	Чёрный коршун
نهنگی شارک	Китовая акула
بېنډۍ	Бамия
د سلطان احمد جومات	Голубая мечеть (Стамбул)
اټومي بټۍ	Ядерный реактор
مايکروسافټ اوټلوک	Microsoft Outlook
بنگالي پړانگ	Бенгальский тигр
مالداري	Животноводство
معمولي کپر (کب)	Сазан
اولوموڅ	Оломоуц
مورفين	Морфин
د صرافی ماشین	Банкомат
نخود	Нут (растение)
نوح	Ной
والټ وايټمېن	Уитмен, Уолт
غاښۍ	Вилка (столовый прибор)
چوپسټېک	Палочки для еды
د خوړو او کرهڼې سازمان	Продовольственная и сельскохозяйственная организация ООН
براشوف	Брашов
زنه	Подбородок
قطبي گيدړ	Песец
سياستوال	Политик
شپږڅنډی	Шестиугольник
د افغانستان جگړه (۱۹۷۹-۱۹۸۹)	Афганская война (1979—1989)
ختيځ هند کمپنۍ	Британская Ост-Индская компания
الكساندر نيكولاېويچ رومانوف	Александр II
اسکلېپيوس	Асклепий
ژان اېف کوستو	Кусто, Жак-Ив
وزير (حکومت)	Министр
گرو نانک	Нанак
کانپوهنه	Минералогия
شېنگن تړون	Шенгенское соглашение
سابه خوړونکي	Вегетарианство
امپيدوکلېس	Эмпедокл
اوېستا	Авеста
ستر جنرال	Генерал
شاه جهان	Шах-Джахан
شېر شاه سوري	Шер-шах
خوشحال خان خټک	Хушаль-хан Хаттак
د الله نومونه	99 имён Аллаха
د ساسانيانو واکمني	Государство Сасанидов
هوروس	Хор (мифология)
پولنډبال	Polandball
راټکو مېلادېچ	Младич, Ратко
انځورگري	Рисунок
پرېژه	Развод
باليووډ	Болливуд
اېف – ۱۶	General Dynamics F-16 Fighting Falcon
عبدالله کلا ولسوالۍ	Кила-Абдулла
کلوژ-ناپوکا	Клуж-Напока
مرزا حسين علي بهاالله	Бахаулла
نېغ انسان	Человек прямоходящий
ماهر انسان	Человек умелый
هاډرون	Адрон
سوسن	Ландыш майский
اينو	Айны
تسپود	Воспаление
بايوم	Биом
لروين	Бинокль
گبين مچۍ	Медоносные пчёлы
آوسټرالوپیتهېکوس	Австралопитеки
نړېواله جگړه	Мировая война
روي شنکر	Шанкар, Рави
چندرۍ	Хмель обыкновенный
کرښی	Линейка
قضايي قوه	Судебная власть
ماگنوس کارلسن	Карлсен, Магнус
مرزا اسد الله خان غالب	Галиб, Мирза Асадулла-хан
خاښۍ	Вилы
ايالت	Штат
کندوز	Кундуз (город)
د افغانستان د ښارونو لړليک	Города Афганистана
انجه	Асафетида
مارشال	Маршал
انټيکولينرجيک	Холинолитические средства
مالي کړکېچ	Финансовый кризис
هزاره گان	Хазарейцы
کريم خليلي	Карим Халили
سليكان ډای اکسايډ	Диоксид кремния
کورکورکه	Пятнистая горлица
د وېلسن ناروغي	Болезнь Вильсона — Коновалова
ابن قيم الجوزي	Ибн Каййим аль-Джаузия
د پاني پت جگړه	Битва при Панипате
الكساندر الكساندروويچ رومانوف	Александр III
بلخ ولايت	Балх (провинция)
مشهد	Мешхед
رنځورپالنه	Сестринское дело
پاکپتن ولسوالۍ	Пакпаттан (округ)
ټولنیزه ولسواکي	Социал-демократия
د ستنې طب	Акупунктура
سفارت	Посол
عقيق	Агат
اپلاتون او دولت	Государство (Платон)
ارستوکراسي	Аристократия
زکات	Закят
ميرمشاه	Мираншах
گيورگې ژوکوف	Жуков, Георгий Константинович
د اوبو چينه	Родник
بڼ پالنه	Садоводство
وېليم جېمز	Джемс, Уильям
غوڅندۍ	Пила
سورلنډی	Шакалы
د موسم بدلون	Изменение климата
واټن	Расстояние
کوباني	Айн-эль-Араб
پراگماتيزم	Прагматизм
وړکتون	Детский сад
ابن ميمون	Маймонид
شين یاقوت	Сапфир
پينځڅنډی	Пятиугольник
ټوټالېټر	Тоталитаризм
کوچيان	Кочевники
درملپوهنه	Фармакология
د زیات شوي ارزښت ورکړېنه	Налог на добавленную стоимость
خټنه	Вязкость
لوي سپين شارک	Белая акула
د جمشید پلاز	Персеполь
انتراکس	Сибирская язва
خشايارشا	Ксеркс I
مزار شريف	Мазари-Шариф
مېگ ۲۹	МиГ-29
د ذرو تعجيل کوونکي ماشين	Ускоритель заряженных частиц
ډیمېټروډون	Диметродоны
سپاینوسور	Спинозавр
بېیپیاوساوروس	Бэйпяозавр
خلافت	Халифат
معمولي آلوبالو	Вишня обыкновенная
زغوپرواژی	Пестициды
ډومنيک ډي وېلپين	Вильпен, Доминик де
د قم ولايت	Кум (остан)
گڼرسنۍ	Мультимедиа
کوروند	Корунд
سریښ	Клей
والي	Губернатор
توکمکښنه	Этнография
کرما په هندويزم کې	Карма
آيورويدا	Аюрведа
د جال تړونونه	Протокол передачи данных
جوليوس روبرټ اوپنهايمر	Оппенгеймер, Роберт
باختر	Бактрия
هېروگليف	Египетское иероглифическое письмо
ولاديمير ولاديميروويچ ماياکوفسکي	Маяковский, Владимир Владимирович
د هند پېښليک	История Индии
مستعمره	Колония
ملخوزه	Пажитник сенной
اخوان المسلمون	Братья-мусульмане
تومور	Опухоль
الياس	Илия (пророк)
طاعون	Чума
د سېټريک اسيد څرخ	Цикл трикарбоновых кислот
دهرما	Дхарма
ټاسماني شيطان	Тасманийский дьявол
توپاز	Топаз
۹×۱۹ مرمی	9×19 мм Парабеллум
براخاوخېنیوس	Брахаухениус
آندروختونوس اوسترالیس	Androctonus australis
قادريه	Кадирия
د ايران ولسوالۍ	Шахрестаны Ирана
ابد	Вечность
عبدالعلي مزاري	Абдул Али Мазари
میرمېسیا پیلوسولا	Чёрный муравей-бульдог
زابل ولايت	Забуль
زکريا	Захария (священник)
مسراشمیت مې-۲۶۲	Messerschmitt Me.262
ازاد شعر	Свободный стих
شگموښی	Наждачная бумага
ايليوشين-۷۶	Ил-76
فرایشتات	Фрайштадт
زينب بنت خزيمه	Зайнаб бинт Хузайма
زينب بنت جحش	Зайнаб бинт Джахш
هربرټ سپېنسر	Спенсер, Герберт
زلمی خليلزاد	Халилзад, Залмай
شاه زمان خان	Земан-Шах Дуррани
سارک	Ассоциация регионального сотрудничества Южной Азии
يوسف	Иосиф Прекрасный
د لويديځ سلاوي ژبې	Западнославянские языки
اروپايي صنوبر	Ель обыкновенная
شين صنوبر	Ель голубая
چمبل	Фиалка
پولي ونيل کلورايډ	Поливинилхлорид
نانگه	Смородина красная
قبطيان	Копты
نارنج	Померанец
اناناس	Ананас
کاجول	Каджол
ايگلا	Игла (переносной зенитный ракетный комплекс)
ځنگلي مېږی	Рыжий лесной муравей
مېگ ۳۱	МиГ-31
پښيميسل اوتاکار ۲	Пржемысл Отакар II
رودلف ۲ هابسبورگ	Рудольф II
ميانې	Зуль-када
عبد العزيز بن عبدالرحمن بن فيصل آل سعود	Абдул-Азиз ибн Сауд
دېوالي	Несостоятельность
بوغمه	Отёк
محمد ظاهر شاه	Захир-Шах
ډگر جنرال	Генерал-лейтенант
بريد جنرال	Бригадный генерал
سيف الله کلا ولسوالۍ	Килла-Сайфулла (округ)
البرخت فون والدشتاین	Валленштейн, Альбрехт фон
امير امان الله خان	Аманулла-хан
محمود طرزي	Тарзи, Махмуд-бек
سکندر مرزا	Мирза, Искандер
عمران خان	Хан, Имран
یان لوگزامبورگ	Иоганн Люксембургский
روهتاس	Рохтас
جيارډيا لامبليا	Кишечная лямблия
ميل می ۸	Ми-8
مېسرشمېت بي اف ۱۰۹	Messerschmitt Bf.109
مسراشمیت بي اف ۱۱۰	Messerschmitt Bf.110
یوزي	Uzi
ريچارډ هولبروک	Холбрук, Ричард
ميل می ۲۴	Ми-24
ايساف	Международные силы содействия безопасности
ټې-۷۲	Т-72
یونکرس یو ۸۸	Junkers Ju 88
کارل ۴	Карл IV (император Священной Римской империи)
مېگ ۲۳	МиГ-23
ارهنډه	Клещевина
اېرو ال-۳۹ الباتروس	Aero L-39 Albatros
نېښ لرونکي بوټي	Крапива двудомная
د آلمان ملي دموکراتیک گوند	Национал-демократическая партия Германии
رشقه	Люцерна посевная
لتا منگېشکر	Мангешкар, Лата
سره غوړیانه	Лилия кудреватая
ادميرال پتنگ	Адмирал (бабочка)
فيض آباد (بدخشان)	Файзабад (Афганистан)
ځريځه	Сафлор красильный
د افغانستان اداري وېشنې	Административное деление Афганистана
محمد رفيع	Мохаммед Рафи
تورن جنرال	Генерал-майор
گزک بوټي	Подорожник ланцетолистный
ال – ۴۱۰	Let L-410 Turbolet
ډمپل کپاډيا	Кападия, Димпл
غوماشی	Малярийные комары
د افغانستان ولايتونه	Провинции Афганистана
تاووس پتنگ	Павлиний глаз
جوهي چاولا	Чавла, Джухи
پريانکا چوپړا	Чопра, Приянка
ويديا بالان	Видья Балан
لاکهيډ مارتين آر کيو ۱۷۰ سېنټينل	Lockheed Martin RQ-170 Sentinel
ناصر الدين شاه قاجار	Насреддин-шах
سپما گڼون	Сберегательный вклад
د اس وې ډې دراگونوف ټوپک	Снайперская винтовка Драгунова
یرژي پوديېبراد	Йиржи из Подебрад
وټه	Экономика
د ځمکې گړۍ	Час Земли
رام	Рама
محمد علی جناح	Джинна, Мухаммад Али
وچکۍ تبه (محرقه)	Сыпной тиф
اتره	Туловище
توت خوره	Вьюрковые
شاتوت	Шелковица чёрная
سنځله	Лох (растение)
ښاريتوب	Урбанизация
غونجېدنه (وټپوهنه)	Дефляция (экономика)
خپلپالنه	Непотизм
باور کارټ	Кредитная карта
پامير	Памир
وېلنی	Мята длиннолистная
سيسۍ	Белые куропатки
سرطانپوهنه	Онкология
گلايکوليسېز	Гликолиз
شکودا فابيا	Škoda Fabia
گایوس واليریوس کاتولوس	Гай Валерий Катулл
بلوچستان (پاکستان)	Белуджистан (Пакистан)
غالۍ	Ковёр
موزيکپوهنه	Музыковедение
ليندۍ	Козерог (знак зодиака)
ابسه	Абсцесс
گانډۍ	Улей
کدو	Тыква (плод)
د کرمان ولايت	Керман (остан)
بدخشان ولايت	Бадахшан (провинция)
لیکاڼۍ	Ручка (канцелярия)
اتڅنډی	Восьмиугольник
مچ	Комнатная муха
وړانديز (وټپوهنه)	Закон спроса и предложения
پارلماني حکومت	Парламентаризм
برغټ	Манул
چمپا	Магнолия чампака
نگوس	Стереотип
تېمور شاه دراني	Тимур-Шах Дуррани
نورستان ولايت	Нуристан
محمد قسيم فهيم	Фахим, Мохаммад
ډولومیت	Доломит
جابر بن حیان	Джабир ибн Хайян
بورقه	Паранджа
کرايووا	Крайова
کورکوری	Обыкновенная горлица
روحانيت	Духовность
انافلاکسي	Анафилактический шок
د اسلام انبیاء	Пророк в исламе
لاسپېله	Перчатки
محمد زکريا رازي	Абу Бакр Мухаммад ар-Рази
مېترونيدازول	Метронидазол
گرافېن	Графен
رنځېږن	Патоген
ليکپاکټ	Конверт
کانفدراسيون	Конфедерация
ټي اېن ټي	Тринитротолуол
چېکيان	Чехи
بغلان ولايت	Баглан (провинция)
ابټ آباد	Абботтабад
بدن	Тело (биология)
يزد ولايت	Йезд (остан)
قم	Кум (город)
توماس اېډورډ لارېنس	Лоуренс, Томас Эдвард
بيولوژيکي وسلې	Биологическое оружие
ټېغکه	Сорокопутовые
عباس ۱	Аббас I Великий
باميان ولايت	Бамиан (провинция)
ای اچ ۶۴ آباچی	McDonnell Douglas AH-64 Apache
لمرگلی	Подсолнечник однолетний
د سهېلي خراسان ولايت	Южный Хорасан
پېښه	Авария
کرمان	Керман
احمديت	Ахмадиты
د اگرې کلا	Красный форт (Агра)
د مذهب خپلواكي	Свобода вероисповедания
تيتر	Цесарковые
ځانگړواله	Индивидуализм
بادغيس ولايت	Бадгис
قبة الصخرة جومات	Купол Скалы
اشرف غني احمدزی	Ашраф Гани Ахмадзай
رېبز	Метла
ټوپولف ټو-۱۵۴	Ту-154
نړیواله پېغله	Мисс Мира
آټوکراسي	Автократия
خواړه ساتنه	Консервирование
مارگريت ميتچېل	Митчелл, Маргарет
آرگېنين	Аргинин
سوخوی سو ٢٧	Су-27
ام۱ آبرامس	Абрамс (танк)
غزني	Газни
وختتېری	Развлечение
کندهار ولايت	Кандагар (провинция)
کاپيسا ولايت	Каписа
هلمند ولايت	Гильменд (провинция)
فارياب ولايت	Фарьяб
محراب	Михраб
د الازهر پوهنتون	Университет аль-Азхар
بوتل پزی څوڅ	Афалина
اوسېلوسکوپ	Осциллограф
توحيد	Таухид
بي-٥٢ سټراټوفورټرېس	Boeing B-52 Stratofortress
کوډيين	Кодеин
قبله	Кибла
فتح علي شاه قاجار	Фетх Али-шах
بېديانۍ پيشو	Барханный кот
تانبه:تاریخ	Портал:История
واتسلاف ۱	Вацлав I
اتڼ	Аттан
د اسلام پنځه بنسټونه	Пять столпов ислама
زوی	Сын
سکاره	Древесный уголь
شنقار	Кречет
د ژونکې تيوري	Клеточная теория
فولېرېن	Фуллерен
نېکروسېز	Некроз
د واشنگټن څلی	Монумент Вашингтона
آنتونوف-۲۲۵	Ан-225
وييپوهنه	Лексикология
ننگرهار ولايت	Нангархар
درونکښ	Грузоподъёмный кран
روژه	Ураза
کاني اوبه	Минеральная вода
نولۍ	Фретка
لگښت ساتنې تگلاره	Протекционизм
آنتیستنس	Антисфен
مرکزي حکومت	Унитарное государство
د پاکستان په شمال لویدیځ کې جگړه	Хронология конфликта в Вазиристане
اسماني کتابونه او صحيفې	Священные тексты
ژبساپوهنه	Психолингвистика
اوبزمکپوهنه	Гидрогеология
د مزلو د اړتیاوو د مرتبو سلسله	Пирамида потребностей по Маслоу
د بازار وټه	Рыночная экономика
اپیکوریزم	Эпикуреизм
اورمازده	Ахура Мазда
درملنه	Терапия (лечение)
اريايان	Арии
يعقوب کندي	Аль-Кинди
گورجېس	Горгий
سياسي فلسفه	Политическая философия
جوهر دوداییف	Дудаев, Джохар Мусаевич
ايوب	Иов
د افغانستان ولسي لاره	Гимн Афганистана
ستورمزلي	Освоение космоса
اېکونومېسټ	The Economist
تورگوت اوزال	Озал, Тургут
نورتورپ گرومان بي ۲ سپېريټ	Northrop B-2 Spirit
لمريز لېږديز کليز	Иранский календарь
فراه ولايت	Фарах (провинция)
غزني ولايت	Газни (провинция)
راشدين خليفه گان	Праведный халиф
وړانگدرملنه	Радиотерапия
کوټه	Комната
شاپ	Суппозитории
پوهنځی	Факультет
نکوټي يانا ټیبېکم	Табак обыкновенный
بلوچستان	Белуджистан
سيد حسن نصرالله	Насралла, Хасан
دايکندي ولايت	Дайкунди
پنجشېر ولايت	Панджшер (провинция)
زړه نابری	Сердечная недостаточность
ټوپولف ټو-۹۵	Ту-95
د جانسي راني	Лакшми-бай
بلخ	Балх (город)
امونيم نايټرېټ	Нитрат аммония
آسيايي زمري	Азиатский лев
کامبوجيه ۲	Камбис II
سرپل ولايت	Сари-Пуль (провинция)
پکتيا ولايت	Пактия
خوارزم	Хорезм
بهرونه	Экспорт
ايټا جېمز	Этта Джеймс
كنسرټ	Концерт
هرات ولايت	Герат (провинция)
سمنگان ولايت	Саманган
نيمروز ولايت	Нимроз
روزگان ولايت	Урузган
جوزجان ولايت	Джаузджан
ميدان وردگ ولايت	Вардак
کورکوړۍ	Щурковые
شننيزه فلسفه	Аналитическая философия
سېموېل کولټ	Кольт, Сэмюэл
جلالکوټ	Джелалабад
خيبر پښتونخوا	Хайбер-Пахтунхва
سينوسايټس	Синусит
موکشا	Мокша (философия)
اسماعيل	Измаил (в Библии)
نسخوږی	Боли в области живота и таза
زينت امان	Аман, Зинат
لسڅنډی	Десятиугольник
چينايي فلسفه	Китайская философия
بوينگ بي ۲۹	Boeing B-29 Superfortress
کرينه کپور	Капур, Карина
بوينگ بي ۱۷ فلاينگ فورټرېس	Boeing B-17 Flying Fortress
اسيډوسېز	Ацидоз
واسلين	Вазелин
اوبي ژرنده	Водяная мельница
فلېپيني عقاب	Филиппинский орёл
لغمان ولايت	Лагман (провинция)
پيېرې لويېس ناپولېيون کيوانارې	Каваньяри, Пьер Луи Наполеон
مولتان	Мултан
کوټه (ښار)	Кветта
پکتيکا ولايت	Пактика
خوست ولايت	Хост (провинция)
کيفيت	Качество продукции
جلال الدين حقاني	Хаккани, Джалалуддин
د لوی اختر مياشت	Зуль-хиджа
بريدمن	Лейтенант
علي اکبر هاشمي رفسنجاني	Хашеми Рафсанджани, Али Акбар
ايمن الظواهري	Айман аз-Завахири
رنځورپاله	Медицинская сестра
غور ولايت	Гор (провинция, Афганистан)
تخار ولايت	Тахар
کندوز ولايت	Кундуз (провинция)
د پاکستان د خلکو گوند	Пакистанская народная партия
د اتریش د خلک ګوند	Австрийская народная партия
ايبوپروفېن	Ибупрофен
کارسک گيدړ	Корсак
ابهيشېک بچچن	Баччан, Абхишек
سالنډي	Одышка
کونړ ولايت	Кунар
پروان ولايت	Парван
آيت	Аят
قول اردو	Корпус (военное дело)
ايمفيسېما	Эмфизема лёгких
احمد ياسين	Ясин, Ахмед
برهان الدين رباني	Раббани, Бурхануддин
پريټي زېنتا	Зинта, Прити
صحابه	Сахаба
سمایلوډون	Смилодоны
مېرمن	Жена
د افغانستان پېښليک	История Афганистана
کابل ولايت	Кабул (провинция)
ټېډ	TED (конференция)
آندری کاراطايف	Коротаев, Андрей Витальевич
سلطان محمود غزنوي	Махмуд Газневи
د زړه ارېتميا	Аритмия
پینټریټ	Пентаэритриттетранитрат
اسلامي هنر	Исламское искусство
اسلامپالنه	Исламизм
پوښتنه	Вопрос
هیکسوجن	Гексоген
ميناتو	Минато
وزيرستان	Вазиристан
اوښلن لوگی	Слезоточивый газ
کوستا کونکورديا	Costa Concordia
د زړه ناروغۍ	Заболевания сердца
ابو حنيفه (امام اعظم)	Абу Ханифа
مرکاوا شوبله	Меркава
جوهر	Сущность
ټوپولف ټو-۱۶۰	Ту-160
شيطاني آيات	Сатанинские стихи
خيبر دره	Хайберский проход
شاپور ۱	Шапур I
سيلدينافيل	Силденафил
تکبیر	Такбир
مالي کال	Финансовый год
سوخوی سو-۲۵	Су-25
پرولاکټين	Пролактин
ټانگتوره	Дурман
تیسفون	Ктесифон
ډېلي ټيليگراف	The Daily Telegraph
سټرېپټومايسين	Стрептомицин
هندي څمڅه منگور	Очковая змея
ټې-۹۰	Т-90
نادر شاه افشار	Надир-шах
د بوټي هورمون	Фитогормоны
مقطعات	Мукатта
ټېټراسايکلين	Тетрациклин
اسلامي فلسفه	Исламская философия
سبسيډي	Субсидия
د پراگ کلا	Пражский Град
آنتونوف-۱۲۴	Ан-124
هود	Худ (пророк)
خړانکه	Коньки (птицы)
ملا محمد عمر	Мухаммед Омар
فريد الدين عطار	Аттар
د خدای پاک مياشت	Раджаб
کړنی سېک	Потенциал действия
امام احمد بن حنبل	Ахмад ибн Ханбаль
سوخوی پک فا	Перспективный авиационный комплекс фронтовой авиации
ابو الکلام آزاد	Азад, Абул Калам
شاهرخ افشار	Шахрох-шах
ام کيو-۱ پرېډاټور	MQ-1 Predator
کوږوږ	Зигзаг
زيډووډين	Зидовудин
محمد يونس خالص	Халес, Юнус
بديع الزمان سعيد نورسي	Саид Нурси
گلروزنه	Цветоводство
افغانۍ	Афгани
مېگ ۲۵	МиГ-25
د سږو اوندنه خنډيزه ناروغي	Хроническая обструктивная болезнь лёгких
احمد شاه مسعود	Ахмад Шах Масуд
داسو میراژ- ۲۰۰۰	Dassault Mirage 2000
آزاد کشمير	Азад Кашмир
اوبسپی	Выдровые
چينايي دوديزه درملگري	Традиционная китайская медицина
گېلگېت بالتستان	Гилгит-Балтистан
بلوڅان	Белуджи
ټراک	Садовая славка
کېټ وېنسلېټ	Уинслет, Кейт
نيوموتوراکس	Пневмоторакс
اورو لانکاسټر	Avro Lancaster
لرغونې فلسفه	Античная философия
زين العابدين بن علي	Зин эль-Абидин Бен Али
غرزي	Гильзаи
يوني ماشين	Ионный двигатель
نېټه	Календарная дата
ایزو ۹۰۰۰	ISO 9000
اليسع	Елисей
معمولي څوڅ	Дельфин-белобочка
ترچ مير	Тиричмир
مطبوعاتي اعلاميه	Пресс-релиз
محمد نجيب الله	Наджибулла, Мохаммад
قونسلگري	Консул (дипломат)
غوز	Грецкий орех (плод)
زنځيري غوڅندۍ	Цепная пила
فدرالي قبايلي سيمې	Федерально управляемые племенные территории
گونگه ښارو	Свиристели
د مذهب فلسفه	Философия религии
ډايازيپم	Диазепам
سوخوی سو-۲۴	Су-24
کورټيکوسټېرويډ	Кортикостероиды
غوږور ښاپېرک	Бурый ушан
چندړ	Сантал белый
سيد قطب	Кутб, Сайид
بوکو حرام	Боко харам
السلام عليکم	Ас-саляму алейкум
خسرو پرويز	Хосров II Парвиз
اېنډوسکوپي	Эндоскопия
مېړه	Муж
طبله	Табла
غونډل	Пауки-птицееды
گندهارا	Гандхара
کوډېکس	Кодекс (книга)
يان ژيژکا	Жижка, Ян
يوم	Заступ
ستره لوبه	Большая игра
مقتدی الصدر	Муктада ас-Садр
چت	Пол (настил)
يزيد بن معاويه	Язид I ибн Муавия
آلانين	Аланин
ښکلي هنرونه	Изящные искусства
افدرين	Эфедрин
ای اچ ۱ کبرا	Bell AH-1 Cobra
سورة الفاتحة	Сура Аль-Фатиха
سورة البقرة	Сура Аль-Бакара
سورة آل عمران	Сура Аль Имран
سورة النساء	Сура Ан-Ниса
سورة المائدة	Сура Аль-Маида
سورة الأنعام	Сура Аль-Анам
سورة الأعراف	Сура Аль-Араф
سورة الأنفال	Сура Аль-Анфаль
سورة التوبة	Сура Ат-Тауба
سورة يونس	Сура Йунус
سورة هود	Сура Худ
سورة يوسف	Сура Йусуф
سورة الرعد	Сура Ар-Раад
سورة إبراهيم	Сура Ибрахим
سورة الحجر	Сура Аль-Хиджр
جنگسالار	Полевой командир
سورة النحل	Сура Ан-Нахль
د سږو امبولي	Тромбоэмболия лёгочной артерии
ښي لاسی او کيڼ لاسی ترافيک	Левостороннее и правостороннее движение
سورة الاسراء	Сура Аль-Исра
سورة الكهف	Сура Аль-Кахф
سورة مريم	Сура Марйам
سورة طه	Сура Та Ха
سورة الأنبياء	Сура Аль-Анбийа
سورة الحج	Сура Аль-Хаджж
سورة المؤمنون	Сура Аль-Муминун
سورة النور	Сура Ан-Нур
برات	Шаабан
سورة الفرقان	Сура Аль-Фуркан
سورة الشعراء	Сура Аш-Шуара
سورة النمل	Сура Ан-Намль
سورة القصص	Сура Аль-Касас
سورة العنکبوت	Сура Аль-Анкабут
سورة الروم	Сура Ар-Рум
De Havilland Mosquito	De Havilland Mosquito
کيشپ	Черепахи
شکودا اوکټاويا	Škoda Octavia
سټېنگر FIM-92	FIM-92 Stinger
سورة لقمان	Сура Лукман
دماغي مړينه	Смерть мозга
مخ (چاپي رسنۍ)	Пейдж
د وټيزو همکاريو سازمان	Организация экономического сотрудничества
هېوادپال	Patriot
شوننېزم	Шовинизм
امريکا غږ	Голос Америки
درې بعدي چاپگر	3D-принтер
سورة السجدة	Сура Ас-Саджда
سورة الاحزاب	Сура Аль-Ахзаб
سورة سبأ	Сура Саба
سورة فاطر	Сура Фатыр
سورة يس	Сура Йа Син
مامولکه	Трясогузки
سورة الصافات	Сура Ас-Саффат
سورة ص	Сура Сад
سورة الزمر	Сура Аз-Зумар
سورة غافر	Сура Гафир
حسن البنا	Аль-Банна, Хасан
سورة فصلت	Сура Фуссилат
سورة الشورى	Сура Аш-Шура
سورة الزخرف	Сура Аз-Зухруф
سورة الدخان	Сура Ад-Духан
سورة الجاثية	Сура Аль-Джасийа
سورة الأحقاف	Сура Аль-Ахкаф
سورة محمد	Сура Мухаммад
سورة الفتح	Сура Аль-Фатх
سورة الحجرات	Сура Аль-Худжурат
سورة ق	Сура Каф
سورة الذاريات	Сура Аз-Зарийат
ډېل کارنېگي	Карнеги, Дейл
سورة الطور	Сура Ат-Тур
سورة النجم	Сура Ан-Наджм
روح الله نېکپا	Никпай, Рохулла
سورة القمر	Сура Аль-Камар
سورة الرحمن	Сура Ар-Рахман
سورة الواقعة	Сура Аль-Вакиа
گڼون	Счёт
سورة الحديد	Сура Аль-Хадид
سورة المجادلة	Сура Аль-Муджадила
سورة الحشر	Сура Аль-Хашр
سورة الممتحنة	Сура Аль-Мумтахана
سورة الجمعة	Сура Аль-Джумуа
سورة المنافقون	Сура Аль-Мунафикун
سورة التغابن	Сура Ат-Тагабун
سورة الطلاق	Сура Ат-Талак
سورة القلم	Сура Аль-Калам
سورة المعارج	Сура Аль-Мааридж
مېتی	Кайло
مادهوري ډکشټ	Дикшит, Мадхури
سورة نوح	Сура Нух
سورة الجن	Сура Аль-Джинн
سورة المزمل	Сура Аль-Муззаммиль
جامنو	Джамболан
سورة المدثر	Сура Аль-Муддассир
سورة القيامة	Сура Аль-Кийама
سورة الإنسان	Сура Аль-Инсан
سورة المرسلات	Сура Аль-Мурсалат
سورة النبأ	Сура Ан-Наба
سورة النازعات	Сура Ан-Назиат
سورة عبس	Сура Абаса
سورة التكوير	Сура Ат-Таквир
سورة الانفطار	Сура Аль-Инфитар
سورة المطففين	Сура Аль-Мутаффифин
سورة الانشقاق	Сура Аль-Иншикак
سورة البروج	Сура Аль-Бурудж
سورة الطارق	Сура Ат-Тарик
سورة الأعلى	Сура Аль-Аля
سورة الغاشية	Сура Аль-Гашийа
سورة الفجر	Сура Аль-Фаджр
سورة البلد	Сура Аль-Балад
سورة الشمس	Сура Аш-Шамс
سورة الليل	Сура Аль-Лайл
سورة الضحى	Сура Ад-Духа
سورة الشرح	Сура Аш-Шарх
د ماغزو تومور	Опухоль головного мозга
سورة التين	Сура Ат-Тин
د افغان-انگرېز دويمه جگړه	Вторая англо-афганская война
سورة العلق	Сура Аль-Алак
سورة القدر	Сура Аль-Кадр
سورة البينة	Сура Аль-Баййина
سورة الزلزلة	Сура Аз-Залзала
سورة العاديات	Сура Аль-Адийат
سار	Курганник
سورة القارعة	Сура Аль-Кариа
سورة التکاثر	Сура Ат-Такасур
سورة العصر	Сура Аль-Аср
سورة الهمزة	Сура Аль-Хумаза
اکشې کمار	Акшай Кумар
سورة الفيل	Сура Аль-Филь
سورة قريش	Сура Курейш
سورة الماعون	Сура Аль-Маун
سورة الکوثر	Сура Аль-Каусар
سورة الکافرون	Сура Аль-Кафирун
سورة النصر	Сура Ан-Наср
مکه معظمه	Мекка (провинция)
سورة المسد	Сура Аль-Масад
سورة الإخلاص	Сура Аль-Ихлас
سورة الفلق	Сура Аль-Фалак
سپين توت	Моринда цитрусолистная
سورة الناس	Сура Ан-Нас
سورت	Сура (Коран)
د هند کمونیست گوند (مارکسیست)	Коммунистическая партия Индии (марксистская)
مکي سورتونه	Мекканская сура
مدني سورتونه	Мединская сура
حديث	Хадис
شاپور ۲	Шапур II
حج	Хадж
رسول	Расуль
سورة الصف	Сура Ас-Сафф
سورة التحريم	Сура Ат-Тахрим
ټې-۸۰	Т-80
ان هيداوې	Хатауэй, Энн (жена Шекспира)
امام بخاري	Мухаммад аль-Бухари
ميل مي - ۲۸	Ми-28
ديکلوفيناک	Диклофенак
سوخوی سو ۳۵	Су-35
پيچکاري	Инъекция
د غزنويانو ټولواکمني	Газневидское государство
څلوريزه	Рубаи
اواران ولسوالۍ	Аваран (округ)
بارخان ولسوالۍ	Бархан (округ)
ابن طفيل	Ибн Туфайль
فيفا	ФИФА
سوشميتا سېن	Сен, Сушмита
ليلا علي	Али, Лейла
رابعه بصري	Рабиа аль-Адавия
بېنزيل پېنيسيلين	Бензатина бензилпенициллин
ريشي کپور	Капур, Риши
۳۹×۷،۶۲ مرمی	7,62×39 мм
د گندمک تړون	Гандамакский договор
ږدن	Пшено
ماريه قبطيه	Мария аль-Кибтия
حفصه بنت عمر بن خطاب	Хафса бинт Умар
اميشا پټېل	Патель, Амиша
صفيه بنت حيي بن اخطب	Сафия бинт Хуяй
حاد مايلوييد ليوکېمي	Острый миелоидный лейкоз
حاد کرونري ساينډروم	Острый коронарный синдром
د کارلشتین کلا	Карлштейн
بلنځه	Саксаул
اروپايي اوښاره	Обыкновенный богомол
امير محمد افضل خان	Мухаммед Афзаль-хан
پلسيوسور	Плезиозавры
کاموف کا ٥٠	Ка-50
گڼ پوهيال	Универсальный человек
شري دېوي	Шридеви
د سپاه پاسداران انقلاب اسلامی ځواک	Стражи Исламской революции
آنتونوف-۱۲	Ан-12
نوشاخ	Ношак
خبري غونډه	Пресс-конференция
ايليوشين-۹۶	Ил-96
خټگري	Каменная кладка
بسم الله الرحمن الرحيم	Басмала
دويمه خور	Раби ас-сани
کلورامفينيکول	Хлорамфеникол
انټر سرويس انټېلېجنس (ISI)	Межведомственная разведка
د چېک پوځ	Армия Чешской Республики
کيچ ولسوالۍ	Кеч (округ)
چاغي ولسوالۍ	Чагай (округ)
اېسټروجن	Эстрогены
ټاټرا کا ټي – ۸	Tatra KT8D5
HACCP	HACCP
مچواژی	Мухобойка
کوف آب ولسوالۍ	Куф-Аб (Район)
غزل	Газель (строфа)
سوابۍ ولسوالۍ	Сваби (округ)
شهاب الدين سهروردي	Шихабуддин Яхья Сухраварди
مېگانېورا	Меганевра
محمد اسماعيل خان	Исмаил-хан
دېره اسماعيل خان ولسوالۍ	Дера-Исмаил-Хан (округ)
د پاکستان د انصاف غورځنگ	Техрик-е-Инсаф
عبدالله بن عمر البيضاوي	Абдуллах аль-Байдави
شهنواز تڼی	Танай, Шахнаваз
د ډيورنډ کرښه	Линия Дюранда
يعقوب	Иаков
لارا دتا	Датта, Лара
الجاحظ	Аль-Джахиз
امام شافعي	Мухаммад аш-Шафии
سيد جمال الدين افغاني	Джамалуддин аль-Афгани
خرېزانتېما توغندی	Хризантема (ПТРК)
نصرت فتح علي خان	Нусрат Фатех Али Хан
نور محمد ترکی	Нур Мохаммад Тараки
عافيه صديقي	Сиддики, Аафия
سادات	Сеид
د راديوايزوټوپونو ترموبريښنایی جنريټر	Радиоизотопный термоэлектрический генератор
آلانين ټرانس امينېز	Аланинаминотрансфераза
ايبټ اباد ولسوالۍ	Абботтабад (округ)
ختيځي مچۍ	Китайская восковая пчела
ختيځه فلسفه	Восточная философия
اروپایی زرغون څرموښکۍ	Зелёная ящерица
عبدالقادر گيلاني	Абдул-Кадир аль-Джилани
عبدالله عزام	Абдулла Аззам
لور	Дочь
عبدالکريم سروش	Соруш, Абдолкарим
ميمنه ولسوالۍ	Меймене
الشباب	Харакат аш-Шабаб
سردار محمد داود خان	Мухаммед Дауд
ماخۍ	Верблюжья колючка
عبدالقدير خان	Абдул Кадыр Хан
سلطان قطب الدين ايبک	Кутб ад-дин Айбак
بيټالکټمېز	Бета-лактамазы
د قدس ځواک	Кодс
پلازموډيم فالسيپارم	Plasmodium falciparum
امام مالک بن انس	Малик ибн Анас
نورالدين عبدالرحمن جامي هروي	Джами
عمران خان (لوبگر)	Хан, Имран (актёр)
رودکي	Рудаки
خان عبدالغفار خان	Абдул Гаффар-хан
غزی	Ходулочники
عبدالرحمان مومند	Абдуррахман Моманд
عبدالرشيد غازي	Гази, Абдул Рашид
شريفي عبدالظاهر	Абду-л-Захир
عبدالله عبدالله	Абдулла, Абдулла
عبدالله يکتا	Яфтали, Абдулла
جرمېن جېکسن	Джексон, Джермейн
ابن حزم اندلسي	Ибн Хазм
والېري ولاديميروويچ پولياکوف	Поляков, Валерий Владимирович
گلبدين حکمتيار	Хекматияр, Гульбеддин
احمد شاه قاجار	Султан Ахмад-шах
مېلبورن پوهنتون	Мельбурнский университет
داسو میراژ اف‌۱	Dassault Mirage F1
دېو انند	Ананд, Дев
آر پي جي-۷	РПГ-7
آغا محمد خان قاجار	Ага Мохаммед Шах Каджар
صالح	Салих
گڼونکی	Бухгалтер
د ۲ کا ۱۲ کوب راکټی سیستم	Куб (зенитный ракетный комплекс)
کنکه لېږندويه انسېفلايټس	Клещевой энцефалит
د افغانستان جگړه (۲۰۰۱)	Операция «Несокрушимая свобода»
اس-۲۰۰	С-200
ويي جوړښت	Словообразование (раздел лингвистики)
تايروکسين	Трийодтиронин
ادريس	Идрис
د سولې نړيواله ورځ	Международный день мира
روماتولوجي	Ревматология
ناصر خسرو	Насир Хосров
شپې ليد سترگۍ	Прибор ночного видения
د بهرنيو اړيکو او څارگرۍ اداره	Управление по внешним связям и информации
پادشاهی جومات	Мечеть Бадшахи
عبدالرشيد دوستم	Дустум, Абдул-Рашид
ذوالکفل	Зуль-Кифль
کريم خان زند	Карим-хан
رنجيت سېنگ	Сингх, Ранджит
فخر الدين رازي	Фахруддин ар-Рази
اپورتونېزم	Оппортунизм
شمي کپور	Капур, Шамми
امير حبيب الله خان	Хабибулла-хан
کمال الدين بهزاد	Кемаледдин Бехзад
بيت الله محسود	Мехсуд, Байтулла
ابوبکر	Абу Бакр
ابو مسلم خراساني	Абу Муслим
جيورج ايډېن	Иден, Джордж
سلطان علاوالدين غلجی	Ала ад-дин Мухаммад-шах
کاشي	Глазурь
تفسير	Тафсир
گوگل	Средостение
راجپوت	Раджпуты
آیت الله سيستاني	Али Систани
صليبي غڼه	Обыкновенный крестовик
ناوې	Невеста
چورليځ	Axis (значения)
محمد علي شاه قاجار	Мохаммад Али-шах
فرانسېس يسېدرو اېجورت	Эджуорт, Фрэнсис Исидор
محمد نادر شاه	Мухаммед Надир-шах
آنتونوف-۱۴۰	Ан-140
سلمان ابن عبدالعزیز آل سعود	Салман ибн Абдул-Азиз Аль Сауд
پټه لرونکی ژگاگ	Полосатый скунс
سليووويټز	Сливовица
ابو الاعلى مودودي	Маудуди, Абуль-Ала
عروض	Аруз
اردشیر پاپاکان	Ардашир Папакан
هېماټويوريا	Гематурия
د سوریانو ټولواکمني	Суриды
جده	Джидда
د چين نړيواله راډيو	Международное радио Китая
الېکسانډر برنېس	Бёрнс, Александр
هندي فلسفه	Индийская философия
دليپ کمار	Дилип Кумар
د ايران هوايي ځواک	Военно-воздушные силы Исламской Республики Иран
دهرمندر	Дхармендра
ملا دادالله اخوند	Дадулла
لوييس سلوتين	Злотин, Луис Александер
شاهد اپریدی	Африди, Шахид
صبغت الله مجددي	Моджаддеди, Себгатулла
آر کیو - ۱۱ ړاوېن	RQ-11 Raven
ال-۱۵۹ الکا	Aero L-159 ALCA
ابراهيم لودي	Ибрахим-шах Лоди
ولاديمير الېکساندروويچ کريوچکوف	Крючков, Владимир Александрович
لمن لگښت	Предельные издержки
د افغانستان د فوټبال فدراسيون	Футбольная федерация Афганистана
کارلوی واری	Карловы Вары
اپريدي	Афридии
خاد	ХАД
اهل بيت	Ахль аль-Байт
خوست	Хост (Афганистан)
سوات ولسوالۍ	Сват (Пакистан)
د هخامنشیانو ټولواکمني	Держава Ахеменидов
لوکوموټيف ۳۸۰	Электровоз 380
شکودا ټي – ۱۵	Škoda 15T
شکودا ۹ ټې اړ	Škoda 9Tr
شکودا سوپرب	Škoda Superb
شاه ولي الله	Шах Валиуллах ад-Дехляви
سايکلوفوسفمايډ	Циклофосфамид
ایندومټاسین	Индометацин
هېکزامېتيلين ټرايپرآکسيډايامين	Гексаметилентрипероксиддиамин
سورلان	Волкодав
سپېرکۍ	Ажгон
ټي اېي ټي بي	Триаминотринитробензол
اېنالاپريل	Эналаприл
سپيرونولکټون	Спиронолактон
مېبېندازول	Мебендазол
امپرېناوير	Ампренавир
هېموسېدرين	Гемосидерин
اوکټوجن	Октоген
اوميپرازول	Омепразол
بودېسونايد	Будесонид
فېنواکسيمېتيل پېنيسيلين	Феноксиметилпенициллин
ديجوکسين	Дигоксин
ډاپسون	Дапсон
ډيلټيازيم	Дилтиазем
مېټوټرکسات	Метотрексат
دوكسيسايكلين	Доксициклин
جنټامايسين	Гентамицин
لاميووډين	Ламивудин
رانيتيدين	Ранитидин
وانکومايسين	Ванкомицин
سالمېټېرول	Сальметерол
الاقصی جومات	Мечеть аль-Акса
د افغانستان اسلامي امارت	Исламский Эмират Афганистан
مسجد الحرام	Мечеть аль-Харам
الخالد شوبله	MBT 2000
منبر	Минбар
ولادېمير افاناسېويچ لياخوف	Ляхов, Владимир Афанасьевич
اسلامي بانکوالی	Исламский банкинг
شاه شجاع	Шуджа-Шах Дуррани
سوخوی سو ٣٧	Су-37
کرېشما کپور	Капур, Каризма
ملکه رضيه	Разия-султан
رېکها	Рекха
شرميلا تاگور	Тагор, Шармила
حميرا بېگم	Хумайра Бегум
ريحانه بنت زيد قرظي	Райхана бинт Зейд
مينا کماري	Мина Кумари
وحيده رحمان	Рехман, Вахида
شبانه اعظمي	Азми, Шабана
مينا کشور کمال	Мина Кешвар Камаль
ديا مرزا	Мирза, Дия
آلماني چابکۍ	Рыжий таракан
لخدر ابراهيمي	Брахими, Лахдар
فرېدرېک بارټ	Барт, Фредрик
غياث الدين کيخسرو بن کيقباد	Кей-Хосров II
هنري کوربان	Корбен, Анри
مظفر الدين شاه قاجار	Мозафереддин-шах Каджар
د درانيانو ټولواکمني	Дурранийская империя
گردېز	Гардез
ملټيپل ميولوما	Миеломная болезнь
بوينگ بي ۴۷ سټراټوجېټ	Boeing B-47 Stratojet
اسکاريس لومبريکويډېس	Человеческая аскарида
رابعه بلخي	Робиаи Балхи
ابن زهر	Ибн Зухр
امير عنايت الله خان	Инаятулла-хан
ويليم مونټگمري وات	Уотт, Монтгомери
حبيب الله کلکاني	Хабибулла бачаи-и сакао
لومړۍ خور	Раби аль-авваль
لښکرگاه	Лашкаргах
تالقان	Талукан
دوشکا (د الوتکو ويشتونکي ماشيندار)	ДШК
بيشاپور	Бишапур
ابن مسكويه	Ибн Мискавейх
شريعت	Шариат
اوزبکان	Узбеки
ازمېښتون	Лаборатория
جيروسكوپ	Гироскоп
تاجکيان	Таджики
سني اسلام	Сунниты
آزربايجاني منات	Азербайджанский манат
بې پيلوټه الوتکه	Беспилотный летательный аппарат
محمد اقبال	Икбал, Мухаммад
فقه	Фикх
چنگېز ايتمانوف	Айтматов, Чингиз Торекулович
مۍ	Маш
د باميانو بودايي پژۍ	Бамианские статуи Будды
تورکمنان	Туркмены
نړیوال سازمان	Международная организация
د ژبې فلسفه	Философия языка
شانگهای د همکاريو سازمان	Шанхайская организация сотрудничества
کلبيان	Киники
د آزادۍ راډيو	Радио «Свобода»
اورنگزیب عالمگیر	Аурангзеб
راني موکېرجي	Мукерджи, Рани
مسجد نبوي	Масджид ан-Набави
اسلاموفوبيا	Исламофобия
ازبکستاني سوم	Узбекский сум
صفره	Сафар
ابن تيميه	Ибн Таймия
د سجیل توغندی	Саджил (ракета)
د نور توغندۍ	Noor (ПКР)
افغان پاسپورټ	Паспорт гражданина Афганистана
ماتريديه	Матуридизм
مېټامتريال	Метаматериал
الوتکه (فلم)	Аэроплан!
توبه	Раскаяние
ختيځي کيکه	Блоха крысиная южная
د شاه فیصل جومات	Мечеть Фейсал
د اوبو ښاپېرک	Водяная ночница
نېفروټېک ساينډروم	Нефротический синдром
ادريس شاه	Идрис Шах
انځور خبريالي	Фотожурналистика
د افغانستان د لارښودانو لړليک	Список монархов Афганистана
تومانچه مادل ۵۲	Cz52
هريپور (پاکستان)	Харипур (город, Пакистан)
د الماني ژبې گرامر	Грамматика немецкого языка
ISO 22000	ISO 22000
صلی الله عليه وسلم	Салават (гоноратив)
اشاعره	Ашариты
ټريپانوسوما	Трипаносомы
عبدالرب رسول سياف	Сайяф, Абдул Расул
د ميوند جگړه	Битва при Майванде
ماشین گڼ ماډل ۵۹	UK vz. 59
پېښور ولسوالۍ	Пешавар (округ)
څاڅکي	Глазные капли
خواجه عبدالله انصاري	Абдуллах аль-Ансари
پريتويراج چوهان	Притхвирадж III
سمېع يوسف	Юсуф, Сами
محمد شاه قاجار	Мохаммед-шах Каджар
ميرويس هوتک	Мир Вайс
محمد عالم خان	Сейид Алим-хан
شاه اشرف هوتک	Ашраф-шах
ډانگ لکۍ	Райская мухоловка
پروټينيوريا	Протеинурия
بوللـه	Касыда
پښتو ابېڅي	Алфавит пушту
رضوي خراسان ولايت	Хорасан-Резави
بفر سټېټ	Буферное государство
کونډه	Карабин (устройство)
تومانچه مادل ٧٥	CZ 75
سکن ایگل	Scan Eagle
جعفر اباد ولسوالۍ	Джафарабад (округ)
څارنوال	Прокурор
ټرانس امينېشن	Трансаминирование
گلومېرولونېفرايټس	Гломерулонефрит
د پاني پت لومړۍ جگړه	Битва при Панипате (1526)
بوکان	Букан
آنتونوف-۱۴۸	Ан-148
کلات ولسوالۍ (بلوچستان)	Калат (округ)
ابهيدا	Абхидхарма
امير ډنډ	Банде-Амир
امير محمد يعقوب خان	Мухаммед Якуб-хан
ټوپولف ټو-۳۳۴	Ту-334
ډئيزم	Деизм
دگماتېزم	Догмат
گلسر	Корольковый вьюрок
اوبدرملنه	Водолечение
برېښنامېچ	Счётчик электрической энергии
ښځه په اسلام کې	Женщина в исламе
ملي گټې	Национальные интересы
د هوتکيانو ټولواکمني	Хотаки
جان گرين	Грин, Джон
عبدالحق	Хак, Абдул (моджахед)
سامويل الېکسانډر کينير وېلسن	Вильсон, Сэмюель
اسلامي تاريخ	История ислама
امام جومات	Мечеть Имама
کتيتر	Катетер
آريانا افغان هوايي شرکت	Ariana Afghan Airlines
د چېک د جمهوریت هوایي ځواک	Воздушные силы Чехии
سوداگري (فلم)	Рабство (фильм)
معتزله	Мутазилиты
شهاب ۳	Шахаб-3
اسحاق	Исаак
بانکي گڼون	Банковский счёт
د کوچني اختر مياشت	Шавваль
اسد آباد	Асадабад
ټاټرا ۱۴۸	Tatra 148
زو – ۲۳ – ۲	ЗУ-23
ټاټرا ۸۱۵	Tatra T815
اېف ۱ لاسي بم	Ф-1 (граната)
ارسلا رحماني	Рахмани, Арсала
ټاټرا ۸۱۳	Tatra 813
د اسيايي هېوادونو لړليک	Список государств и зависимых территорий Азии
د افغانستان ملي لرغونتون	Кабульский музей
د اشراق فلسفه	Ишракизм
اسد الله سروري	Сарвари, Асадулла
عينک د تامبې کان	Мес Айнак
درملپېژندنه	Фармакодинамика
ريگويدا	Ригведа
کوهستان ولسوالۍ (پښتونخوا)	Кохистан (округ)
شاه محمود سدوزى	Махмуд-Шах Дуррани
محمد حسن شرق	Шарк, Мухаммед Хасан
سلېمان لايق	Лаек, Сулейман
طيبه لښکر	Лашкаре-Тайба
سيد محمد حسين طباطبايي	Табатабаи, Мухаммад Хусейн
نورستانيان	Нуристанцы
لاله سری	Турумти
چنجری	Турачи (род птиц)
محمد نور احمد اعتمادي	Эттемади, Нур Ахмад
د غشی زهر آبي چونگښه	Голубой древолаз
جي اېف ۱۷ تهنډر	Chengdu FC-1 Xiaolong
حامد کرزی نړيوال هوايي ډگر	Кабул (аэропорт)
وزلوبه	Козлодрание
آية الکرسي	Аят аль-Курси
معمولي وامبټ	Короткошёрстный вомбат
هېلېنيستي فلسفه	Эллинистическая философия
کورکورۍ	Белобрюхий рябок
هندو هېوادونه	Индуизм по странам
تور-ام۱	Тор (зенитный ракетный комплекс)
بوټځمکپوهنه	География растений
لېیوروس قوینقوېستریاتوس	Leiurus quinquestriatus
د روژومبرک کلا	Рожмберк
تجويد	Таджвид
ملتون	Коммерческая организация
اسلامي ساينس	Наука в средневековом исламском мире
ظهير الدين محمد بابر	Бабур
نورگل ولسوالۍ	Нургал
بر کونړ ولسوالۍ	Бар-Кунар
وټه پور ولسوالۍ	Вата-Пур
چپه دره ولسوالۍ	Чапа-Дара
نړنگ او باډل ولسوالۍ	Наранг
پاکستان مسلم لیگ ن	Пакистанская мусульманская лига (Н)
ږيره ور خوگ	Бородатая свинья
برزخ	Барзах
درېيځ (مېچپوهنه)	Куб
آتريال فېبرېلېشن	Фибрилляция предсердий
هډپوهنه	Остеология
څلورمه خور	Джумада ас-сани
ارواپالنه	Спиритуализм (религия)
چاپېريال ساتنه	Охрана окружающей среды
ماشيندار مادل ٦١	Скорпион (пистолет-пулемёт)
جنت	Джаннат
فيزيکي کتنه	Физикальное обследование
يهودي فلسفه	Еврейская философия
اومان	Хвойник
امام علي آرام ځاي	Мечеть Имама Али
ټاټرا ټې – ۳	Tatra T3
لوېديځه فلسفه	Западная философия
مندر	Индуистский храм
لويه جرگه	Лойя-джирга
اسلامي زده کړې	Исламоведение
رقم جوړؤنکي وسایل	Оцифровка
2G	2G
د زړه عضلاتي اعتلال	Кардиомиопатия
نيوروفېبروماټوسېز	Нейрофиброматоз
درېيمه خور	Джумада аль-уля
ټوپک مادل ٥٨	CZ SA Vz.58
کومييز سرطان	Рак гортани
پېرودونکی	Заказчик
د استخباراتو امنيتي اداره	Служба безопасности и информации
عيسوي فلسفه	Христианская философия
دوه څنډی	Двуугольник
زوم	Жених
د سږو بوغمه	Отёк лёгких
آی خانم	Ай-Ханум
وییزېرمه	Глоссарий
معاصره فلسفه	Философия Нового времени
د مهدي پوځ	Армия Махди
پاکستان مسلم لیگ ق	Пакистанская мусульманская лига (К)
بسم الله خان محمدي	Хан, Бисмилла
ليکتوکي	Канцелярские товары
د اکولا اوبتل	Подводные лодки проекта 971 «Щука-Б»
د بازار جوړښت	Структура рынка
چترال ولسوالۍ	Читрал (округ)
سمونتيا	Реформа
ډانا مادل ۷۷ لیري ویشتونکي توپ	152-мм самоходная пушка-гаубица vz.77 «Дана»
دارالامان ماڼۍ	Дворец «Дар уль-Аман»
توردلی	Чеканы (мухоловки)
د رېږدلې انجنيري	Сейсмостойкое строительство
ماليکولي ننوونی	Молекулярные сита
مونټ سټوارټ الفنسټن	Эльфинстон, Маунтстюарт
برېښنایي مرمري سکيټ کب	Мраморный электрический скат
تور نس لرونکي ستن	Стрекоза решётчатая
هېماټوپويسز	Гемопоэз
هندو (ورځپاڼه)	The Hindu
گجرات	Гуджрат
سجده	Суджуд
ذاکر نايک	Найк, Закир
اسلامي وييپانگه	Исламские термины
ميدان ښار ولسوالۍ	Майданшахр
جهنگ ولسوالۍ	Джанг (округ)
د سيستان او بلوچستان ولايت	Систан и Белуджистан
سني ډيول	Деол, Санни
د افغانستان اسلامي حزب	Исламская партия Афганистана
ايراني هڅوب	Культура Ирана
بژېونوف صومعه	Бржевновский монастырь
ستراهوف صومعه	Страговский монастырь
محمد اسلم وطنجار	Ватанджар, Мохаммад Аслам
افغانايټ	Афганит
هندو خدايان	Индуистские божества
سلطان علي کشتمند	Кештманд, Султан Али
سردار محمد اکبر خان	Акбар-хан
غازي محمد ايوب خان	Мухаммед Аюб-хан
سردار نصرالله خان	Насрулла-хан
اېکزېما	Экзема
د افغان-انگرېز لومړۍ جگړه	Первая англо-афганская война
مردان	Мардан
لرغونې يوناني فلسفه	Древнегреческая философия
بودايي فلسفه	Буддийская философия
يشناټکی	Температура кипения
د فارس ولايت	Фарс (остан)
غزاله جاوېد	Джавед, Газала
د نړۍ برحاله هېوادمشران	Список действующих глав государств и правительств
مستونگ ولسوالۍ	Мастунг (округ)
پاړاچنار	Парачинар
انار دره ولسوالۍ	Анар-Дара
هالي بېري	Берри, Хэлли
غبرگه ښیښه	Стеклопакет
1G	1G
د روسيې دولتي کتابتون	Российская государственная библиотека
ابو الفتح الشهرستاني	Абуль-Фатх аш-Шахрастани
اندخوی ولسوالۍ	Андхой
د بوټي ژونکه	Растительные клетки
د استخباراتو پرانيستى سرچينه	OSINT
اږبکه	Пурпурная лесная ласточка
ووبرنځپوهنه	Патогистология
يوڅنډی	Одноугольник
گڼيال رسنۍ	Носитель информации
لادا اوبتل	Подводные лодки проекта 677 «Лада»
پېښور	Пешавар
کرک ولسوالۍ	Карак (округ)
آر پي جي – ۲۹	РПГ-29
څېړنيزه خبريالي	Журналистские расследования
جرمنۍ غومبسه	Оса германская
زهوب	Экссудат
حدود	Хадд
د افغانستان ولسمشر	Президент Афганистана
فرعوني مېږی	Фараонов муравей
طلا تپه	Тилля-тепе
د مخترعینو لړليک	Список изобретателей
اداينه	Платёж
د افغانستان حکومت	Государственный строй Афганистана
د افغانستان بانک	Да Афганистан банк
خروشتي	Кхароштхи
جل وهنه	Тепловой удар
خدايگوټی	Язаты
هندو ليکنې	Литература индуизма
د بابر توغندی	Хатф-VII Бабур
دوتنه	Файл (значения)
لافايټ جنگي بېړۍ	Фрегаты типа «Лафайет»
گڼيه	Ипотечное кредитование
ناپروکسين	Напроксен
تعبیه شوی چاودیدونکی وسیله	Самодельное взрывное устройство
کوهاټ ولسوالۍ	Кохат (округ)
د پاني پت دريمه جگړه	Битва при Панипате (1761)
د افغان-انگرېز درېمه جگړه	Третья англо-афганская война
د هرات جامع جومات	Джума-мечеть (Герат)
سولگریز جال	Компьютерная сеть
د حکومت بڼې	Форма государственного правления
ځنگلي خزدکه	Навозник лесной
محمد هاشم ميوندوال	Майвандваль, Мохаммад Хашим
پر اسلام نيوکه	Критика ислама
قارون	Корей
اسلامي هڅوب	Исламская культура
توره بوړه	Тора-Бора
اسلامي وټه	Исламская экономика
کابل پوهنتون	Кабульский университет
موسکيټ	Москит (противокорабельная ракета)
ویرا غیر فعال څارونکی سیستم	Vera
د کاربن ډای اکسایډ ليزر	Углекислотный лазер
د اصفهان ولايت	Исфахан (остан)
ويکيپېډيا:وييپانگه	Википедия:Глоссарий
مرتضی مطهري	Мутаххари, Муртаза
محمد يوسف	Мухаммед Юсуф
فضل حق خالقيار	Халекьяр, Фазль-уль-Хак
محمد موسى شفيق	Шафик, Мохаммад Муса
وېشنيزه:د امريکا متحده ايالات	Категория:США
وېشنيزه:روسيه	Категория:Россия
وېشنيزه:کاناډا	Категория:Канада
وېشنيزه:برطانيه	Категория:Великобритания
وېشنيزه:چين	Категория:Китай
وېشنيزه:هندوستان	Категория:Индия
وېشنيزه:سعودي عربستان	Категория:Саудовская Аравия
وېشنيزه:ايران	Категория:Иран
پښتونولي	Пуштунвалай
لامبوځنه ښیښه	Термополированное стекло
ابدالي	Дуррани
د مقدس جورج کلیسا	Базилика Святого Георгия
وېشنيزه:افغانستان	Категория:Афганистан
وېشنيزه:الجېريا	Категория:Алжир
وېشنيزه:عراق	Категория:Ирак
وېشنيزه:نېدرلانډ/هالېنډ	Категория:Нидерланды
وېشنيزه:نايجېريا	Категория:Нигерия
وېشنيزه:پاکستان	Категория:Пакистан
وېشنيزه:د روم امپراطوری	Категория:Римская империя
وېشنيزه:مارغان	Категория:Птицы
وېشنيزه:بوټي	Категория:Растения
وېشنيزه:ژونپوهنه	Категория:Биология
وېشنيزه:پېښليک	Категория:История
وېشنيزه:ځمکپوهنه	Категория:География
وېشنيزه:ټولنه	Категория:Общество
وېشنيزه:مذهب	Категория:Религия
وېشنيزه:ورزښت	Категория:Спорт
وېشنيزه:اروپايي اتحاديه	Категория:Европейский союз
وېشنيزه:ټوليزې رسنۍ	Категория:Средства массовой информации
وېشنيزه:ژبه	Категория:Язык
وېشنيزه:ځمکه	Категория:Земля
وېشنيزه:تشيال	Категория:Космос
مړاپ زره پوښ گاډي	MRAP
لړم (مياشت)	Абан (месяц)
ټېمېلين اټومي برېښناکوټ	АЭС Темелин
مثنوي	Маснави
د قرآن مخينه	История Корана
بر دير ولسوالۍ	Верхний Дир
رڼايي سپڼسيزې اړيكې	Волоконно-оптическая связь
د بشري حقونو نړېواله اسلامي اعلاميه	Каирская декларация о правах человека в исламе
نوښار ولسوالۍ	Наушера (округ)
چاودونکي شکل لرونکي مردک	Ударное ядро
د پاکستان هوايي ځواک	Военно-воздушные силы Пакистана
سرپل	Сари-Пуль (город)
پښتونستان	Пуштунистан
اورمکۍ	Моли
کينډۍ:/بکس-پايليک	Шаблон:Box-footer
ابراهيم	Ибрахим
افغانستان د اسلام د راتگ نه مخکې	Доисламская история Афганистана
نړيواله ټولنه	Мировое сообщество
ملهم	Мазь
کاربون نانو نل	Углеродные нанотрубки
محصول	Продукт
پزوونی	Ланцет
د افغانستان هوايي ځواک	Национальный воздушный корпус Афганистана
رکوع	Руку
پراگا وې ۳ اس	Praga V3S
بابر بڼ	Сады Бабура
سوده بنت زمعه	Сауда бинт Зама
کيشکره	Кедровки
د حسن او حسين مياشت	Мухаррам
د افغانستان وټه	Экономика Афганистана
وېشنيزه:فلسفه	Категория:Философия
وېشنيزه:عيسويت	Категория:Христианство
وېشنيزه:اسلام	Категория:Ислам
وېشنيزه:يهوديت	Категория:Иудаизм
پارت	Парфянское царство
جزء	Джуз (Коран)
اخوان الصفا	Братья чистоты
روينا ټنډون	Тандон, Равина
ملا صدرا	Мулла Садра
محمد نبي محمدي	Наби, Мухаммед
خمس	Хумс
توپک مادل ۲۴	Vz. 24 (винтовка)
لکي مروت ولسوالۍ	Лакки-Марват (округ)
بونير ولسوالۍ	Бунер (округ)
رهبانيت	Монашеский орден
گوادر ولسوالۍ	Гвадар (округ)
اميرالمومنين	Амир аль-муминин
گوربت	Орлиные
رمله بنت ابي سفيان	Рамля бинт Абу Суфьян
چسکی کروملوف (ماڼۍ)	Крумловский замок
سلطان معزالدين کيقباد	Муизз ад-дин Кай-Кубад
اسلام شاه سوري	Ислам-шах
چرگ	Петух
غازي آباد ولسوالۍ (کونړ)	Газиабад (Афганистан)
ساتنه	Защита
ډیسکوساوریسکوس	Дискозавриск
وړانگه	Рей
مولتان ولسوالۍ	Мултан (округ)
پشين ولسوالۍ	Пишин (округ)
فيصل آباد ولسوالۍ	Фейсалабад (округ)
حافظ آباد ولسوالۍ	Хафизабад (округ)
گوجرانواله ولسوالۍ	Гуджранвала (округ)
بهاولپور ولسوالۍ	Бахавалпур (округ)
لوره لايي ولسوالۍ	Лоралай (округ)
بولان ولسوالۍ	Качхи
ژوب ولسوالۍ	Зхоб (округ)
اټک ولسوالۍ	Атток (округ)
بکتر شکن	HJ-8
زيارت ولسوالۍ	Зиарат (округ)
نصير اباد ولسوالۍ	Насирабад (округ)
دېره غازي خان ولسوالۍ	Дера-Гази-Хан (округ)
موسی خېل ولسوالۍ (بلوچستان)	Мусахель (округ)
چکوال ولسوالۍ	Чаквал (округ)
بهکر ولسوالۍ	Бхаккар (округ)
لاهور ولسوالۍ	Лахор (округ)
کوټه ولسوالۍ	Кветта (округ)
ډېره بگټي ولسوالۍ	Дера-Бугти (округ)
سيالکوټ ولسوالۍ	Сиялкот (округ)
کوهلو ولسوالۍ	Кохлу (округ)
خراسان	Великий Хорасан
لر دير ولسوالۍ	Нижний Дир
مانسهره ولسوالۍ	Маншехра (округ)
کابل پوليتخنيک پوهنتون	Кабульский политехнический университет
اندراب ولسوالۍ	Андараб
مردان ولسوالۍ	Мардан (округ)
د پاکستان ولسوالۍ	Округа Пакистана
چارسده ولسوالۍ	Чарсадда (округ)
هنگو ولسوالۍ	Хангу (округ)
شنگله ولسوالۍ	Шангла (округ)
بوښوتنيکا	Бохотница
الاسمای	Аль-Асмаи
د خښتي پل جومات	Пул-е Хишти
اناپلازموسېز	Анаплазмоз
شېراني ولسوالۍ	Ширани (округ)
قيف غاښ لرونکي ژوي	Яноконодон
ساهيوال ولسوالۍ	Сахивал (округ)
راجنپور ولسوالۍ	Раджанпур (округ)
ويهاړي ولسوالۍ	Вихари (округ)
ليه ولسوالۍ	Леях (округ)
نارووال ولسوالۍ	Наровал (округ)
منډي بهاوالدين ولسوالۍ	Манди-Бахауддин (округ)
ميانوالي ولسوالۍ	Миянвали (округ)
تولید (سوداگري)	Продукт (бизнес)
نوشکي ولسوالۍ	Нушки (округ)
پنجگور ولسوالۍ	Панджгур (округ)
د عراق او شام اسلامي دولت	Исламское государство Ирака и Леванта
يونس	Иона (пророк)
عبدالروف بېنوا	Бенава, Абдуррауф
وټيز څېړندود	Методология экономической науки
د افغانستان ژبې	Языки Афганистана
داستان	Дастан
سبي ولسوالۍ	Сиби (округ)
بادخورک	Пустельга
لودهران ولسوالۍ	Лодхран (округ)
ننکانه صاحب ولسوالۍ	Нанкана-Сахиб (округ)
چنيوټ ولسوالۍ	Чиниот (округ)
شېخپوره ولسوالۍ	Шекхупура (округ)
قصور ولسوالۍ	Касур (округ)
واخان ولسوالۍ	Вахан (район, Афганистан)
افغانستان ته د اسلام راتگ	Арабское вторжение в Афганистан
ویدانتا	Веданта
د کيميا فلسفه	Философия химии
کشک ولسوالۍ	Кушк (район)
د افغانستان بنسټيزه کړنلاره	Конституция Афганистана
پښتانه	Пуштуны
لکي مروت	Лакки-Марват
رانا سنگا	Санграм Сингх
سکندر لودي	Сикандар-шах Лоди
د پاکستان د هوايي ډگرونو لړليک	Список аэропортов Пакистана
لیس ډوسېټ	Дюсет, Лиз
د هرات پوهنتون	Университет города Герат
ابو الفضل محمد بيهقي	Абуль-Фадль аль-Байхаки
خوشاب ولسوالۍ	Хушаб (округ)
پانډور زره پوښ موټر	Pandur II
مرزا اسلم بېگ	Бек, Аслам
د افغانستان د اوسنيو واليانو لړليک	Список губернаторов провинций Афганистана
جهل مگسي ولسوالۍ	Джхал-Магси (округ)
افغانان (آسټراليا)	Афганцы (Австралия)
رحيميار خان ولسوالۍ	Рахимъярхан (округ)
خضدار ولسوالۍ	Хуздар (округ)
مولوي	Мавлави
گرېگ مورټنسن	Мортенсон, Грег
بايزيد انصاري	Баязид Ансари
مخابرات په افغانستان کې	Телекоммуникации в Афганистане
پېچ دره ولسوالۍ	Дара-и-Печ
دانگام ولسوالۍ	Дангам
اسد آباد ولسوالۍ	Асадабад (район)
ناړۍ ولسوالۍ	Нари
څوکۍ ولسوالۍ	Чавкай
مروره ولسوالۍ	Маравара
خاص کونړ ولسوالۍ	Хас-Кунар
د افغانستان د هوايي ډگرونو لړليک	Список аэропортов Афганистана
خواهان ولسوالۍ	Хвахан (район)
تخنيک	Техника
مهرانا پراتاپ	Махарана Пратап
قاضي حسين احمد	Ахмад, Кади Хусейн
بهلول لودي	Бахлул-хан Лоди
نكاح	Никах
رسنۍ	Среднее значение
سمبالښت	Менеджмент
وېشنيزه:هڅوب	Категория:Культура
وېشنيزه:لويې وچې	Категория:Континенты
وېشنيزه:ځمکپېژنده	Категория:Геология
وېشنيزه:الوتکې	Категория:Воздушные суда
چنای ایکسپریس	Ченнайский экспресс
ثريا طرزي	Тарзи, Сорайя
تور غر ولسوالۍ	Торгар (округ)
وکيل احمد متوکل	Мутаваккиль, Вакиль Ахмад
د افغانستان د دفاع وزارت	Министерство обороны Афганистана
محمد رباني	Раббани, Мохаммад
هرنۍ ولسوالۍ	Харнай (округ)
بنو ولسوالۍ	Банну (округ)
باغبان (فلم)	Любовь и предательство
ايشوبی	Отопительный котёл
بټگرام ولسوالۍ	Баттаграм (округ)
مالاکنډ ولسوالۍ	Малаканд (округ)
تانبه:ځمکپوهنه	Портал:География
تانبه:فلسفه	Портал:Философия
د کوکا کولا شرکت	The Coca-Cola Company
ميمونه بنت الحارث	Маймуна бинт аль-Харис
حزب	Хизб
واصل بن عطا	Васил ибн Ата
ويکيپېډيا:غونډال ته څنګه ورننوځو	Википедия:Представление системе
ترتيل	Тартиль
ذکر	Zekr
قاري	Кари (чтец Корана)
جويريه بنت الحارث	Джувайрия бинт аль-Харис
کيمياوي وسلې	Химическое оружие
وېشنيزه:د پوهنغونډ روباټان	Категория:Участники:Боты
وېشنيزه:د افغانستان توکمونه	Категория:Народы Афганистана
تانبه:ټولنه	Портал:Общество
څلوريځ	Двустишие
د مسلمانو فيلسوفانو لړليک	Проект:Ислам/Список известных философов
غلام محمد خان طرزي	Тарзи, Гулям Мухаммад
افغانکا	Афганка
د خوست پوهنتون	Университет города Хост
محمد خان افغان	Афган-Мухаммед
حميد مومند	Абдулхамид Моманд
تانبه:هنرونه	Портал:Искусство
مصحف	Мусхаф
خټموښی	Кельма
کينډۍ:دوراشې کامه	Шаблон:Цитата
ويکيپېډيا:د نن ورځې انځور	Википедия:Изображение дня
وېشنيزه:هېوادونه	Категория:Страны
وېشنيزه:وټپوهنه	Категория:Экономика
ويکيپېډيا:پازوالان	Википедия:Администраторы
ويکيپېډيا:روباټان	Википедия:Бот
وېشنيزه:وخت	Категория:Время
وېشنيزه:انټرنټ	Категория:Интернет
عبدالباري جهاني	Абдул Бари Джахани
عبدالقادر خان خټک	Абдулкадырхан Хаттак
وېشنيزه:پیسې	Категория:Деньги
وېشنيزه:بوټپوهنه	Категория:Ботаника
وېشنيزه:اناتومي	Категория:Анатомия
وېشنيزه:طب	Категория:Медицина
وېشنيزه:سياست	Категория:Политика
گڼنه	Бухгалтерский учёт
امام زفر	Зуфар ибн аль-Хузайл
مصر	Египет
گما اس ۱ ای رادار	Гамма-С1Е
هندويزم او اسلام	Индуизм и ислам
اسلامي نظام	Исламское государство
د افغانستان شاعري	Литература Афганистана
وېشنيزه:فيلسوفان	Категория:Философы
کينډۍ:Bot	Шаблон:Bot
خپگان	Депрессия
کاناډا	Канада
وېشنيزه:هنګري	Категория:Венгрия
وېشنيزه:د اروپایي اتحادیې غړي هیوادونه	Категория:Государства-члены Европейского союза
وېشنيزه:چېک جمهوريت	Категория:Чехия
وېشنيزه:سلواکيا	Категория:Словакия
ويکيپېډيا:نيوليک	Википедия:Содержание Википедии
غوښتنه (وټپوهنه)	Платёжеспособный спрос
اکدي واکمنۍ	Аккад
وېشنيزه:مايکروسافټ	Категория:Microsoft
تانبه:پوهنه	Портал:Наука
کينډۍ:Flagicon	Шаблон:Флаг
وېشنيزه:د اروپا هېوادونه	Категория:Страны Европы
وېشنيزه:اروپا	Категория:Европа
تانبه:تازه پېښې	Портал:Текущие события
کينډۍ:لاسوند	Шаблон:Doc
ويکيپېډيا:د ټولنې تانبه	Википедия:Портал сообщества
وېشنيزه:User languages	Категория:Википедия:Участники по языкам
ويکيپېډيا:کارن-نوم	Википедия:Имена участников
عايشه بنت ابي بکر	Аиша бинт Абу Бакр
امام ابن حبان	Ибн Хиббан
سوداگري	Предпринимательство
تانبه:ټکنالوجي	Портал:Техника
کينډۍ:Softredirect	Шаблон:Soft redirect
کينډۍ:ړنگول	Шаблон:К быстрому удалению
ليکبڼه	Шрифт
وېشنيزه:ژبې	Категория:Языки
ويکيپېډيا:General disclaimer	Википедия:Отказ от ответственности
وېشنيزه:د چېک جمهوريت ښارونه	Категория:Города Чехии
ماشیندار اېوو - ۳	Cz Scorpion EVO 3 A1
کينډۍ:Navbox	Шаблон:Navbox
ويکيپېډيا:Shortcut	Шаблон:Shortcut
وېشنيزه:د ایران ښارونه	Категория:Города Ирана
خيميران	Химерообразные
کينډۍ:Citation needed	Шаблон:Нет источника
تانبه:ژوندليکونه	Портал:Персоналии
کينډۍ:Tnavbar	Шаблон:Tnavbar
ايمان	Вера
کينډۍ:Clear	Шаблон:Clear
کينډۍ:Col-begin	Шаблон:Столбцы
کينډۍ:Col-end	Шаблон:Столбцы/конец
کينډۍ:Anchor	Шаблон:Якорь
کينډۍ:Babel	Шаблон:Babel
کينډۍ:Commons	Шаблон:Commons
کينډۍ:لړسرچينې	Шаблон:Примечания
کينډۍ:AFG	Шаблон:AFG
کينډۍ:نابشپړ	Шаблон:Заготовка
کينډۍ:User de	Шаблон:User de
کينډۍ:User en-3	Шаблон:User en-3
کينډۍ:User en-1	Шаблон:User en-1
کينډۍ:User en-2	Шаблон:User en-2
کينډۍ:User en	Шаблон:User en
کينډۍ:User fa	Шаблон:User fa
وېشنيزه:افغاني هڅوب	Категория:Культура Афганистана
کينډۍ:User ja	Шаблон:User ja
کينډۍ:User ja-1	Шаблон:User ja-1
وېشنيزه:امريکايي لرغونپوهان	Категория:Археологи США
کينډۍ:د هېواد مالومات تاجکستان	Шаблон:Флагификация/Таджикистан
وېشنيزه:آسيا	Категория:Азия
کينډۍ:Esoteric	Шаблон:Эзотерика
کينډۍ:د هېواد مالومات کویټ	Шаблон:Флагификация/Кувейт
کينډۍ:Mod	Шаблон:Mod
کينډۍ:د هېواد مالومات بلجيم	Шаблон:Флагификация/Бельгия
کينډۍ:د هېواد مالومات سلواکيا	Шаблон:Флагификация/Словакия
کينډۍ:د هېواد مالومات اېل سلوادور	Шаблон:Флагификация/Сальвадор
کينډۍ:د هېواد مالومات پاناما	Шаблон:Флагификация/Панама
کينډۍ:د هېواد مالومات اېکوادور	Шаблон:Флагификация/Эквадор
کينډۍ:د هېواد مالومات اېتوپيا	Шаблон:Флагификация/Эфиопия
کينډۍ:د هېواد مالومات تونېسيا	Шаблон:Флагификация/Тунис
کينډۍ:د هېواد مالومات د چېک جمهوريت	Шаблон:Флагификация/Чехия
کينډۍ:د هېواد مالومات تايلنډ	Шаблон:Флагификация/Таиланд
کينډۍ:د هېواد مالومات کيوبا	Шаблон:Флагификация/Куба
کينډۍ:د هېواد مالومات اندونېزيا	Шаблон:Флагификация/Индонезия
کينډۍ:د هېواد مالومات کمبوډيا	Шаблон:Флагификация/Камбоджа
کينډۍ:د هېواد مالومات سېنېگال	Шаблон:Флагификация/Сенегал
کينډۍ:د هېواد مالومات ماداګاسکر	Шаблон:Флагификация/Мадагаскар
کينډۍ:د هېواد مالومات البانيا	Шаблон:Флагификация/Албания
وېشنيزه:درملپوهنه	Категория:Фармакология
کينډۍ:د هېواد مالومات پېرو	Шаблон:Флагификация/Перу
کينډۍ:د هېواد مالومات پاراګوای	Шаблон:Флагификация/Парагвай
کينډۍ:د هېواد مالومات کېنيا	Шаблон:Флагификация/Кения
کينډۍ:د هېواد مالومات نيکاراګوا	Шаблон:Флагификация/Никарагуа
کينډۍ:د هېواد مالومات هندوراس	Шаблон:Флагификация/Гондурас
کينډۍ:د هېواد مالومات ازبکستان	Шаблон:Флагификация/Узбекистан
کينډۍ:د هېواد مالومات بولېويا	Шаблон:Флагификация/Боливия
کينډۍ:د هېواد مالومات د ډومينيکان جمهوريت	Шаблон:Флагификация/Доминиканская Республика
کينډۍ:د هېواد مالومات توگو	Шаблон:Флагификация/Того
کينډۍ:د هېواد مالومات ګواتمالا	Шаблон:Флагификация/Гватемала
وېشنيزه:ژبپوهنه	Категория:Лингвистика
کينډۍ:د هېواد مالومات هايېتي	Шаблон:Флагификация/Гаити
کينډۍ:د هېواد مالومات مالي	Шаблон:Флагификация/Мали
کينډۍ:د هېواد مالومات مولدووا	Шаблон:Флагификация/Молдавия
کينډۍ:د هېواد مالومات لاتويا	Шаблон:Флагификация/Латвия
کينډۍ:د هېواد مالومات مالټا	Шаблон:Флагификация/Мальта
کينډۍ:د هېواد مالومات ډېنمارک	Шаблон:Флагификация/Дания
کينډۍ:د هېواد مالومات آيسلېنډ	Шаблон:Флагификация/Исландия
کينډۍ:د هېواد مالومات پولنډ	Шаблон:Флагификация/Польша
کينډۍ:د هېواد مالومات کېپ وردا	Шаблон:Флагификация/Кабо-Верде
کينډۍ:د هېواد مالومات بلغاريه	Шаблон:Флагификация/Болгария
کينډۍ:د هېواد مالومات بوسنيا او هېرزگوينا	Шаблон:Флагификация/БиГ
کينډۍ:د هېواد مالومات ګايانا	Шаблон:Флагификация/Гайана
کينډۍ:Wikivar	Шаблон:Wikivar
کينډۍ:د هېواد مالومات ناروې	Шаблон:Флагификация/Норвегия
کينډۍ:د هېواد مالومات سوېلي افريقا	Шаблон:Флагификация/ЮАР
کينډۍ:د هېواد مالومات جمايکا	Шаблон:Флагификация/Ямайка
کينډۍ:د هېواد مالومات ګورجستان	Шаблон:Флагификация/Грузия
کينډۍ:د هېواد مالومات ارجنټاين	Шаблон:Флагификация/Аргентина
کينډۍ:د هېواد مالومات يوروګوای	Шаблон:Флагификация/Уругвай
کينډۍ:د هېواد مالومات ټرېنېډاډ او توباګو	Шаблон:Флагификация/Тринидад и Тобаго
کينډۍ:د انځور نښه	Шаблон:Метка изображения
کينډۍ:د هېواد مالومات برونای	Шаблон:Флагификация/Бруней
کينډۍ:د هېواد مالومات سريلانکا	Шаблон:Флагификация/Шри-Ланка
کينډۍ:د هېواد مالومات مکسيکو	Шаблон:Флагификация/Мексика
کينډۍ:د هېواد مالومات یونان	Шаблон:Флагификация/Греция
کينډۍ:د هېواد مالومات لوکسېمبورگ	Шаблон:Флагификация/Люксембург
کينډۍ:د هېواد مالومات سعودي عربستان	Шаблон:Флагификация/Саудовская Аравия
کينډۍ:د هېواد مالومات بهاماس	Шаблон:Флагификация/Багамские Острова
کينډۍ:د هېواد مالومات کرواتيا	Шаблон:Флагификация/Хорватия
کينډۍ:د هېواد مالومات عراق	Шаблон:Флагификация/Ирак
کينډۍ:ليکوال-مالوماتبکس/لاسوند	Шаблон:Писатель
کينډۍ:د هېواد مالومات متحده عرب امارات	Шаблон:Флагификация/ОАЭ
کينډۍ:د هېواد مالومات ماروکو	Шаблон:Флагификация/Марокко
کينډۍ:د هېواد مالومات سربيا	Шаблон:Флагификация/Сербия
کينډۍ:د هېواد مالومات آسټراليا	Шаблон:Флагификация/Австралия
کينډۍ:د هېواد مالومات فرانسه	Шаблон:Флагификация/Франция
کينډۍ:Ambox	Шаблон:Ambox
کينډۍ:دکارنبکس-بېخ	Участник:Box/Конец колонки
کينډۍ:هېواد-مالوماتبکس	Шаблон:Государство
کينډۍ:د هېواد مالومات لاووس	Шаблон:Флагификация/Лаос
کينډۍ:د هېواد مالومات اتريش	Шаблон:Флагификация/Австрия
کينډۍ:د هېواد مالومات نيپال	Шаблон:Флагификация/Непал
کينډۍ:ترسره شو	Шаблон:Сделано
کينډۍ:د هېواد مالومات فېنلاند	Шаблон:Флагификация/Финляндия
کينډۍ:Audio	Шаблон:Audio
کينډۍ:د هېواد مالومات مصر	Шаблон:Флагификация/Египет
کينډۍ:د هېواد مالومات لېتوانيا	Шаблон:Флагификация/Литва
کينډۍ:د هېواد مالومات جاپان	Шаблон:Флагификация/Япония
کينډۍ:د هېواد مالومات نېدرلنډ	Шаблон:Флагификация/Нидерланды
کينډۍ:Start box	Шаблон:Start box
کينډۍ:ساينسپوه-مالوماتبکس	Шаблон:Учёный
کينډۍ:پوهنتون مالوماتبکس/لاسوند	Шаблон:Карточка университета
کينډۍ:د هېواد مالومات آذربايجان	Шаблон:Флагификация/Азербайджан
کينډۍ:د فايرفاکس کارن	Участник:Box/Пользователь Firefox
کينډۍ:Ar	Шаблон:Lang-ar
کينډۍ:د هېواد مالومات وېتنام	Шаблон:Флагификация/Вьетнам
کينډۍ:Featured article	Шаблон:Избранная статья
کينډۍ:د هېواد مالومات لېبيا	Шаблон:Флагификация/Ливия
کينډۍ:د هېواد مالومات روسیه	Шаблон:Флагификация/Россия
وېشنيزه:User en	Категория:User en
وېشنيزه:User en-2	Категория:User en-2
کينډۍ:مالوماتبکس	Шаблон:Карточка
کينډۍ:د ايران ولايتونه	Шаблон:Останы Ирана
کينډۍ:د هېواد مالومات اېکواټوريال گوينا	Шаблон:Флагификация/Экваториальная Гвинея
کينډۍ:User zh	Шаблон:User zh
کينډۍ:Colorbox	Шаблон:Colorbox
وېشنيزه:دوتر توکي	Категория:Офисная техника
کينډۍ:د هېواد مالومات اټاليا	Шаблон:Флагификация/Италия
کينډۍ:د المان ايالتي نقشه	Шаблон:Карта Земель Германии
کينډۍ:User ru-4	Шаблон:User ru-4
کينډۍ:Pp-template	MediaWiki:Protectedpagetext
کينډۍ:د هېواد مالومات سويډن	Шаблон:Флагификация/Швеция
وېشنيزه:کرهڼه	Категория:Сельское хозяйство
کينډۍ:Babel-4	Шаблон:Babel-4
کينډۍ:Infobox settlement	Шаблон:НП
کينډۍ:سني اسلام	Шаблон:Сунниты
کينډۍ:User ru	Шаблон:User ru
کينډۍ:نغا	Шаблон:IPA1
وېشنيزه:سياستوال	Категория:Политики
وېشنيزه:لمريز نظام	Категория:Планеты Солнечной системы
وېشنيزه:امريکا	Категория:Америка
کينډۍ:د هېواد مالومات کوسټاريکا	Шаблон:Флагификация/Коста-Рика
کينډۍ:د هېواد مالومات هند	Шаблон:Флагификация/Индия
کينډۍ:د هېواد مالومات الجېريا	Шаблон:Флагификация/Алжир
کينډۍ:د هېواد مالومات وېنېزوېلا	Шаблон:Флагификация/Венесуэла
کينډۍ:د هېواد مالومات فيجي	Шаблон:Флагификация/Фиджи
کينډۍ:Infobox Officeholder	Шаблон:Государственный деятель
کينډۍ:د هېواد مالومات انډورا	Шаблон:Флагификация/Андорра
کينډۍ:د هېواد مالومات آنگولا	Шаблон:Флагификация/Ангола
کينډۍ:د هېواد مالومات بوټسوانا	Шаблон:Флагификация/Ботсвана
کينډۍ:د هېواد مالومات اروپايي اتحاديه	Шаблон:Флагификация/Европейский союз
کينډۍ:Border	Шаблон:Граница
کينډۍ:د هېواد مالومات ډومنيکا	Шаблон:Флагификация/Доминика
کينډۍ:د هېواد مالومات پارتوګال	Шаблон:Флагификация/Португалия
کينډۍ:د هېواد مالومات آيرلېنډ	Шаблон:Флагификация/Ирландия
کينډۍ:د هېواد مالومات واټيکان ښار	Шаблон:Флагификация/Ватикан
کينډۍ:Fmbox	Шаблон:Fmbox
کينډۍ:د هېواد مالومات چین	Шаблон:Флагификация/Китай
کينډۍ:د هېواد مالومات بېنين	Шаблон:Флагификация/Бенин
کينډۍ:د هېواد مالومات د کانگو جمهوريت	Шаблон:Флагификация/Республика Конго
کينډۍ:ويکيسازنه	Шаблон:Викифицировать
کينډۍ:Familytree/end	Шаблон:Familytree/end
کينډۍ:د هېواد مالومات ترکيه	Шаблон:Флагификация/Турция
وېشنيزه:ليکوال	Категория:Писатели
کينډۍ:د هېواد مالومات قبرس	Шаблон:Флагификация/Кипр
کينډۍ:د هېواد مالومات سويتزرلاند	Шаблон:Флагификация/Швейцария
کينډۍ:د هېواد مالومات فلېپين	Шаблон:Флагификация/Филиппины
کينډۍ:د هېواد مالومات نايجېريا	Шаблон:Флагификация/Нигерия
کينډۍ:د هېواد مالومات آيرلنډ	Шаблон:Флагификация/Белоруссия
کينډۍ:د هېواد مالومات مالېزيا	Шаблон:Флагификация/Малайзия
کينډۍ:د هېواد مالومات ارمنستان	Шаблон:Флагификация/Армения
کينډۍ:د هېواد مالومات زېمبابوې	Шаблон:Флагификация/Зимбабве
کينډۍ:د هېواد مالومات ختيځ تېمور	Шаблон:Флагификация/Восточный Тимор
وېشنيزه:تومانچې	Категория:Пистолеты
کينډۍ:د هېواد مالومات ماينامار	Шаблон:Флагификация/Мьянма
کينډۍ:د هېواد مالومات قزاقستان	Шаблон:Флагификация/Казахстан
کينډۍ:د هېواد مالومات چېلي	Шаблон:Флагификация/Чили
کينډۍ:د هېواد مالومات سلووېنيا	Шаблон:Флагификация/Словения
کينډۍ:د هېواد مالومات لبنان	Шаблон:Флагификация/Ливан
کينډۍ:د کتاب مالوماتبکس-1	Шаблон:Издание
وېشنيزه:اسلامي وييپانګه	Категория:Арабские фразы
کينډۍ:د هېواد مالومات بهوټان	Шаблон:Флагификация/Бутан
کينډۍ:Booland	Шаблон:Both
وېشنيزه:څارګرې ادارې	Категория:Спецслужбы
کينډۍ:سورت	Шаблон:Суры
کينډۍ:لطفاً په دې مخ کې بدلون مه راولۍ	Википедия:Введение 2
کينډۍ:Lang-la	Шаблон:Lang-la
کينډۍ:Lang-el	Шаблон:Lang-el
وېشنيزه:اخلاق	Категория:Этика
د سره صليب نړيواله ټولنه	Международный комитет Красного Креста
کينډۍ:AddNewSection	Шаблон:AddNewSection
کينډۍ:Mergefrom	Шаблон:Перенести сюда
وېشنيزه:سولګر	Категория:Компьютеры
وېشنيزه:توکي	Категория:Оборудование
کينډۍ:MMAstatsbox	Шаблон:Боец смешанного стиля
کينډۍ:مالوماتبکس لويه وچه	Шаблон:Материк
وېشنيزه:پخوانی ژبې	Категория:Мёртвые языки
وېشنيزه:User ja-N	Категория:User ja-N
تانبه:اسلام	Портал:Ислам
کينډۍ:دشريان-مالوماتبکس	Шаблон:Карточка кровеносного сосуда
کينډۍ:Polytonic	Шаблон:Polytonic
کينډۍ:تانبې گرځښتپټه	Шаблон:Индекс
کينډۍ:Familytree/start	Шаблон:Familytree/start
کينډۍ:نامبهمېدنه	Шаблон:Неоднозначность
وېشنيزه:اسرائیلي جوماتونه	Категория:Мечети Израиля
وېشنيزه:د ایران امپراتورۍ او پاچاهۍ	Категория:Персия
وېشنيزه:پوځي الوتکې	Категория:Военные самолёты
کينډۍ:محمد	Шаблон:Мухаммад
کينډۍ:Lang-grc	Шаблон:Lang-grc
کينډۍ:د هېواد مالومات کوموروس	Шаблон:Флагификация/Коморы
کينډۍ:د فلسفې سرليکونه	Шаблон:Разделы философии
کينډۍ:Lang-pt	Шаблон:Lang-pt
کينډۍ:د هېواد مالومات قطر	Шаблон:Флагификация/Катар
کينډۍ:FRA	Шаблон:FRA
کينډۍ:د هېواد مالومات اسرایل	Шаблон:Флагификация/Израиль
کينډۍ:د هېواد مالومات اوکراين	Шаблон:Флагификация/Украина
کينډۍ:د هېواد مالومات کولمبيا	Шаблон:Флагификация/Колумбия
کينډۍ:د هېواد مالومات پاکستان	Шаблон:Флагификация/Пакистан
کينډۍ:د هېواد مالومات ګانا	Шаблон:Флагификация/Гана
کينډۍ:د هېواد مالومات رومانیا	Шаблон:Флагификация/Румыния
کينډۍ:د هېواد مالومات سوېلي کوريا	Шаблон:Флагификация/Республика Корея
کينډۍ:د لومړي مخ منځ-ويکي	Шаблон:Интервики на заглавной
کينډۍ:Npov	Шаблон:Проверить нейтральность
کينډۍ:Afghanistan-stub	Шаблон:Afghanistan-stub
کينډۍ:د هېواد مالومات بحرين	Шаблон:Флагификация/Бахрейн
کينډۍ:بوديزم	Шаблон:Буддизм
وېشنيزه:User ja	Категория:User ja
وېشنيزه:User ur	Категория:User ur
وېشنيزه:User ko-N	Категория:User ko-N
وېشنيزه:User ru-N	Категория:User ru-N
وېشنيزه:وختتېری	Категория:Развлечения
وېشنيزه:افغاني ټولنه	Категория:Общество Афганистана
وېشنيزه:تاريخپوهان	Категория:Историки
وېشنيزه:User de	Категория:User de
وېشنيزه:User de-N	Категория:User de-N
کينډۍ:د افغانستان ولايتونه	Шаблон:Административное деление Афганистана
وېشنيزه:User en-3	Категория:User en-3
وېشنيزه:User en-N	Категория:User en-N
آلو	Слива (подрод)
وېشنيزه:User fa	Категория:User fa
کينډۍ:N/A	Шаблон:N/a
وېشنيزه:د اسلام پيغمبران	Категория:Исламские пророки
کينډۍ:د هېواد مالومات برونډي	Шаблон:Флагификация/Бурунди
کينډۍ:د هېواد مالومات جرمني	Шаблон:Флагификация/Германия
کينډۍ:د هېواد مالومات بريتانيه	Шаблон:Флагификация/Великобритания
وېشنيزه:مېچپوهنه	Категория:Геометрия
کينډۍ:د هېواد مالومات اېسټونيا	Шаблон:Флагификация/Эстония
کينډۍ:د هېواد مالومات مانټېنېګرو	Шаблон:Флагификация/Черногория
کينډۍ:Weather box	Шаблон:Климат местности
وېشنيزه:User ja-1	Категория:User ja-1
کينډۍ:نستعليق	Шаблон:Nastaliq
وېشنيزه:ژمنۍ لوبې	Категория:Зимние виды спорта
وېشنيزه:User ko	Категория:User ko
وېشنيزه:د امريکا د متحده ايالاتو ايالتونه	Категория:Штаты США
کينډۍ:کورنۍ	Шаблон:Родственные отношения
وېشنيزه:بانکوالی	Категория:Банковское дело
کينډۍ:د هېواد مالومات د عاج ساحل	Шаблон:Флагификация/Кот-д’Ивуар
وېشنيزه:د ایران ولایتونه	Категория:Останы Ирана
وېشنيزه:User ru-1	Категория:User ru-1
کينډۍ:د لارښود نيوليک پر شا تگ	Шаблон:Help contents back
اسلامي رخصتۍ	Исламские праздники
وېشنيزه:مخدره مواد	Категория:Наркокультура
وېشنيزه:اند	Категория:Мышление
وېشنيزه:لمريز غونډال	Категория:Солнечная система
کينډۍ:د هېواد مالومات برازیل	Шаблон:Флагификация/Бразилия
وېشنيزه:مخترعين	Категория:Изобретатели
وېشنيزه:سر او غاړه	Категория:Голова
ډبرپوهنه	Литология
کينډۍ:د هېواد مالومات سوازيلاند	Шаблон:Флагификация/Свазиленд
وېشنيزه:ژوپوهنه	Категория:Зоология
وېشنيزه:د رضوي خراسان ولايت	Категория:Хорасан-Резави
تانبه:دين	Портал:Религия
وېشنيزه:هلیکوپترونه	Категория:Вертолёты
وېشنيزه:ټولنيزې پوهنې	Категория:Общественные науки
کينډۍ:د هېواد مالومات هنګري	Шаблон:Флагификация/Венгрия
وېشنيزه:د آفریقاهیوادونه	Категория:Страны Африки
کينډۍ:Template reference list	Шаблон:Ссылки в шаблоне
وېشنيزه:حزب الله	Категория:Хизбалла
کينډۍ:د هېواد مالومات نيوزيلاند	Шаблон:Флагификация/Новая Зеландия
وېشنيزه:القاعده	Категория:Аль-Каида
وېشنيزه:User ro-3	Категория:User ro-3
وېشنيزه:User ru	Категория:User ru
وېشنيزه:User ru-2	Категория:User ru-2
وېشنيزه:User ru-3	Категория:User ru-3
وېشنيزه:User ru-4	Категория:User ru-4
کينډۍ:انبيا په قرآن كې	Шаблон:Пророки ислама
کينډۍ:Lang	Шаблон:Lang
کينډۍ:د هېواد مالومات د امريکا متحده ايالات	Шаблон:Флагификация/США
وحدة الوجود	Вахдат аль-вуджуд
کينډۍ:د هېواد مالومات ترکمنستان	Шаблон:Флагификация/Туркмения
وېشنيزه:د ۱۹۵۷ کال زېږېدنې	Категория:Родившиеся в 1957 году
کينډۍ:د هېواد مالومات سهېلي کوريا	Шаблон:Флагификация/КНДР
کينډۍ:د هېواد مالومات افغانستان	Шаблон:Флагификация/Афганистан
کينډۍ:د هېواد مالومات بنگله دېش	Шаблон:Флагификация/Бангладеш
لوگر ولايت	Логар (провинция)
کينډۍ:د پاکستان سياسي جغرافي وېش	Шаблон:Административное деление Пакистана
کينډۍ:د افغانستان سرليکونه	Шаблон:Афганистан в темах
کينډۍ:امينواسيدونه	Шаблон:Аминокислоты
وېشنيزه:افغانان	Категория:Персоналии:Афганистан
وېشنيزه:بي بي سي	Категория:Би-би-си
کينډۍ:Biochemical families	Шаблон:Биохимические группы
د آلمان دپاره آلترناتیف	Альтернатива для Германии
وېشنيزه:آرنی	Категория:Статьи
کينډۍ:د هېواد مالومات د کانگو ډيموکراتيک جمهوريت	Шаблон:Флагификация/Демократическая Республика Конго
وېشنيزه:اوبتلونه	Категория:Подводные лодки
کينډۍ:OrganicBox atom	Шаблон:OrganicBox
وېشنيزه:ماشیندارونه	Категория:Пистолеты-пулемёты
وېشنيزه:د پاکستان ایالتونه او سیمې	Категория:Провинции Пакистана
وېشنيزه:ليبيا	Категория:Ливия
وېشنيزه:افغاني رسنۍ	Категория:Средства массовой информации Афганистана
وېشنيزه:په وچې پورې تړلي هیوادونه	Категория:Страны, не имеющие выхода к морю
وېشنيزه:د افغانستان وټه	Категория:Экономика Афганистана
کينډۍ:User ru-1	Шаблон:User ru-1
کينډۍ:د هېواد مالومات بېلاز	Шаблон:Флагификация/Белиз
وېشنيزه:بلوچستان	Категория:Белуджистан
کينډۍ:دا وخت	Участник:Box/Календарик
کينډۍ:د هېواد مالومات کوسووا	Шаблон:Флагификация/Республика Косово
کينډۍ:د هېواد مالومات ماورېتانيا	Шаблон:Флагификация/Мавритания
کينډۍ:د هېواد مالومات ګابون	Шаблон:Флагификация/Габон
کينډۍ:د هېواد مالومات جبوتي	Шаблон:Флагификация/Джибути
کينډۍ:د هېواد مالومات آروبا	Шаблон:Флагификация/Аруба
کينډۍ:د هېواد مالومات سوډان	Шаблон:Флагификация/Судан
کينډۍ:د هېواد مالومات چاډ	Шаблон:Флагификация/Чад
وېشنيزه:روسي ساينسپوهان	Категория:Учёные России
وېشنيزه:طالبان	Категория:Талибан
وېشنيزه:بازارموندنه	Категория:Маркетинг
وېشنيزه:د نړۍ هېوادونه	Категория:Международные отношения
کينډۍ:د هېواد مالومات انټيگ او بربودا	Шаблон:Флагификация/Антигуа и Барбуда
کينډۍ:د هېواد مالومات ګامبيا	Шаблон:Флагификация/Гамбия
وېشنيزه:غږپوهنه	Категория:Фонология
کينډۍ:د هېواد مالومات نامېبيا	Шаблон:Флагификация/Намибия
وېشنيزه:مالیه	Категория:Финансы
وېشنيزه:روسي اوبتلونه	Категория:Подводные лодки ВМФ России
وېشنيزه:د افغانستان ولايتونه	Категория:Провинции Афганистана
وېشنيزه:د چېک خلک	Категория:Персоналии:Чехия
وېشنيزه:مرکزي بانکونه	Категория:Центральные банки
وېشنيزه:کيمياوي توکي	Категория:Химические элементы
وېشنيزه:امريکايي فيلسوفان	Категория:Философы США
وېشنيزه:ساينسپوهان	Категория:Учёные
وېشنيزه:لمريزې مياشتې	Категория:Месяцы иранского календаря
وېشنيزه:د افغانستان پوځ	Категория:Вооружённые силы Афганистана
وېشنيزه:سهېلي کوريا	Категория:Корейская Народно-Демократическая Республика
وېشنيزه:د ليبيا خلک	Категория:Персоналии:Ливия
وېشنيزه:د آسيا ارزونه	Категория:Азиатские валюты
وېشنيزه:ايراني سیاستوال	Категория:Политики Ирана
وېشنيزه:د پاکستان سياستوال	Категория:Политики Пакистана
کينډۍ:د هېواد مالومات بورکينا فاسو	Шаблон:Флагификация/Буркина-Фасо
کينډۍ:د هېواد مالومات د منځنۍ افريقا جمهوريت	Шаблон:Флагификация/Центральноафриканская Республика
وېشنيزه:خبريالي	Категория:Журналистика
وېشنيزه:اوزبکستان	Категория:Узбекистан
وېشنيزه:مغولو پاچايي	Категория:Империя Великих Моголов
وېشنيزه:عثماني پېر	Категория:Османская империя
وېشنيزه:افغاني ليکوال	Категория:Писатели Афганистана
کينډۍ:د هېواد مالومات سېچېلېس	Шаблон:Флагификация/Сейшельские Острова
کينډۍ:د هېواد مالومات پاپوا نيوګوينا	Шаблон:Флагификация/Папуа — Новая Гвинея
وېشنيزه:پاکستاني هېوادمشران	Категория:Президенты Пакистана
وېشنيزه:د فارس خليج هېوادونه	Категория:Страны у Персидского залива
وېشنيزه:مېوې	Категория:Фрукты
وېشنيزه:زهرلرونکي نباتونه	Категория:Ядовитые растения
د پښتو ژبې لنډ گرامر	Грамматика языка пушту
وېشنيزه:د اروپا سيمې	Категория:Регионы Европы
وېشنيزه:د آسیا جغرافیا	Категория:География Азии
وېشنيزه:جوماتونه	Категория:Мечети
وېشنيزه:د ترکیې جوماتونه	Категория:Мечети Турции
هډوتري	Компьютерная техника
وېشنيزه:دانټي رېټرووايرل درملونه	Категория:Средства для лечения ВИЧ
وېشنيزه:انتي بيوتيکونه	Категория:Антибиотики
وېشنيزه:د افشاريانو حکمرانان	Категория:Афшариды
وېشنيزه:ددرمل شکل	Категория:Лекарственные формы
وېشنيزه:د شمېرپوهنې ډګرونه	Категория:Разделы математики
وېشنيزه:خبري اژانس	Категория:Информационные агентства
وېشنيزه:بشرِی حقوق	Категория:Права человека
تورن	Капитан
وېشنيزه:ناټو	Категория:НАТО
وېشنيزه:پوځي وييونه	Категория:Военная терминология
وېشنيزه:غړي	Категория:Органы (биология)
وېشنيزه:وسلې	Категория:Оружие
وېشنيزه:امريکايي سندرغاړي	Категория:Певцы США
وېشنيزه:د ټوپولف الوتکې	Категория:Самолёты Туполева
وېشنيزه:بم غورځونکي الوتکې	Категория:Бомбардировщики
وېشنيزه:د بېټا-لاکټاماز انتي بيوتيکونه	Категория:Бета-лактамы
وېشنيزه:پاړسي ژبه	Категория:Персидский язык
وېشنيزه:اېډز	Категория:ВИЧ-инфекция
وېشنيزه:قران	Категория:Коран
وېشنيزه:ناروغۍ	Категория:Заболевания
وېشنيزه:ترافيک ترانسپورت	Категория:Транспорт
وېشنيزه:لوبې	Категория:Виды спорта
وېشنيزه:کورنۍ	Категория:Семья
وېشنيزه:قضاء	Категория:Правосудие
وېشنيزه:سندرغاړي	Категория:Певцы и певицы
وېشنيزه:وټپوهان	Категория:Экономисты
کينډۍ:Flagcountry	Шаблон:Флагификация
کينډۍ:د ژبې مالوماتبکس	Шаблон:Язык
وېشنيزه:ځمکپوهان	Категория:Географы
وېشنيزه:ولسواکي	Категория:Демократия
وېشنيزه:درمل	Категория:Лекарственные средства
وېشنيزه:ټانکونه	Категория:Танки
وېشنيزه:د آفریقا د هېوادونو پلازمېنې	Категория:Столицы Африки
وېشنيزه:ايراني هڅوب	Категория:Культура Ирана
وېشنيزه:د رومانیا ښارونه	Категория:Города Румынии
وېشنيزه:کراچۍ	Категория:Карачи
وېشنيزه:کابل	Категория:Кабул
وېشنيزه:د آسیا د هېوادونو پلازمېنې	Категория:Столицы азиатских государств
وېشنيزه:پښتانه	Категория:Пуштуны
وېشنيزه:چېکي واکمنان	Категория:Короли Чехии
وېشنيزه:د مسراشمیت الوتکې	Категория:Самолёты Messerschmitt
وېشنيزه:د افغانستان ژبې	Категория:Языки Афганистана
وېشنيزه:هندوکش	Категория:Гиндукуш
وېشنيزه:هرات	Категория:Герат (город)
کينډۍ:د خيبر پښتونخوا ولسوالۍ	Шаблон:Округа Хайбер-Пахтунхвы
وېشنيزه:د بانکوالی وییونه او اوزار	Категория:Банковские термины и оборудование
وېشنيزه:شوبلې ضد وسلې	Категория:Противотанковые ракетные комплексы
وېشنيزه:مرکزي قبایلي سیمې	Категория:Федерально управляемые племенные территории
وېشنيزه:معمر القذافي	Категория:Муаммар Каддафи
وېشنيزه:د افغانستان جوماتونه	Категория:Мечети Афганистана
وېشنيزه:کندهار	Категория:Кандагар
وېشنيزه:د قاجاريانو حکمرانان	Категория:Каджары
وېشنيزه:افغاني ګوندونه	Категория:Политические партии Афганистана
کينډۍ:د هېواد مالومات اسپانيا	Шаблон:Флагификация/Испания
کينډۍ:د هېواد مالومات کاناډا	Шаблон:Флагификация/Канада
کينډۍ:د هېواد مالومات بربادوس	Шаблон:Флагификация/Барбадос
کينډۍ:د هېواد مالومات ګرېنادا	Шаблон:Флагификация/Гренада
کينډۍ:د هېواد مالومات اردن	Шаблон:Флагификация/Иордания
کينډۍ:د هېواد مالومات قرغزستان	Шаблон:Флагификация/Киргизия
کينډۍ:د هېواد مالومات لېسوتو	Шаблон:Флагификация/Лесото
کينډۍ:د هېواد مالومات لايبېريا	Шаблон:Флагификация/Либерия
کينډۍ:د هېواد مالومات ملاوي	Шаблон:Флагификация/Малави
کينډۍ:د هېواد مالومات مالديپ	Шаблон:Флагификация/Мальдивы
کينډۍ:د هېواد مالومات ماورېشوس	Шаблон:Флагификация/Маврикий
کينډۍ:د هېواد مالومات مغولستان	Шаблон:Флагификация/Монголия
کينډۍ:د هېواد مالومات نايجېر	Шаблон:Флагификация/Нигер
کينډۍ:د هېواد مالومات پورټو ريکو	Шаблон:Флагификация/Пуэрто-Рико
کينډۍ:د هېواد مالومات راوانډا	Шаблон:Флагификация/Руанда
کينډۍ:د هېواد مالومات سېراليون	Шаблон:Флагификация/Сьерра-Леоне
کينډۍ:د هېواد مالومات سورينام	Шаблон:Флагификация/Суринам
کينډۍ:د هېواد مالومات سوريه	Шаблон:Флагификация/Сирия
کينډۍ:د هېواد مالومات سېنگاپور	Шаблон:Флагификация/Сингапур
کينډۍ:د هېواد مالومات يوگانډا	Шаблон:Флагификация/Уганда
کينډۍ:د هېواد مالومات ونواتو	Шаблон:Флагификация/Вануату
کينډۍ:د هېواد مالومات يمن	Шаблон:Флагификация/Йемен
کينډۍ:د هېواد مالومات زېمبيا	Шаблон:Флагификация/Замбия
وېشنيزه:افغان جنګسالاران	Категория:Военачальники Афганистана
کينډۍ:د هېواد مالومات اېرېتېريا	Шаблон:Флагификация/Эритрея
کينډۍ:يهوديت	Шаблон:Иудаизм
کينډۍ:رنگ مالوماتبکس	Шаблон:Карточка цвета
وېشنيزه:د آسیا هېوادونه	Категория:Страны Азии
زينت کرزۍ	Карзай, Зинат
کينډۍ:آډولف هېټلر	Шаблон:Адольф Гитлер
کينډۍ:لمريزې مياشتې	Шаблон:Месяцы иранского календаря
کينډۍ:تصوف	Шаблон:Суфизм
کينډۍ:Sw icon	Шаблон:Ref-sw
وېشنيزه:مسافروړونکي الوتکې	Категория:Пассажирские самолёты
کينډۍ:د هېواد مالومات عربي ټولنه	Шаблон:Флагификация/Лига арабских государств
وېشنيزه:د القلوید مواد	Категория:Алкалоиды
وېشنيزه:خيبر پښتونخوا	Категория:Хайбер-Пахтунхва
وېشنيزه:باليووډ	Категория:Болливуд
کينډۍ:د هېواد مالومات لوېديځه سحارا	Шаблон:Флагификация/Западная Сахара
کينډۍ:د هېواد مالومات د فالکلاند ټاپوان	Шаблон:Флагификация/Фолклендские острова
نومونپوهنه	Терминология
کينډۍ:د هېواد مالومات ګونې	Шаблон:Флагификация/Гвинея
کينډۍ:د هېواد مالومات ګوينې بېساو	Шаблон:Флагификация/Гвинея-Бисау
کينډۍ:وسله مالوماتبکس	Шаблон:Карточка оружия
وېشنيزه:د ټاټرا موټرونه	Категория:Автомобили Tatra
وېشنيزه:اسلامي وټه	Категория:Исламский банкинг
کينډۍ:د هېواد مالومات آذربايجان-SSR	Шаблон:Флагификация/Азербайджанская ССР
کينډۍ:غوږ شه	Шаблон:Listen
وېشنيزه:د ساسانیانو حکمرانان	Категория:Сасаниды
وېشنيزه:د پاکستان هوایی ځواک	Категория:Военно-воздушные силы Пакистана
وېشنيزه:سنډ	Категория:Синд
وېشنيزه:د افغانستان لومړي وزيران	Категория:Премьер-министры Афганистана
کينډۍ:د هېواد مالومات مقدونيه	Шаблон:Флагификация/Македония
وېشنيزه:مسلمان فيلسوفان	Категория:Исламские философы
وېشنيزه:ليکتوکي	Категория:Канцтовары
وېشنيزه:بسونه	Категория:Автобусы
وېشنيزه:تصوف	Категория:Суфизм
وېشنيزه:ورکړېنې	Категория:Налогообложение
روژه (مياشت)	Рамадан (месяц)
وېشنيزه:افغاني فلمونه	Категория:Фильмы Афганистана
کينډۍ:د هېواد مالومات تانزانيا	Шаблон:Флагификация/Танзания
وېشنيزه:ټراکټورونه	Категория:Трактор
وېشنيزه:پاکستانی جنرالان	Категория:Генералы Пакистана
کينډۍ:د هېواد مالومات سوماليا	Шаблон:Флагификация/Сомали
وېشنيزه:پاکستاني جوماتونه	Категория:Мечети Пакистана
وېشنيزه:پښتو ژبه	Категория:Пушту
وېشنيزه:د چیک ولسمشران	Категория:Президенты Чехии
وېشنيزه:قراني سورتونه	Категория:Суры Корана
وېشنيزه:د لويديځ سلاوي ژبې	Категория:Западнославянские языки
وېشنيزه:User en-1	Категория:User en-1
وېشنيزه:افغان ښځې	Категория:Женщины Афганистана
وېشنيزه:د پاکستان څارگرې ادارې	Категория:Спецслужбы Пакистана
وېشنيزه:پښتانه شاعران	Категория:Поэты на пушту
وېشنيزه:اسلامپوهان	Категория:Исламоведы
کينډۍ:Userbox-level	Участник:Box/Уровень
دويم بريدمن	Младший лейтенант
د امانت گڼون	Банковский вклад
ټنک ولسوالۍ	Танк (округ)
کينډۍ:Supranational European Bodies	Шаблон:Наднациональные европейские организации
ټغ	Сойки (значения)
کينډۍ:د-هېواد-تاريخ	Шаблон:Дипломатические отношения
کينډۍ:د بلوچستان ولسوالۍ (پاکستان)	Шаблон:Округа пакистанского Белуджистана
کينډۍ:د پنجاب ولسوالۍ (پاکستان)	Шаблон:Округа пакистанского Пенджаба
د افغانستان پوځ	Вооружённые силы Афганистана
ويکيپېډيا:Infobox templates	Википедия:Шаблоны/Карточки
تانبه:قرآن	Портал:Коран
کوکۍ	Булавоусые чешуекрылые
قيامت	Киямат
ابو منصور ماتريدي	Абу Мансур аль-Матуриди
مولۍ	Редька посевная
درملتون	Аптека
تانبه:پاکستان	Портал:Пакистан
هريپور ولسوالۍ	Харипур (округ)
کينډۍ:Style/ril	Шаблон:Style/ril
کينډۍ:Style/IPA	Шаблон:Style/IPA
کينډۍ:Style/yid	Шаблон:Style/yid
Module:Convert	Модуль:Convert
سوفيست	Софисты
کينډۍ:د-ن-و-ا	Шаблон:Potd
افغانستان او پاکستان کې د 2013 کال سېلابونه	Наводнение в Афганистане и Пакистане (2013)
کينډۍ:د هېواد مالومات عمان	Шаблон:Флагификация/Оман
کينډۍ:د هېواد مالومات موزمبيق	Шаблон:Флагификация/Мозамбик
کينډۍ:د هېواد مالومات کېمرون	Шаблон:Флагификация/Камерун
Module:Roman	Модуль:Roman
کينډۍ:Infobox event	Шаблон:Новостное событие
Module:Factorization	Модуль:Factorization
ځانګړی:اوسني بدلونونه	Служебная:Свежие правки
Module:Coordinates	Модуль:Coordinates
د پېښور پر پوځي ښوونځي بريد	Террористический акт в Пешаваре 16 декабря 2014 года
