Afrika	Африка
Jabaan	Япония
Ameerikada koonfureed	Южная Америка
Norway	Норвегия
Ingiriiska	Англия
Skotland	Шотландия
Waalis	Уэльс
Waqooyiga Ayrland	Северная Ирландия
Ireland	Ирландия
Hungaria	Венгрия
Isbania	Испания
Mareykanka	Соединённые Штаты Америки
Beljim	Бельгия
Luksemburg	Люксембург
Koon	Вселенная
Dhul	Земля
Nolosha	Жизнь
Biniaadan	Человек разумный
George Washington	Вашингтон, Джордж
Finland	Финляндия
Iswiidhan	Швеция
Denmark	Дания
Boland	Польша
Lithuaniya	Литва
Talyaaniga	Италия
Iswisarland	Швейцария
Austriya	Австрия
Giriig	Греция
Turkiga	Турция
Bortuqaal	Португалия
Yurub	Европа
Aasiya	Азия
Woqooyiga Ameerika	Северная Америка
Antiarktis	Антарктида
Wikipedia	Википедия
Holland	Нидерланды
New York	Нью-Йорк
Washington D.C	Вашингтон (округ Колумбия)
Baarliin	Берлин
Los Angeles	Лос-Анджелес
Boeing	Boeing
Kumbuyuutar	Компьютер
Jineefa	Женева
Internet	Интернет
Barack Obama	Обама, Барак
Uruguay	Уругвай
London	Лондон
Qaahiro	Каир
Baariis	Париж
Android	Android
Google	Google (компания)
Meksiko	Мексика
Badweynta Atlaantik	Атлантический океан
Badweynta Baasifik	Тихий океан
Kalifornia	Калифорния
Isniin	Понедельник
Janaayo	Январь
Febraayo	Февраль
Maarso	Март
Farraare	Марс
Kiinya	Кения
Itoobiya	Эфиопия
Gaana	Гана
Abriil	Апрель
May	Май
Juun	Июнь
Luuliyo	Июль
Agoosto	Август
Sebteembar	Сентябрь
Oktoobar	Октябрь
Nofeembar	Ноябрь
Diseembar	Декабрь
Talaado	Вторник
Arbaco	Среда
Khamiis	Четверг
Jimco	Пятница
Sabti	Суббота
Axad	Воскресенье
Libaax	Лев
Faransiiska	Франция
Esberanto	Эсперанто
Ey	Собака
Midowga boqortooyada Britan	Великобритания
Yaanyuur	Кошка
Shiinaha	Китайская Народная Республика
Af-Faransiis	Французский язык
Malaay	Рыбы
Khamri	Алкогольные напитки
Barasiil	Бразилия
François Hollande	Олланд, Франсуа
Ruushka	Россия
Nibiri	Китообразные
Labajibaarane	Квадрат
Bad	Море
Bada madaw	Чёрное море
Pi Sumad xisaabeed	Пи (число)
Cambe	Манго (фрукт)
Wiki	Вики
Toronto	Торонто
Alabama	Алабама
São Paulo	Сан-Паулу
São Paulo (Gobol)	Сан-Паулу (штат)
Wikimedia	Фонд Викимедиа
Jimmy Wales	Уэйлс, Джимми
Ingiriis	English (значения)
Jarmalka	Германия
Belarus	Белоруссия
Af-Jarmal	Немецкий язык
Island	Исландия
Estoniya	Эстония
David Cameron	Кэмерон, Дэвид
Raage	Сатурн
Chocolate	Шоколад
Dagaalada	Война
Kow	1 (число)
Labo	2 (число)
Sadax	3 (число)
Afar (lambar)	4 (число)
Shan	5 (число)
0	0 (число)
George W. Bush	Буш, Джордж Уокер
Laydi	Прямоугольник
Latfiya	Латвия
Ukrain	Украина
Jamhuuriyadda Tashik	Чехия
Islofaakiya	Словакия
Isloveeniya	Словения
Moldofa	Молдавия
Romania	Румыния
Bulgaria	Болгария
Roma	Рим
Jamhuriyada Makedonia	Республика Македония
Albania	Албания
Griinland	Гренландия (административная единица)
Kroatia	Хорватия
Bosniya	Босния и Герцеговина
Aserbiijaan	Азербайджан
Andorra	Андорра
Jasiirada Qabrus	Республика Кипр
Joorjiya	Грузия
Kasakhstan	Казахстан
Malta	Мальта
Monako	Монако
Montenegro	Черногория
Faatikan	Ватикан
San Marino	Сан-Марино
Boroksel	Брюссель
Kuuba	Куба
Belise	Белиз
Barbados	Барбадос
Indunisiya	Индонезия
Wolfgang Amadeus Mozart	Моцарт, Вольфганг Амадей
Af-Turki	Турецкий язык
Koonfur Afrika	Южно-Африканская Республика
Aljeeriya	Алжир
Usbekistan	Узбекистан
Biyo	Вода
Alwaax	Древесина
Telefishin	Телевидение
Claude Monet	Моне, Клод
Diego Velázquez	Веласкес, Диего
Jili	Чили
El Greco	Эль Греко
Ciise	Иисус Христос
Dusaa	Меркурий
Taariikh	История
Apple Inc	Apple
Waxaraxir	Венера
Jaceyl	Любовь
Cirjeex	Юпитер
Uraano	Уран (планета)
Nicolas Sarkozy	Саркози, Николя
Nebtuun	Нептун
Xiddigis	Астрономия
Singabuur	Сингапур
Saynis	Наука
Buluuto	Плутон
Liechtenstein	Лихтенштейн
Ciyaaraha	Спорт
Adolf Hitler	Гитлер, Адольф
Facebook	Facebook
Julian Assange	Ассанж, Джулиан
Dagaalkii koowaad	Первая мировая война
Dagaalkii Labaad ee Aduunka	Вторая мировая война
Goorsheegto	Часы
Linux	Linux
Xisaab	Математика
Af-Laatiin	Латинский язык
Baxrayn	Бахрейн
Armania	Армения
Seerbiya	Сербия
Bil	Луна
Istanbuul	Стамбул
Australia	Австралия
Fiisigis	Физика
Arjantiina	Аргентина
Isgaarsiinta	Электросвязь
Peru	Перу
Bayoloji	Биология
Waqooyiga Kuuriya	Корейская Народно-Демократическая Республика
Kambodiya	Камбоджа
Qur'aan	Коран
Diinsoor (xayawaan)	Динозавры
Islaam	Ислам
Ljubljana	Любляна
World Wide Web	Всемирная паутина
Naag	Женщина
Gabay	Поэзия
Chernobyl	Авария на Чернобыльской АЭС
Milan	Милан
Torino	Турин
Liin dhanaan	Лимон
Moos	Банан
Ubax	Цветок
Magaalo	Город
Napoleon Bonaparte	Наполеон I
Xidig	Звезда
Qorax	Солнце
Cir	Небо
Tuulo	Село
Ooshiyaaniya	Океания
Bahda Midaysay Qoraxdu	Солнечная система
Ilig	Зуб (биология)
Hydrogen	Водород
Hiliyaam	Гелий
Ilik	Зубы человека
Cadaab	Ад
Wikimedia Commons	Викисклад
Liithiyaam	Литий
Beriiliyaam	Бериллий
Buug	Книга
Maalin	Сутки
Bariga Timor	Восточный Тимор
Sanad	Год
Qarni	Век
Oslo	Осло
Lissabon	Лиссабон
Dubay	Дубай (эмират)
Lionel Messi	Месси, Лионель
Booron	Бор (элемент)
Versailles	Версаль (город)
Kaarboon	Углерод
Nitrojiin	Азот
Ogsajiin	Кислород
FC Internazionale Milano	Интернационале
Meere	Планета
Muusig	Музыка
Moskow	Москва
Foloriin	Фтор
Af-Taliyaani	Итальянский язык
Niyoon	Неон
Saint Petersburg	Санкт-Петербург
Jad	Чад
Sodhiyaam	Натрий
Woqooyi	Север
Magniisiyaam	Магний
Alumiiniyaam	Алюминий
New Zealand	Новая Зеландия
Koonfur	Юг
Hindiya	Индия
Silikoon	Кремний
Faransiyaam	Франций
Tuvalu	Тувалу
Fosforos	Фосфор
Xadiid	Железо
Galbeed	Запад
Salfar	Сера
Bari (Jiho)	Восток
Jasiiradaha Solomon	Соломоновы Острова
Koloriin	Хлор
Koofurta Holland	Южная Голландия
Balau	Палау
Aargon	Аргон
Nawru	Науру
Firefox	Mozilla Firefox
Waqooyiga Holland	Северная Голландия
Botashiyaam	Калий
Zeeland	Зеландия (провинция)
Kaalshiyaam	Кальций
Flevoland	Флеволанд
Lead	Свинец
Jasiirada Marshall	Маршалловы Острова
Kiribati	Кирибати
Mongolia	Монголия
Fiji	Фиджи
Iskaandhiyaam	Скандий
Titaaniyaam	Титан (элемент)
Fanansuwela	Венесуэла
Jinkis Khan	Чингисхан
Fanadhiyaam	Ванадий
Koroomiyaam	Хром
Faras	Домашняя лошадь
Amistardam	Амстердам
Hub	Оружие
Xayawaan	Животные
Surinam	Суринам
Manganiis	Марганец
Paraguay	Парагвай
Guyana	Гайана
Fan	Искусство
Ikwadoor	Эквадор
Reheniyaam	Рений
Kolombiya	Колумбия
Kobalti	Кобальт
Tungsten	Вольфрам
Nikel	Никель
Boliifia	Боливия
Osmiyaam	Осмий
Groningen	Гронинген (провинция)
Kober	Медь
Beer	Растения
Sinki	Цинк
Leonardo da Vinci	Леонардо да Винчи
Boqoshaa	Грибы
Jamayka	Ямайка
Friesland	Фрисландия (Нидерланды)
Drenthe	Дренте
Overijssel	Оверэйссел
Guatemala	Гватемала
Gelderland	Гелдерланд
Utrecht	Утрехт (провинция)
Bahamas	Багамские Острова
Dooro	Курица
Antigua iyo Barbuda	Антигуа и Барбуда
Hawaay	Гавайи
Dominika	Доминика
Doofaar	Домашняя свинья
Haiti	Республика Гаити
El Salfador	Сальвадор
Iiraan	Иран
Ciraaq	Ирак
Xikmad	Мудрость
Kosta Rika	Коста-Рика
Israaiil	Израиль
Magaalada Utrecht	Утрехт
Banama	Панама
Yemen	Йемен
Virus	Вирусы
Urdun	Иордания
Nikaragua	Никарагуа
Florida	Флорида
Qargistan	Киргизия
Kuwayt	Кувейт
Laos	Лаос
Lubnaan	Ливан
Jasiirada Maldiif	Мальдивы
Ameerika	Америка
Lo'	Корова
Malaysiya	Малайзия
Burma	Мьянма
Nebal	Непал
Cumaan	Оман
Bakistaan	Пакистан
Qatar	Катар
Ciyaarta Teeniska	Теннис
Sacuudi Carabiya	Саудовская Аравия
Siri Lanka	Шри-Ланка
Suuriya	Сирия
Gaaliyaam	Галлий
Tadsjikistan	Таджикистан
Pokemon	Покемон
Taywan	Китайская Республика
YouTube	YouTube
Jermaaniyaam	Германий
Tayland	Таиланд
Tareen	Поезд
Aarsenik	Мышьяк
Turkmenistan	Туркмения
Seleniyaam	Селен
Iridiyaam	Иридий
Imaaraatka Carabta	Объединённые Арабские Эмираты
Boromiin	Бром
Balatiniyaam	Платина
Fiyetnam	Вьетнам
Charlie Chaplin	Чаплин, Чарльз
Koonfur Kuuriya	Республика Корея
Kiribtoon	Криптон
Afgaanistan	Афганистан
Gangnam Style	Gangnam Style
Rubiidhiyaam	Рубидий
Dahab	Золото
Kanaalka Suweys	Суэцкий канал
Bangladesh	Бангладеш
Maali	Мали
Sokrades	Сократ
Angola	Ангола
Butaan	Бутан
Twitter	Твиттер
Barunay	Бруней
Tansaaniya	Танзания
Meerkuri	Ртуть
Roald Amundsen	Амундсен, Руаль
Harry Mulisch	Мулиш, Харри
Filibiin	Филиппины
Jamhuuriyadda Bartamaha Afrika	Центральноафриканская Республика
Cirifka Koonfur	Южный полюс
Cirifka waqooyi	Северный полюс
Isxaaq Newton	Ньютон, Исаак
Albert Einstein	Эйнштейн, Альберт
Istoroontiyaam	Стронций
Itriyaam	Иттрий
Bismuth	Висмут
Jaale	Жёлтый цвет
Togo	Того
Tunisiya	Тунис
Saambiya	Замбия
Simbaabwi	Зимбабве
Beijing	Пекин
Koonfur Suudaan	Южный Судан
Benin	Бенин
Botswana	Ботсвана
Burkina Faso	Буркина-Фасо
Burundi	Бурунди
Komoros	Коморы
Jamhuuriyadda Kongo	Республика Конго
Jamhuuriyada Dimuqaraadiga Kongo	Демократическая Республика Конго
Jabuuti	Джибути
Boloniyaam	Полоний
Ikweetiga Guinea	Экваториальная Гвинея
Eratareya	Эритрея
New Delhi	Нью-Дели
Ilmo	Младенец
Astatiin	Астат
Gabon	Габон
Mahatma Gandhi	Махатма Ганди
Gambia	Гамбия
Guinea	Гвинея
Guinea-Bissau	Гвинея-Бисау
Xeebta Foolmaroodi	Кот-д’Ивуар
Kamiruun	Камерун
Kab Ferde	Кабо-Верде
Lesotho	Лесото
Liberia	Либерия
Libiya	Ливия
Madagaskar	Мадагаскар
Malaawi	Малави
Mauritania	Мавритания
Mauritius	Маврикий
Marooko	Марокко
Musanbiig	Мозамбик
Nambiya	Намибия
Nayjar	Нигер
Nayjeeriya	Нигерия
Yugandha	Уганда
Ruwanda	Руанда
Sirkooniyaam	Цирконий
Sao Tome iyo Prinsipe	Сан-Томе и Принсипи
Sinigaal	Сенегал
Seyshelles	Сейшельские Острова
Sierra Leone	Сьерра-Леоне
Soomaaliya	Сомали
Niyobiyaam	Ниобий
Julius Caesar	Гай Юлий Цезарь
Suudaan	Судан
Swasiland	Свазиленд
Qaansa Roobaad	Радуга
Molybdenum	Молибден
Teknetiyaam	Технеций
Qaramada Midoobay	Организация Объединённых Наций
Juquraafi	География
Wadno	Сердце
Maskax	Головной мозг
Maqaar	Кожа
Midab	Цвет
Rutheniyaam	Рутений
Roodhiyaam	Родий
Baluug	Синий цвет
Baladiyaam	Палладий
Naxaas	Серебро
Kaadmiyaam	Кадмий
Limburg	Лимбург (Нидерланды)
Tin (curiye)	Олово
Antimony	Сурьма
Teluriyaam	Теллур
Waqooyiga Brabant	Северный Брабант
Aaydhiin	Иод
Siinoon	Ксенон
Kaasiyaam	Цезий
Baariyaam	Барий
Haafniyaam	Гафний
Aktiiniyaam	Актиний
Tantalum	Тантал (элемент)
Bill Clinton	Клинтон, Билл
Raadhiyaam	Радий
Raadhoon	Радон
Lorraine	Лотарингия
Buerto Riko	Пуэрто-Рико
Niedersachsen	Нижняя Саксония
Lombardia	Ломбардия
Qudus	Иерусалим
Rutherfordium	Резерфордий
Dubniyaam	Дубний
Siiborgiyaam	Сиборгий
Badweynta Hindiya	Индийский океан
Kosofo	Республика Косово
Badda Karabiya	Карибское море
Bohriyaam	Борий
Hasiyaam	Хассий
Meitneriyaam	Мейтнерий
Darmstadtiyaam	Дармштадтий
Roentgeniyaam	Рентгений
Dortmund	Дортмунд
Ununtriyaam	Унунтрий
Lifermoriyaam	Ливерморий
Ununoktiyaam	Унуноктий
Maastricht	Маастрихт
Jiilaal	Зима
Gu	Весна
Xagaa	Лето
Dayr	Осень
Sadaam Xuseen	Саддам Хусейн
Usaama bin Laadin	Усама бен Ладен
Caarcaaro	Пауки
Miro	Плод
Lacagta	Деньги
Xasharaad	Насекомые
Faladimir Lenin	Ленин, Владимир Ильич
Uetersen	Итерзен
Augustus Octavian	Октавиан Август
Microsoft Windows	Windows
Jibraltaar	Гибралтар
Nokia	Nokia
Baabuur	Автомобиль
Juventus FC	Ювентус
Texas	Техас
Bruno Mars	Бруно Марс
Sasiiliya	Сицилия
Sardiiniya	Сардиния
Fuuqbax	Болезнь Крона
Buenos Aires	Буэнос-Айрес
Tokyo	Токио
Barcelona	Барселона
Abidjan	Абиджан
Minnesota	Миннесота
Baqdaad	Багдад
Isuduwaha Waqtiga Caalamiga	Всемирное координированное время
AC Milan	Милан (футбольный клуб)
Buuri	Табак (вещество)
Internet Explorer	Internet Explorer
Sigaar	Сигарета
Nayl armistaroong	Армстронг, Нил
Maxamed Faarax	Фарах, Мохаммед
München	Мюнхен
Fiyena	Вена
Kobanhaygan	Копенгаген
Stockholm	Стокгольм
Helsinki	Хельсинки
Dublin	Дублин
Bratislava	Братислава
Budapest	Будапешт
Frankfurt	Франкфурт-на-Майне
Lanthanum	Лантан
Kitaabka quduska	Библия
Phnom Penh	Пномпень
Ho Chi Minh City	Хошимин
Luteetiyaam	Лютеций
Mida Rumeed Kaniisada Ciise	Церковь истинного Иисуса
Ingiriis (luqad)	Английский язык
Bangkok	Бангкок
Dong Hoi	Донгхой
Concepción	Консепсьон (город, Чили)
Franck Ribéry	Рибери, Франк
Ottawa	Оттава
Dayaxa Cirjeex	Спутники Юпитера
Juba	Джуба
Końskowola	Коньсковоля
Dar es Salaam	Дар-эс-Салам
Khartuum	Хартум
Dayaxa raage	Спутники Сатурна
2000	2000 год
2003	2003 год
2002	2002 год
2001	2001 год
2012	2012 год
2011	2011 год
2010	2010 год
2009	2009 год
2013	2013 год
2014	2014 год
2008	2008 год
2004	2004 год
2005	2005 год
2006	2006 год
2007	2007 год
1900	1900 год
1901	1901 год
Charles De Gaulle	Де Голль, Шарль
1906	1906 год
1908	1908 год
1909	1909 год
1992	1992 год
1991	1991 год
1990	1990 год
1993	1993 год
1994	1994 год
1995	1995 год
1996	1996 год
1910	1910 год
1911	1911 год
1912	1912 год
1913	1913 год
1914	1914 год
1997	1997 год
1998	1998 год
1999	1999 год
1918	1918 год
Cunto	Пища
Mas	Змеи
Dayaxa docay	Спутники Нептуна
Dashiishe	1 января
1920	1920 год
1919	1919 год
1921	1921 год
Georges Pompidou	Помпиду, Жорж
Malmö	Мальмё
Birmingham	Бирмингем
Microsoft	Microsoft
Borotoon	Протон
Kurów	Курув
Kimisteri	Химия
Robin van Persie	Ван Перси, Робин
27	27 год
1989	1989 год
1988	1988 год
1987	1987 год
1986	1986 год
1985	1985 год
1984	1984 год
1983	1983 год
1982	1982 год
1981	1981 год
1980	1980 год
Muqdisho	Могадишо
Sana'a	Сана
1970	1970 год
1971	1971 год
1972	1972 год
1973	1973 год
1974	1974 год
1975	1975 год
1976	1976 год
1977	1977 год
1978	1978 год
1979	1979 год
1969	1969 год
18 Abriil	18 апреля
25 Abriil	25 апреля
26 Abriil	26 апреля
Dayax	Спутник (космос)
Kristian Wulff	Вульф, Кристиан
15 Meey	15 мая
SSC Napoli	Наполи
1968	1968 год
1967	1967 год
1966	1966 год
1965	1965 год
1964	1964 год
27 Juun	27 июня
Kubadda Cagta	Футбол
AS Roma	Рома (футбольный клуб)
1963	1963 год
Holokost	Холокост
1962	1962 год
Michael Jackson	Джексон, Майкл
Bogota	Богота
29 Diseembar	29 декабря
Quito	Кито
Adhi	Коза домашняя
21 Oktoobar	21 октября
Paramaribo	Парамарибо
Wiil	Мальчик
Gabar	Девочка
Kanbera	Канберра
Sydney	Сидней
Cagaar	Зелёный цвет
Gaduud	Красный цвет
Perth	Перт (Австралия)
Galbeed Australia (gobol)	Западная Австралия
New South Wales	Новый Южный Уэльс
Wabiga Niil	Нил
Jini	Джинн
Wabiga Nijer	Нигер (река)
Rabat	Рабат
Algiers	Алжир (город)
Tunis	Тунис (город)
Triboli	Триполи
Rede Globo	Globo
Jabuuti (magaalo)	Джибути (город)
Tahraan	Тегеран
Addis Abeba	Аддис-Абеба
Ankara	Анкара
Asmara	Асмэра
Nijamiina	Нджамена
Niamey	Ниамей
Nawakshot	Нуакшот
1961	1961 год
Bamako	Бамако
Belgaraad	Белград
Dakar	Дакар
Banjul	Банжул
Konakri	Конакри
Bissau	Бисау
Category:Template	Категория:Википедия:Шаблоны
Monrofia	Монровия
Braia	Прая
1960	1960 год
Akara	Аккра
Dimishiq	Дамаск
Yamoussoukro	Ямусукро
Faransiis Guyana	Французская Гвиана
Ougadougou	Уагадугу
Freetown	Фритаун
Abuja	Абуджа
Lome	Ломе
Borto-Novo	Порто-Ново
Yawunde	Яунде
Malabo	Малабо
Librefille	Либревиль
Bangui	Банги
Kinshasa	Киншаса
Barasafille	Браззавиль
Bujumbura	Бужумбура
Kigali	Кигали
Dodoma	Додома
Nayroobi	Найроби
Lilongwe	Лилонгве
Lusaka	Лусака
Qorax madoobaad	Солнечное затмение
Mabuto	Мапуту
Kambaala	Кампала
Luanda	Луанда
Moroni	Морони
Mabane	Мбабане
Maseru	Масеру
Dugsi	Школа
Antananarifo	Антананариву
Jaamacad	Университет
Gaborone	Габороне
Harare	Хараре
Pretoria	Претория
Bort Lois	Порт-Луи
Sao Tome	Сан-Томе (город)
Windhoek	Виндхук
Wikipedia:Bacaadka	Википедия:Песочница
Fiktoria	Виктория (Сейшельские острова)
Guri	Жилище
Kombuyuuterka Dhabta	Ноутбук
Computer Hardware	Аппаратное обеспечение
Aljebra	Алгебра
Webiyada	Река
Osasko	Озаску
Garoonka ee Dong Hoi	Донгхой (аэропорт)
Curitiba	Куритиба
Pangea	Пангея
Keyn	Лес
Anne Frank	Франк, Анна
Shilin Soomaali	Сомалийский шиллинг
Confucius	Конфуций
Category:Taariikhda Ciraaq	Категория:История Ирака
Corbin Bleu	Блю, Корбин
Category:Xisaab	Категория:Математика
Jasiiradaha Feroe	Фарерские острова
Maxamed Morsi	Мурси, Мухаммед
Euro	Евро
Bada Dhexe	Средиземное море
Haashim	Бану Хашим
Masiixiyad	Христианство
Windows 8	Windows 8
Template:Dalalka Aasiya	Шаблон:Страны Азии
Bariis	Рис (продукт питания)
Céline Dion	Дион, Селин
Qaaradaha	Континент
Adelaide	Аделаида
Shimbir	Птицы
Template:Islaam	Шаблон:Ислам
Bilaha	Месяц
Mustafa Kemal Atatürk	Ататюрк, Мустафа Кемаль
1948	1948 год
Jeejniya	Чечня
1949	1949 год
Garoosni	Грозный
Huang Xianfan	Хуан Сяньфань
1956	1956 год
1941	1941 год
1945	1945 год
1958	1958 год
1926	1926 год
1947	1947 год
1944	1944 год
1952	1952 год
Bill Gates	Гейтс, Билл
Encyclopedia	Энциклопедия
DVD	DVD
Bogga Hore	Заглавная страница
CPU	Процессор
1959	1959 год
Template:Maqaal Cusub	Шаблон:Хорошая статья
Dhesibel	Децибел
Kubadda Koleyga	Баскетбол
Kab town	Кейптаун
Bada Qaswiin	Каспийское море
Harta Fiktooriya	Виктория (озеро)
Harada malaawi	Ньяса
Salvador Dalí	Дали, Сальвадор
Finsent van Gogh	Ван Гог, Винсент
Hokusai	Кацусика Хокусай
Mishelangelo	Микеланджело
Bablo bekaso	Пикассо, Пабло
Rembrandt van Rijn	Рембрандт
Eminem	Эминем
Bas	Автобус
Baabiyloon	Вавилон
Katalooniya	Каталония
Samarqanda	Самарканд
Bukhaara	Бухара
Mekka	Мекка
Che Guvara	Че Гевара, Эрнесто
Mao Zedong	Мао Цзэдун
Kabul	Кабул
Luqada Tamil-ka	Тамильский язык
Filasoofiyada	Философия
50 Cent	50 Cent
Dr. Dre	Dr. Dre
Snoop Dogg	Snoop Dogg
Shaax	Чай
Tupac Shakur	Шакур, Тупак
Xidig-dhul	Настоящие ежи
1507	1507 год
Shuuciyad	Коммунизм
Amadeyo afogadro	Число Авогадро
Liberalinimo	Либерализм
Wadan	Страна
Qaran	Нация
Jow Bayden	Байден, Джо
Hillary Clinton	Клинтон, Хиллари
Dabaal	Плавание человека
Category:Xiddigis	Категория:Астрономия
1542	1542 год
1543	1543 год
Jaan Jaak Rosoo	Руссо, Жан-Жак
Saxaara	Сахара
Hambeegar	Гамбургер
Shaydaanka	Бес (христианство)
1606	1606 год
Maktabad	Библиотека
FC Barcelona	Барселона (футбольный клуб)
Midowga afrika	Африканский союз
Siyaasadda,	Политика
Jaamacada Carabta	Лига арабских государств
Dimoqraadi	Демократия
Hay'ada laanqayrta cas	Международное движение Красного Креста и Красного Полумесяца
Gaashaanbuurta NATO	Организация Североатлантического договора
Qin Shi Huang	Цинь Шихуанди
Bariga Dhexe	Средний Восток
Jamhuriyadda	Республика
Hantiwadaag	Социализм
Dowlad	Государство
Xisbi	Политическая партия
Kilimanjaaro	Килиманджаро
Kristoffer Kolombus	Колумб, Христофор
Rixlaat Ibn Batuuta	Ибн Баттута
Kanaalka Banama	Панамский канал
Dheg	Ухо
San	Нос
Muruq	Мышцы
Hees	Песня
Kaneeco	Комары
Libaax Badeed	Акулы
Geel	Верблюды
Naasley	Млекопитающие
Maroodi	Слон
Quraansho	Муравьи
Shini	Пчёлы
Software	Программное обеспечение
Af-Holandees	Нидерландский язык
DNA	Дезоксирибонуклеиновая кислота
Nuucyada dhirta	Биологический вид
Hooyo	Мать
Aabe	Отец
Waalid	Родители
Gaadiidka Dadweynaha	Транспорт
Debian	Debian
1669	1669 год
1670	1670 год
1671	1671 год
1672	1672 год
1673	1673 год
1674	1674 год
1675	1675 год
1676	1676 год
1677	1677 год
1678	1678 год
1679	1679 год
1680	1680 год
1856	1856 год
Af-Ruush	Русский язык
Faladimir Putin	Путин, Владимир Владимирович
Dastuur	Конституция
Dalalka Kommonwels	Содружество наций
OPEC	Организация стран — экспортёров нефти
Rooti	Хлеб
UNESCO	ЮНЕСКО
Baaqa Caalamiga ee Xuquuqda Aadanaha	Всеобщая декларация прав человека
1796	1796 год
1797	1797 год
1899	1889 год
Sawaaxili	Суахили
1893	1893 год
Unug	Клетка
Dhiig	Кровь
Qolfoof	Скелет
Sambab	Лёгкие
Hab Neefsi	Дыхательная система
Habdhiska Taranka	Репродуктивная система
Af-Romani	Румынский язык
Roob	Дождь
Dhulgariir	Землетрясение
Ibn Siinaa	Ибн Сина
Nelson Mandela	Мандела, Нельсон
Martin Luther King,	Кинг, Мартин Лютер
Ensiim	Ферменты
Borotiin	Белки
Daad	Наводнение
Tsunami	Цунами
Fulkaano	Вулкан
Caad	Облака
Tirignoometeri	Тригонометрия
Joomitiri	Геометрия
Qarnigii 2aad	II век
Qarnigii 1aad	I век
Dhaqaale	Экономика (наука)
Warshad	Промышленность
Farta laatiinka	Латинский алфавит
Suugaan	Литература
Category:Faransiiska	Категория:Франция
Category:Muusig	Категория:Музыка
Kun Habeen Iyo Habeen	Тысяча и одна ночь
Category:Suugaanta	Категория:Литература
Category:Gabayada	Категория:Поэзия
Waxbarasho	Образование
Qoys	Семья
Hugo Chavez	Чавес, Уго
Nin	Мужчина
Guur	Брачный союз
Midab Takoor	Расизм
Adoon	Рабство
Dagaal Sokeeye	Гражданская война
Cumar	Умар ибн аль-Хаттаб
Suldaan Suleymaan kan 1aad	Сулейман I
Bun	Кофе
Caano	Молоко
Buur	Гора
Salaaxudiin al-Ayyuubi	Салах ад-Дин
Karaaji	Карачи
Riyaal Madrid	Реал Мадрид (футбольный клуб)
Dagaalkii qaboobaa	Холодная война
Seoul	Сеул
Tomas Edison	Эдисон, Томас Алва
Michael Faraday	Фарадей, Майкл
Internet protocol	IP
HTML	HTML
Af-Iswiidhan	Шведский язык
Muxamed bin Muuse al-Khwarizmī	Аль-Хорезми
Karl Marx	Маркс, Карл
Nabi Muuse C.S.	Моисей
Aqoon	Знание
Naas	Женская грудь
Atom	Атом
Ileys	Свет
Af Giriig	Греческий язык
Operating system	Операционная система
Naf	Душа
Af-Faarsi	Персидский язык
Diin	Религия
Nabi Ibraahiim C.S.	Авраам
Saladh	Салат (блюдо)
Yuhuuda	Иудаизм
Af-Hebrow	Иврит
Ibn Khalduun	Ибн Хальдун
Beer (xubin)	Печень
Bakeyle	Кролики
Cilminafsi	Психология
Badweyn	Океан
Gootama buuda	Будда Шакьямуни
Muxamed	Мухаммед
BBC	Би-би-си
Shahrukh Khan	Хан, Шахрух
Al-Ghazaali	Абу Хамид аль-Газали
Gerald Ford	Форд, Джеральд Рудольф
Shiica	Шииты
Suufi	Суфизм
Carab	Язык (анатомия)
Chelsea FC	Челси (футбольный клуб)
Arsenal F.C.	Арсенал (футбольный клуб, Лондон)
Ganac	Поджелудочная железа
Qolfoofta Dadka	Скелет человека
Qoor	Шея
Af	Рот
Sakaar	Грудная клетка
Elizabeth II	Елизавета II
Caajiska	Переутомление
Schiphol	Схипхол
Haarlem	Харлем
Ronald Reagan	Рейган, Рональд
Af-Zulu	Зулу
Foosto	Бочка
Sabool	Бедность
Gordon Brown	Браун, Гордон
Jadwalka Curiyayaasha	Периодическая система химических элементов
Robert Mugabe	Мугабе, Роберт
Xamaam(Shinbir)	Голубиные
Bakteeri	Бактерии
Geed	Дерево
Canab	Виноград (ягода)
Malab	Мёд
Hilib	Мясо
Barandho	Картофель
Sonkor	Сахар
Khudaar	Овощи
Robot	Робот
Makiinad	Машина
Saxaafad	Журналистика
Taleefoon	Телефон
Dhaqan	Культура
RNA	Рибонуклеиновая кислота
Xidigisyahan	Астроном
Habdhiska Wareega Dhiiga	Кровообращение
Mindhicirka weyn	Толстая кишка
Mindhicirka yar	Тонкая кишка
Ibn Haytham	Ибн аль-Хайсам
Isku dhis	Химическое соединение
Sharci dajinta	Законодательная власть
Windows 7	Windows 7
Boqolleey	Процент
Windows Vista	Windows Vista
Fidel Castaro	Кастро, Фидель
Category:Barasiil	Категория:Бразилия
Tamar	Энергия
Abala-abalayn bayoloji	Система органического мира
Awood	Сила
Cufisjiidad	Гравитация
Cuf	Масса
Bir	Металлы
Hawo	Газ
Dareere	Жидкость
Adke	Твёрдое тело
Bushkuleeti	Велосипед
Markab	Судно
Beeraha	Сельское хозяйство
Cudbi	Хлопок
Tiknolajiga nano	Нанотехнология
Xaansho	Бумага
Bac	Пластмассы
Bed	Площадь
Lambar	Число
Kiilogaraam	Килограмм
Cristiano Ronaldo	Криштиану Роналду
Mitir	Метр
Ilbiriqsi	Секунда
Galley	Кукуруза сахарная
Kelvinka	Кельвин
Dalalka	Алфавитный список стран и территорий
Ludwik Lejzer Zamenhof	Заменгоф, Людвик Лазарь
Mesobotaamiya	Месопотамия
Buti	Медвежьи
Britney Spears	Спирс, Бритни
Habdhiska Dheefshiidka	Пищеварение
Habka Samayska Cuntada	Фотосинтез
Kansar	Злокачественная опухоль
Boqortooyo	Король
Qamadi	Пшеница
Kalandar	Календарь
Dhagool	Нарушение слуха
Cudur	Болезнь
Niikotiin	Никотин
Malaariyo	Малярия
Cunto xumida	Недоедание
Benseliin	Бензилпенициллин
Nantes	Нант
AIDS	ВИЧ-инфекция
Sokorow	Сахарный диабет
Template:Location map Yemen	Шаблон:ПозКарта Йемен
Mona Lisa	Мона Лиза
Horgale (Fiisikis)	Международная система единиц
Burj Khalifa	Бурдж-Халифа
Gidaarka Shiinaha	Великая Китайская стена
Abyoone	Целое число
Kubad	Сфера
Dawladii Cabaasiyiinta	Аббасидский халифат
Dawlada Cosmaniya	Османская империя
Koronto	Электричество
Seef	Меч
Pawlo Kuwelho	Коэльо, Пауло
Stephan El Shaarawy	Эль-Шаарави, Стефан
Liin	Апельсин
Af-Soomaali	Сомалийский язык
Aljaziira	Аль-Джазира
Hal-xeraale	Головоломка
Carabi	Арабский язык
Xorta ah	Свободный контент
Baar	Пальмовые
Dollar	Доллар
Ra'iisul wasaare	Премьер-министр
Araga	Оптика
Calan	Флаг
Qalin Qori	Карандаш
Saabaan	Мебель
Template:Location map Sudan	Шаблон:ПозКарта Судан
Template:Location map Eritrea	Шаблон:ПозКарта Эритрея
Template:Location map Ethiopia	Шаблон:ПозКарта Эфиопия
Template:Location map Djibouti	Шаблон:ПозКарта Джибути
Template:Location map Somalia	Шаблон:ПозКарта Сомали
Template:Location map Nigeria	Шаблон:ПозКарта Нигерия
Template:Location map Uganda	Шаблон:ПозКарта Уганда
Geri	Жираф
Faruur	Губы
Shaarbo	Усы
Midowga Sofiyet	Союз Советских Социалистических Республик
Qolofta kore ee Dhulka	Земная кора
Lil Wayne	Лил Уэйн
FC Bayern München	Бавария (футбольный клуб)
Queen	Queen
Kanye West	Уэст, Канье
Huguri	Горло
Wikipedia:Maqaallo Xul Ah	Википедия:Избранные статьи
Maalmaha	День
Aduunka	Мир (Земля)
Wikipedia:Goob	Википедия:Форум
Nanjing	Нанкин
Mayotte	Майотта
Goobo	Окружность
Cesc Fàbregas	Фабрегас, Сеск
Mobile	Сотовый телефон
Goronyo	Страус
Kuuriya	Корея
Manchester	Манчестер
1000	1000 год
999	999 год
Yeey	Волк
1955	1955 год
1954	1954 год
1953	1953 год
1951	1951 год
1950	1950 год
1946	1946 год
1943	1943 год
1942	1942 год
1940	1940 год
1939	1939 год
1938	1938 год
1937	1937 год
1936	1936 год
Manchester United FC	Манчестер Юнайтед
1935	1935 год
1934	1934 год
Axdiga Cusub	Новый Завет
Qafqaas	Кавказ
Sagaal	9 (число)
Dabaqaroof	Скорпионы
Koobka Adduunka	Чемпионат мира по футболу
Boolo	Пеликаны
Macdin Alkaliini ah	Щелочные металлы
Macdin dhuleed ah	Щёлочноземельные металлы
Rafael Correa	Корреа, Рафаэль
Transitional Metal	Переходные металлы
Bir la Mood	Полуметаллы
Bir Ma Ahe	Неметаллы
Guruubka 17	Галогены
Neefta Gobta	Благородные газы
5	5 год
4	4 год
3	3 год
Boqorad	Царствующая королева
2	2 год
Buqarest	Бухарест
Louvre	Лувр
Motorhead	Motörhead
Dameer	Домашний осёл
Wikipedia:Maqaal Cusub	Википедия:Хорошие статьи
6	6 год
Axdigii Hore	Ветхий Завет
Saddax-xagal	Треугольник
Lady Gaga	Леди Гага
Luqada Hindo Yurub	Индоевропейские языки
Breinigerberg	Брайнигерберг
Muammar Qadaafi	Каддафи, Муаммар
Shabeel	Тигр
Francesco Totti	Тотти, Франческо
PSY	PSY
Nissan	Nissan
Booyad	Автомобиль-цистерна
Walhade	Маятник
Samsung	Samsung
Skandinafiyen	Скандинавия
Aruba	Аруба
Smartphone	Смартфон
Shidaal	Нефть
Isuduwe Habka Juqraafiga	Географические координаты
Banki	Банк
1	1 год
10	10 год
20	20 год
30	30 год
Abkhazia	Абхазия
40	40 год
9	9 год
7	7 год
8	8 год
Todoba	7 (число)
Sideed	8 (число)
Todobaad	Неделя
Deero	Оленевые
Baraf	Лёд
Toon	Чеснок
Musée d'Orsay	Музей Орсе
Anthroboloji	Антропология
Badacas	Красное море
13	13 год
Koonfur Ossetia	Южная Осетия
Ulan Bator	Улан-Батор
51	51 год
Jasiirad	Остров
Cad	Белый цвет
Madaw	Чёрный цвет
37	37 год
900	900 год
Lordi	Lordi
Basal	Лук репчатый
Lix	6 (число)
700	700 год
Yaanyo	Томат
George H. W. Bush	Буш, Джордж Герберт Уокер
68	68 год
89	89 год
11	11 год
Quang Binh	Куангбинь
Entrena	Энтрена
Dhulbare	Экватор
NASA	НАСА
Benito Mussolini	Муссолини, Бенито
15	15 год
14	14 год
17	17 год
500	500 год
150	150 год
Qaamuus	Словарь
Bermuda	Бермудские Острова
Madax	Голова
Wellington	Веллингтон
23	23 год
800	800 год
Heesta qaranka	Государственный гимн
42	42 год
Afarta jiho	Стороны света
18	18 год
Nuurad	Известняк
19	19 год
16	16 год
21	21 год
26	26 год
41	41 год
32	32 год
33	33 год
Falastiin	Палестина
Valletta	Валлетта
200	200 год
38	38 год
43	43 год
39	39 год
24	24 год
79	79 год
61	61 год
104	104 год
29	29 год
102	102 год
100	100 год
Haramcad	Гепард
Afarta xilli	Времена года
101	101 год
105	105 год
108	108 год
Dhuxul Dhagax	Ископаемый уголь
22	22 год
46	46 год
25	25 год
153	153 год
156	156 год
31	31 год
28	28 год
Liverpool	Ливерпуль
85	85 год
88	88 год
76	76 год
54	54 год
60	60 год
47	47 год
Guumees	Совообразные
Nederlaan Antiilis	Нидерландские Антильские острова
Bahda Bisada	Кошачьи
Ambeer	Ампер
Isotope	Изотопы
Göteborg	Гётеборг
Culeys	Вес
Geed Timir	Финик пальчатый
Burris	Молоток
Racibórz	Рацибуж
Odense	Оденсе
Kobe Bryant	Брайант, Коби
Luqadaha Berberiga	Берберские языки
600	600 год
400	400 год
300	300 год
Tilburg	Тилбург
Dayax gacmeed	Искусственный спутник Земли
Taylor Swift	Свифт, Тейлор
Khaalid bin Waliid	Халид ибн аль-Валид
Bariga Afrika	Восточная Африка
Bartamaha Ameerika	Центральная Америка
Af-Cafari	Афарский язык
Magrib	Магриб
Amxaari	Амхарский язык
36)	36 год
Tin	Волосы
Wareeg	Периметр
Dhicis	Выкидыш
Dhar	Текстиль
Kacdoonka masar	Революция в Египте (2011)
Willis Tower	Уиллис-тауэр
Kacbada	Кааба
Beatriks	Беатрикс
Isuzu	Isuzu
Dublad	Воронка
159	159 год
107	107 год
103	103 год
152	152 год
240	240 год
197	197 год
70	70 год
Duqa	Мэр
81	81 год
69	69 год
87	87 год
65	65 год
66	66 год
67	67 год
55	55 год
34	34 год
44	44 год
35	35 год
64	64 год
151	151 год
155	155 год
50	50 год
260	260 год
45	45 год
49	49 год
230	230 год
Zhengzhou	Чжэнчжоу
154	154 год
52	52 год
82	82 год
84	84 год
73	73 год
72	72 год
62	62 год
71	71 год
75	75 год
74	74 год
83	83 год
78	78 год
77	77 год
90	90 год
80	80 год
91	91 год
190	190 год
109	109 год
53	53 год
270	270 год
Madaxweyne	Президент
63	63 год
86	86 год
401	401 год
99	99 год
98	98 год
110	110 год
137	137 год
138	138 год
140	140 год
130	130 год
210	210 год
220	220 год
Dell	Dell
180	180 год
158	158 год
157	157 год
106)	106 год
48	48 год
97	97 год
Yuumbi	Марлиновые
56	56 год
93	93 год
Alofi	Алофи (Ниуэ)
57	57 год
Jamestown	Джеймстаун (остров Святой Елены)
Walaal	Сиблинги
170	170 год
171	171 год
172	172 год
58	58 год
59	59 год
139	139 год
134	134 год
135	135 год
96)	96 год
92	92 год
133	133 год
176	176 год
131	131 год
Fowdo	Анархия
Jasiirad Dhuleedka Carabta	Аравийский полуостров
250	250 год
280	280 год
290	290 год
Mindi	Нож
Masaajid	Мечеть
Akon	Эйкон
Dumnad	Домино
174	174 год
International Standard Book Number	Международный стандартный книжный номер
132	132 год
178	178 год
Luqadaha Tashaadiga	Чадские языки
Drake	Дрейк (певец)
Luqadaha Kushiitiga	Кушитские языки
Afguri	Диалект
95	95 год
94	94 год
257	257 год
Biriq	Молния
Gacan	Кисть (анатомия)
Luqadaha Omotik	Омотские языки
Af-Oromo	Оромо (язык)
Caleen	Лист
Jilaa	Актёр
Niue	Ниуэ
Luqadaha Semitiga	Семитские языки
Justin Bieber	Бибер, Джастин
Xusni Mubaarak	Мубарак, Хосни
Af-Tigrinya	Тигринья
Af-Tigre	Тигре (язык)
Dhululubo	Цилиндр
Subag	Сливочное масло
Yaasir Carafaat	Ясир Арафат
Fara-ka hadal	Жестовые языки
136	136 год
Injiil	Евангелие
Alexander Graham Bell	Белл, Александр Грейам
Tasmaniya	Тасмания
Rotterdam	Роттердам
Saabuun	Мыло
Cabdillahi ibn Cabdi al Mudalib	Абдуллах ибн Абд аль-Мутталиб
Mošovce	Мошовце
Zeyd Binu Xaaritha	Зейд ибн Хариса
Shakira	Шакира
Jaamacadda Oxford	Оксфордский университет
Maxamuud Axmadinajaad	Ахмадинежад, Махмуд
CD	Компакт-диск
Al-Qaacida	Аль-Каида
Maxamed Al-faatex	Мехмед II
Jeer	Обыкновенный бегемот
Far	Палец
Furaat	Евфрат
Gacanka Faarsiga	Персидский залив
Cilmiga bulshada	Общественные науки
Somaliland	Сомалиленд
Ciida sanadka cusub	Новый год
Babaay	Папайя
Brisbane	Брисбен
Fiitamiin	Витамины
Towraad	Тора
Koonfur Joorjiya iyo Koonfurta Jasiiradaha Sanwij	Южная Георгия и Южные Сандвичевы Острова
Maahmaah	Пословица
Noemi	Ноэми (певица)
Website	Сайт
Ido	Идо
Sumeer	Шумер
Kolonbo	Коломбо
Dariishad	Окно
Medina	Медина
Akkadiyaan	Аккадский язык
Booliis	Полиция
UEFA	УЕФА
Tigris	Тигр (река)
Koonfur Australia (gobol)	Южная Австралия
Baarlamaan	Парламент
Maatar	Материя (физика)
Jaamacadda Cambridge	Кембриджский университет
Fulinta (Dawlad)	Исполнительная власть
Hurdo	Сон
Neefta	Бронхиальная астма
Doon	Лодка
Queensland	Квинсленд
Mohammed ali Clay,	Али, Мохаммед
Beyoncé Knowles	Бейонсе
Urur	Множество
Siligo	Силиго
Riyo	Сновидение
Bur	Мука
Dhigaha	Долгота
Kimikal dibusocod	Химическая реакция
Den Haag	Гаага
Goriila	Гориллы
Daylight saving time	Летнее время
Daanta galbeed	Западный берег реки Иордан
Maraykanka assalkoodii	Индейцы
Siinaa	Синайский полуостров
Albaab	Дверь
Rihanna	Рианна
Hargab Doofaar	Свиной грипп
Cinjo	Ногти
Ugaadhsi	Охота
Toshiro Mifune	Мифунэ, Тосиро
Waji	Лицо
Aleksander Fileming	Флеминг, Александр
Musmaar	Гвоздь
Nabi Suleymaan C.S.	Соломон
Yahoo	Yahoo!
AK-47	Автомат Калашникова
Mowjad	Волна
Dhexroor	Диаметр
Bare	Учитель
Internet Movie Database	Internet Movie Database
Dalai Lama	Далай-лама
Jilib (xubin)	Коленный сустав
ISO 4217	ISO 4217
Tomas hobis	Гоббс, Томас
Campora San Giovanni	Кампора-Сан-Джованни
Jirjiroole	Хамелеоны
Cusmaan bin Cafaan	Усман ибн Аффан
Jaandi	Сплав
Nafto	Дизельное топливо
Qare	Арбуз обыкновенный
Toban iyo shan	15 (число)
Rikter Cabir	Магнитуда землетрясения
Xamaas	ХАМАС
Ruhollah Khomeini	Хомейни, Рухолла Мусави
Rajab Dayib Erdogaan	Эрдоган, Реджеп Тайип
Mug	Объём
Jamaal Cabdinaasir	Насер, Гамаль Абдель
Bluetooth	Bluetooth
Cali	Али ибн Абу Талиб
Marinka Gaza	Сектор Газа
Cabitaan	Напиток
Qoori	Пляж
Qabaal	Эллипс
Hobart	Хобарт
Dayax Gacmeed	Космический аппарат
Doorashada	Выборы
Iskudhufasho	Умножение
Saxaraha Galbeed	Сахарская Арабская Демократическая Республика
Geeska Afrika	Африканский Рог
Lisa Gerrard	Джеррард, Лиза
Nabi Yaxye C.S.	Иоанн Креститель
Jennifer Lopez	Лопес, Дженнифер
Faraq	Вычитание
Breda (Netherlands)	Бреда
Shuban	Диарея
Nancy	Нанси
Honiara	Хониара
PH	Водородный показатель
Asiyriya	Ассирия
Qardhaas	Ромб
Xayla Siilaasi	Хайле Селассие I
Xalab	Алеппо
Big Ben	Биг-Бен
Dhererka Mowjadda	Длина волны
Nabi Daa'uud C.S.	Давид
Borussia Dortmund	Боруссия (футбольный клуб, Дортмунд)
Xidido	Корень
Mole	Моль
Frank Lampard	Лэмпард, Фрэнк
Qallal	Эпилепсия
Ramadaan	Рамадан
Baqal	Мул
Garaam	Грамм
Shahaadah	Шахада
Gacanka Cadmeed	Аденский залив
Beeraha laalaada	Висячие сады Семирамиды
Maas	Маас
Khadiija binti Khuweylad	Хадиджа бинт Хувайлид
Waraabe	Гиены
Sariir	Кровать
Madaxwayne kuxigeen	Вице-президент
Cilmibaadhis	Исследование
Faaranhaayt	Градус Фаренгейта
Dhuldaaqsiin	Саванна
Dhogor	Шерсть (материал)
Toobin	Конус
Daliban	Талибан
MP3	MP3
Ismaamulka Falastiin	Палестинская национальная администрация
.ke	.ke
Fernando Torres	Торрес, Фернандо
Gar	Борода
Nabi	Пророк
Derbi	Стена
SMS	SMS
Yaxaas	Настоящие крокодилы
Majladda Time	Time
Dhedig	Самка
Farabadne	Губоногие
Amedeo Avogadro	Авогадро, Амедео
Shambay	Лесной кот
Federaalka	Федеративное государство
Sedex Geesoodka Bermuda	Бермудский треугольник
Arjen Robben	Роббен, Арьен
Xamid Karzai	Карзай, Хамид
Lab	Самец
Rey mysterio	Рей Мистерио
Dayax madoobaad	Лунное затмение
Taxane	Матрица (математика)
Kayene	Кайенна
John Cena	Сина, Джон
Waran	Копьё
Dadqalato	Каннибализм
Busbus	Ветряная оспа
Dekad	Порт
Garoonka Diyaaradaha ee Bole	Боле (аэропорт)
Dadka Berberiga	Берберы
Afganbi	Государственный переворот
Burcad Badeed	Пиратство
RSS	RSS
Lacagta Meherka	Приданое
Barbaroole	Параллелограмм
Leeb	Стрела
Chris Paul	Пол, Крис
Awood Socota	Кинетическая энергия
Koor	Трапеция
Qaanso	Лук (оружие)
Amiibada	Амёба
Zlatan Ibrahimović	Ибрагимович, Златан
GSM	GSM
Dhaban	Щека
Saint-Denis	Сен-Дени (Реюньон)
Arsène Wenger	Венгер, Арсен
Baabiylooniya	Вавилония
Muslim	Мусульманин
Warqadda aqoonsiga	Идентификационные карты
Template:Commonscat	Шаблон:Commonscat
Qoorgooye	Менингит
399	399 год
Iidi Amiin Daada	Амин, Иди
Kayseri	Кайсери
CNN	CNN
Drogbaa	Дрогба, Дидье
Dhakhaatiirta Bilaaxuduudaa	Врачи без границ
Abwaan	Поэт
Manchester city	Манчестер Сити
Ilaahay	Тромс
John Dramani Mahama	Махама, Джон Драмани
Luqada Masaarida	Египетский язык
Nabi Ciise	Иса ибн Марьям
Cudurka Ebola	Геморрагическая лихорадка Эбола
Template:Taxobox	Шаблон:Taxobox
Carly Rae Jepsen	Джепсен, Карли Рэй
Toyota	Toyota
Osmose	Осмос
Af-Hawsa	Хауса (язык)
Saxan	Тарелка
Mwai Kibaki	Кибаки, Мваи
Jalaal Daalabaani	Талабани, Джаляль
Ismaaciil Cumar Geelle	Гелле, Исмаил Омар
Nuur Al-Maliki	Аль-Малики, Нури
Dileita Maxamed Dileita	Дилейта, Дилейта Мохамед
Mark Rutte	Рютте, Марк
Cumar Cabdirashiid Cali Sharmaarke	Шермарк, Омар Абдирашид Али
Axmed Dafutoglu	Давутоглу, Ахмет
Robinho	Робиньо
Bada Carbeed	Аравийское море
Dhircun	Фитофагия
Calanka Denmark	Флаг Дании
Jay-Z	Jay-Z
Yuusuf Alqardaawi	Аль-Кардави, Юсуф
Sahel	Сахель
Henry Kissinger	Киссинджер, Генри
Abu Hurayra	Абу Хурайра
Flums	Флумс
Nabi Aadam C.S.	Адам
Diego Milito	Милито, Диего
Habaryar	Тётка
Abti	Дядя
Shumac	Свеча
Wikipedia:Sharaxaada Maqaalada Xulka Ah	Википедия:Кандидаты в избранные статьи
Wikipedia:Sharaxaada Maqaalada Cusub	Википедия:Кандидаты в хорошие статьи
Dhalo	Бутылка
Raqay	Тамаринд
Shabeelada Tamil	Тигры освобождения Тамил-Илама
Qaangaadh	Взрослый
Enjerneer	Инженер
Gacanka Caqaba	Акаба (залив)
KwaZulu-Natal Province	Квазулу-Натал
Hilibcun	Плотоядные
AFC Ajax	Аякс (футбольный клуб, Амстердам)
Qaado	Ложка
VOIP	IP-телефония
Jibriil	Архангел Гавриил
Astaamayn	Пунктуация
Taksi	Такси
Soqotra	Сокотра (остров)
Timor	Тимор
Almere	Алмере
Xoor-dubbur	Скунсовые
Dooli	Домовая мышь
Suul	Большой палец
Mesut ozil	Озиль, Месут
Turki	Турки
Ukun	Яйцо (пищевой продукт)
HyperText	Гипертекст
Xeeb	Побережье
Ibb	Ибб
Lobamba	Лобамба
Walxaha	Период периодической системы
Magarete2	Маргрете II
Calanka jabuuti	Флаг Джибути
Xareed	Пресная вода
Calanka Suudaan	Флаг Судана
Daanyeer	Человекообразные обезьяны
Sodium Hydroxide	Гидроксид натрия
Xoolo	Сельскохозяйственные животные
Cirid	Дёсны
Chalcogen	Халькогены
Tufaax	Яблоня
Shakaal	Гипотенуза
Biniktojiin	Подгруппа азота
Lambedusa	Лампедуза
Manuel Neuer	Нойер, Мануэль
Jalmad	Чайник
Eris	Эрида (значения)
Wiz Khalifa	Уиз Халифа
Agool	Перхоть
Barfasoor	Профессор
Maydhax	Ксилема
Dhax kujir	Государства без выхода к морю
Andalus	Аль-Андалус
Sako	Закят
Dhadhan	Вкус
ICAO	Международная организация гражданской авиации
.so	.so
Western Cape Province	Западно-Капская провинция
Mario Balotelli	Балотелли, Марио
Qiiq	Дым
Eastern Cape Province	Восточно-Капская провинция
Cerebellum	Мозжечок
Haaruun Alrashiid	Харун ар-Рашид
Kaftan	Шутка
Funaanad	Футболка
IMMAGINE&POESIA	Живопись и поэзия
Tangent	Касательная прямая
Niisaabuur	Нишапур
Khilaafada Islaamka	Халифат
Cadan	Аден
Het Wilhelmus	Гимн Нидерландов
Mpumalanga Province	Мпумаланга
Northern Cape Province	Северо-Капская провинция
Mamawdsaw	Мамудзу
Gauteng Province	Гаутенг
Lug	Нога человека
Cagaarshow	Желтуха
Du gamla, Du fria	Гимн Швеции
Shaydaanimo	Сатанизм
Limpopo Province	Лимпопо (провинция)
LG	LG Group
Ogaden	Огаден
Alexandre Pato	Алешандре Пато
Wabiga Jubba	Джубба
Qooleey	Почтовый голубь
Wabiga Shabeelle	Уэби-Шабелле
Masago	Мойва
Marsho	Зубчатое колесо
Saynab bint Khuzayma	Зайнаб бинт Хузайма
Saynab bint Jahsh	Зайнаб бинт Джахш
Nabi Yuusuf	Иосиф Прекрасный
One Direction	One Direction
Mille	Растворитель
Ajay Devgan	Девган, Аджай
Herpesviruses	Герпесвирусы
Degmo	Дистрикт
Tomahok (gantaal)	Томагавк (ракета)
Dambas	Зола
Eduard Douwes Dekker	Доувес Деккер, Эдуард
Yuusuf Islaam	Кэт Стивенс
Kiyaawe	Гаечный ключ
Awood Kaydsan	Потенциальная энергия
Chris Brown	Браун, Крис
Aadan Cabdulle Cusmaan	Даар, Аден Абдулла Осман
Saylac	Сайла
Anopheles	Малярийные комары
Malawad	Прямая кишка человека
Universidade Federal da Bahia	Университет штата Баия
Calanka Soomaaliya	Флаг Сомали
Dhuuso	Метеоризм
Free State Province	Фри-Стейт
Maqal	Слух
Oorfane	Детский дом
Ubuc	Туловище
Meles Zenawi	Мелес Зенауи
Nicki Minaj	Ники Минаж
Wahaabi	Ваххабизм
Diffusion	Диффузия
DDT	ДДТ (инсектицид)
Cadnaan Oktaar	Октар, Аднан
Dheddin	Мирра (растение)
Ibrahim Affelay	Афеллай, Ибрагим
Angry Birds	Angry Birds
Daango	Попкорн
Qalin	Ручка (канцелярия)
Aadaan	Азан
Usher	Ашер (певец)
Hummaag noqod	Отражение (физика)
North West Province	Северо-Западная провинция (ЮАР)
Lelystad	Лелистад
Midabada Asaasiga	Основные цвета
Isnidaamis	Чесотка
Daaf	Конъюнктивит
CAF	Африканская конфедерация футбола
Hargeysa	Харгейса
Nabiyada Islaamka	Пророк в исламе
Xijaas	Хиджаз
Filibs	Philips
Kaliber	Калибр
Geed Hindi	Ним (дерево)
Jidh	Тело (биология)
Qosol	Смех
Nektar	Нектар (сахаристый сок)
Mount kenya	Кения (гора)
Uunsi	Ладан
Jomo Kenyatta	Кениата, Джомо
Gacan (Joomitiri)	Радиус
Centimetre	Сантиметр
Millimeter	Миллиметр
Baadiye	Сельская местность
Portal:Taariikh	Портал:История
Hunguriga neefta	Трахея
Bowdo	Бедренная кость
Qaamo-qashiir	Эпидемический паротит
Tiirarka Islaamka	Пять столпов ислама
Fanaan	Певец
Huulaaku Khan	Хулагу
Wadan soo kobcooyo	Развивающиеся страны
Dhuxul	Древесный уголь
Shansho	Большеберцовая кость
Saac (faah faahin)	Наручные часы
Soon	Ураза
Alchemist(Buug)	Алхимик (роман)
The Notorious B.I.G.	The Notorious B.I.G.
Sanab	Статуя
Saadiyom bicarbonate	Гидрокарбонат натрия
Nabi Ayuub C.S.	Иов
Fatima bint Muxamed	Фатима Захра
Baras	Витилиго
Sumad xisaabed	Таблица математических символов
Daan	Челюсть
Ricir	Позвонок
Qol	Комната
Dhado	Влажность
Curiye	Элемент
Mucaawiye bin Abii Sufyaan	Муавия I ибн Абу Суфьян
Xasan Nasrallaah	Насралла, Хасан
Mahathir Bin Maxamed	Махатхир Мохамад
Bidaar	Алопеция
Aafda tahriibka	Торговля людьми
KLM	KLM
Johan Rudolph Thorbecke	Торбеке, Йохан Рудольф
Gabareey-maanyo	Морская дева
Mitsubishi	Mitsubishi
Cashuura	Ашура
Tamaashiir	Мел
Memory card	Карта памяти
Daxal	Ржавчина
Will.i.am	Will.i.am
Saxaro	Навоз
Gaamur	Дёготь
UFC	Ultimate Fighting Championship
Pitbull	Pitbull
Aayad	Аят
Tariikhda Shiikh Axmed Yaasiin	Ясин, Ахмед
Saxaabi	Сахаба
Xaas	Жена
Gows	Моляры
Shanbal	Тарелка (музыкальный инструмент)
Harar	Харэр
Dhismaha websiteka	Веб-дизайн
Golcas	Газели
Abuu Xaniifa	Абу Ханифа
Ammonium	Аммоний
Session Initiation Protocol	SIP
Salafiya	Салафия
Berbera	Бербера
Botka internetka	Робот (программа)
Bergen op Zoom	Берген-оп-Зом
Mengista Xayle Maryam	Менгисту Хайле Мариам
Mowliidka Nebiga	Мавлид
Ciraaqi Diinaar	Иракский динар
Adenoviridae	Аденовирусы
Daniel arap Moi	Мои, Даниэль арап
Nabi Huud	Худ (пророк)
Ne-Yo	Ни-Йо
Sin	Тазобедренный сустав
Rajab	Раджаб
Axmed Binu Xambal	Ахмад ибн Ханбаль
Jirid	Транк
Sheybaar	Микроскоп
Peso (Arjantiina)	Аргентинское песо
Yamanta Koonfureed	Народная Демократическая Республика Йемен
Assur	Ашшур (город)
Decimetre	Дециметр
Sean paul	Шон Пол
Yazidi (yasiidi)	Езиды
Calanka somaliland	Флаг Сомалиленда
Soomaali Galbeed	Сомали (регион)
Shilin Kiinyaati	Кенийский шиллинг
Astaannta Qaranka ee Soomaaliya	Герб Сомали
Astaannta Qaranka ee Imaaraatka	Герб Объединённых Арабских Эмиратов
Velupillai Prabhakaran	Велупиллаи Прабхакаран
Federaaliisim	Федерализм
Biomolikule	Биомолекулы
Nabi Alyasac C.S.	Елисей
Birr	Эфиопский быр
Jaad	Кат
Cows	Газон
S-block	S-элементы
Dab Damis	Пожарный автомобиль
SliTaz	SliTaz
Kung fu	Кунг-фу
Maxamed Siyaad Barre	Барре, Мохамед Сиад
Salo	Сало (Финляндия)
Ívi Adámou	Адаму, Иви
Cafar	Афар (народ)
Saliid Macsaro	Кунжутное масло
Cumar Mukhtaar	Мухтар, Омар
Seey	Муж
Angalool	Раковина
Flo Rida	Флоу Райда
Eden Hazard	Азар, Эден
T.I.	T.I.
Budhcad badeeda geeska afrika	Сомалийские пираты
Ayaan Xirsi Cali	Хирси, Айаан Али
P-block	P-элементы
D-block	D-элементы
F-block	F-элементы
Cabdullaahi Yuusuf Axmed	Ахмед, Абдуллахи Юсуф
Ururka Dawladaha aan la aqoonsan Wali	Организация наций и народов, не имеющих представительства
Qof	Личность
Darawal	Водитель
Addimo-yaqaan	Ортопедия
Dhul (dhulka lagu socdo)	Пол (настил)
Faysal Bin Cabdil Caziiz	Фейсал ибн Абдул-Азиз Аль Сауд
Wadar	Сумма (математика)
Qormo saynis	Экспоненциальная запись
C.H	BC
Adam Levine	Левин, Адам
Al-Faatixa	Сура Аль-Фатиха
Al-Baqara	Сура Аль-Бакара
Hogaamiye Kooxeed	Полевой командир
T-pain	T-Pain
Anggun	Анггун
Carlos the Jackal	Рамирес Санчес, Ильич
Fatima	Фатима
Mombaaso	Момбаса
Alexa Internet	Alexa Internet
Sheekh Xasan Albanaa	Аль-Банна, Хасан
Daariq ibn Ziyaad	Тарик ибн Зияд
Seed	Сухожилие
Al-Ikhlas	Сура Аль-Ихлас
Suurad	Сура (Коран)
Xadiis	Хадис
Sunna	Сунна
Allaah	Аллах
Salaad	Намаз
Xaj	Хадж
Malag	Ангел
Astaannta Qaranka ee Kolombiya	Герб Колумбии
Xisbiga shacabka iyo xoriyada Holalnd	Народная партия за свободу и демократию
Qeshm	Кешм (остров)
Bukhaari	Мухаммад аль-Бухари
Dadka Soomaaliyeed	Сомалийцы
Haumea	Хаумеа (значения)
Dagaalkii sokeeye ee Soomaaliya	Гражданская война в Сомали
Jason Derulo	Деруло, Джейсон
Macrakadii Ceyn Jaaluut	Битва при Айн-Джалуте
Iskugeyn	Плюс
Akkad	Аккад (значения)
FIFA	ФИФА
Uumi	Пар
Iman model	Иман (модель)
Amina bint Wahb	Амина бинт Вахб
Maryama al-Qibtiyya	Мария аль-Кибтия
Xafsa bint Cumar	Хафса бинт Умар
Laf	Кость
Wayne Rooney	Руни, Уэйн
Al Hudaydah	Ходейда
Sheekh Shariif Axmed	Ахмед, Шейх Шариф
Kismaayo	Кисмайо
Beydaan	Индийский миндаль
R. Kelly	Ар Келли
Fool	Резцы
Lacey Duvalle	Дюваль, Лейси
Dhul Udug	Пунт
Nabi Yacquub C.S.	Иаков
Mariana Ximenes	Шименес, Мариана
Zubeyr bin Cawaam R.C	Аз-Зубайр ибн аль-Аввам
Imaam Nawawi	Мухйиддин ан-Навави
Imaamu Shaafici	Мухаммад аш-Шафии
Demba Ba	Ба, Демба
Xasan Guuleed Abtidoon	Аптидон, Хассан Гулед
K'naan	K’naan
Greyson Chance	Ченс, Грейсон
Cabdul-Qadir Jilani	Абдул-Кадир аль-Джилани
Cabdi Bile Cabdi	Биле, Абди
Cabdiqaasim Salaad Xassan	Абдулкасим Салад Хасан
Cabdirashiid Cali Sharma'arke	Шермарк, Абдирашид Али
Al-Shabaab	Харакат аш-Шабаб
Al Mahwit	Махвит
Al Mukalla	Эль-Мукалла
Sheekh Yaasir Al-Xabiib	Ясир аль-Хабиб
Imaam Maalik	Малик ибн Анас
Cody Simpson	Симпсон, Коди
Cabdullaahi Ciise	Исса, Абдуллахи
Madfac	Снаряд
Dagaalkii xoraynta ogaden	Война за Огаден (1977—1978)
Oromo	Оромо
Ibn Nafiis	Ибн ан-Нафис
Xasan Sheekh Maxamuud	Махмуд, Хасан Шейх
Rodolfo Graziani	Грациани, Родольфо
Maxamed Faarax Caydiid	Айдид, Мухаммед Фарах
Biyo baxa deg dega ah	Преждевременная эякуляция
Dhulka Talyaaniga ee Soomaaliya	Итальянское Сомали
Saytuun	Псидиум
Trey songz	Сонгз, Трей
Macawiis	Саронг
Nuuraddin Faarax	Фарах, Нуруддин
Compaq	Compaq
Nabi Saalax	Салих
Unimog	Unimog
Nabi Idriis	Идрис
Gob	Зизифус мавританский
Tooreey	Клинок
Boosaaso	Босасо
Dowladda federaalka kumeelgaarka	Переходное федеральное правительство Сомали
Axmed Deedat	Дидат, Ахмед
Nabi Dulkifli	Зуль-Кифль
Abu Bakr	Абу Бакр
Abuu Sufyaan	Абу Суфьян ибн Харб
Imaam Axmed Guray	Ахмед ибн Ибрагим аль-Гази
IHH	Фонд защиты прав и свобод человека и гуманитарной помощи (IHH)
Daahir Rayaale Kaahin	Дахир Риял Кахин
Timo Soini	Сойни, Тимо
Cali maxamed Geedi	Геди, Али Мохаммед
Marek Grechuta	Грехута, Марек
Jeddah	Джидда
Shukaansi	Ухаживание
Sacad bin Abii Waqaas	Саад ибн Абу Ваккас
Axmed Maxamed Maxamuud (Siilaanyo)	Силаньо, Ахмед
Nabi Haaruun C.S.	Харун
Afgooye	Афгойе
Xulka Qaranka Soomaaliya	Сборная Сомали по футболу
Woqooyi bari	Северо-Восточная провинция (Кения)
Cabdullaahi bin Cabbaas	Ибн Аббас
Masjid al-Aqsa	Мечеть аль-Акса
Dadka Tigriga	Тиграи
Computer Engineering	Компьютерная инженерия
Masjid al-Xaram	Мечеть аль-Харам
Taabici	Табиин
Nuur Xasan Xuseen	Хусейн, Нур Хасан
Astaanta Calanka Soomaaliya	Проснись, Сомали
Amxaaro	Амхара
Rayhana bint Zayd	Райхана бинт Зейд
Ta'izz	Таиз
Murgacasho	Растяжение связок
Calooleey	Триппа
Nabi Ismaaciil C.S.	Исмаил
Maxamed Xaaji Ibraahim Cigaal	Мухаммед Хаджи Ибрагим Эгаль
Aamina	Амина (значения)
Dibi	Вол
Paramore	Paramore
Tuur	Кифоз
Lafdhabar	Позвоночник
Luís Carlos Almeida da Cunha	Нани
Paris Saint-Germain FC	Пари Сен-Жермен
Ahlu sunno waljamaaca	Сунниты
Puntland	Пунтленд
Qureysh	Курайшиты
Masjidka Nabiga	Масджид ан-Набави
Dagaalkii uxud	Битва при Ухуде
Sambuus	Самса
Imaam Mujtahid Sheykhul-Islaam	Ибн Таймия
Bilaal ibn Ribaax	Билял ибн Рабах
Fiat 124	Fiat 124
Busteejo	Автовокзал
Galatasaray SK	Галатасарай (футбольный клуб)
Astaanta Calanka Jabuuti	Гимн Джибути
Baydhabo	Байдабо
G-Spot	G-точка
Naxariis iyo Nabadgelyo Korkiisa Ha Ahaato	Салават (гоноратив)
Sayid Maxamed Cabdulle Xassan	Саид Мохаммед Абдилле Хасан
Salmaan Alfaarisi	Салман аль-Фариси
Maxamed Cabdulaahi Maxamed	Абдуллахи Мохамед, Мохамед
Sheekh Maxamed Naasiruddiin Al-Albaani	Насируддин аль-Албани
Salaada Magrib	Магриб (молитва)
Bayt al-Faqih	Байт-эль-Факих
Baskin-Robbins	Baskin-Robbins
Haparanda	Хапаранда
Xisbiga Hantiwadaagga Kacaanka Soomaaliyeed	Сомалийская революционная социалистическая партия
Aakhiro	Жизнь после смерти
Dhuusamareeb	Дусамареб
Marka	Марка (Сомали)
Biciid	Ориксы
Eliana	Элиана
Hiiraan	Хиран
Astaannta Qaranka ee somaliland	Эмблема Сомалиленда
Dhulka Biritishka ee Soomaaliya	Британское Сомали
Wax soo saar	Продукция
Nabi Isxaaq C.S.	Исаак
Soomaaliweyn	Великое Сомали
Zamenhof	Заменгоф (значения)
Xidid	Сосуд
Shabeellaha Dhexe	Средняя Шабелле
Hanti maguurto	Недвижимость
Salaada Subax	Фаджр
Carta	Арта (город, Джибути)
Liiska dalalka dad ahaan	Список стран по населению
Mr. Lordi	Путаансуу, Томи
Bari (Gobol)	Бари (Сомали)
Wajeer	Ваджир
Adult Film Database	AFDb
Cali Mahdi Maxamed	Али Махди Мухаммед
Midowga Maxkamadaha Islaamiga	Союз исламских судов
Somaliland shilling	Сомалилендский шиллинг
UNICEF	ЮНИСЕФ
Behra	Бейра (антилопа)
Godeey	Годе
Abuu Cubeydah Caamir ibn Jaraax	Абу Убайда ибн аль-Джаррах
Sanaag	Санаг
Jigjiga	Джиджига
Salaada Casir	Аср
Salaada Cishe	Иша
Garoonka Diyaaradaha ee Da Nang	Дананг (аэропорт)
Cirbadii dhimashada	Leiurus quinquestriatus
Nansi Ajram	Аджрам, Нэнси
Nashiido	Нашид
Azania	Азания
Awdal	Аудаль
Bankiga Somaliland	Банк Сомалиленда
Baardheere	Бардере
Jasiiradaha Jubbada Hoose	Баджуни (острова)
Bari	Бари (значения)
Sedjibeke	Куб
Beledweyne	Беледуэйне
Garoowe	Гароуэ
Kilometer	Километр
Xaawo	Ева
Web feed	Новостная лента
Salaada Duhur	Зухр
YouPorn	YouPorn
Guraag	Гураге
Gaarisa	Гарисса
Eurobeat	Евробит
Sool	Соль (провинция)
York University	Йоркский университет
Buurta Xira	Хира (пещера)
Gedo	Гедо (Сомали)
Ajuuraan	Аджуран (государство)
Gaalkacyo	Галькайо
Guddi	Комитет
Togdheer	Тогдер
Galguduud	Галгудуд
Shabeellaha Hoose	Нижняя Шабелле
Mudug	Мудуг
Jubbada Hoose	Нижняя Джубба
Saxiixu Muslim	Сахих Муслим
Boorama	Борама
Reoviruses	Реовирусы
Wikipedia:Caawinaad	Википедия:Справка
Wikipedia:Tutorial	Википедия:Первые шаги
Miraha Mucjisada	Магический фрукт
Galmudug	Галмудуг
Canjeelo	Ынджера
Sunanka Abii Daawuud	Сунан Абу Давуда
Dawladii Mamaaliikta	Мамлюки
Poxviruses	Поксвирусы
Digri	Зикр
Burco	Буръо
Ajdjadajd	Джубаленд
Mandheera	Мандера
Cadaad	Акация сенегальская
Qabaa'ilka Soomaaliya	Население Сомали
Nabi Shuceyb	Шуайб
Budka Suflera	Budka Suflera
Buuhoodle	Буходле
Hobyo	Хобьо
Jamaame	Джамаме
Garbahaarey	Гарбахаррей
Murshid abad	Муршидабад
Laascaanood	Ласъанод
Eyl	Эйль
Saxiixul Bukhaari	Сахих аль-Бухари
Abuu Dar Alghafaari	Абу Зарр аль-Гифари
Calool	Желудок человека
Jubbada Dhexe	Средняя Джубба
Nugaal	Нугаль (провинция)
Internet Adult Film Database	Internet Adult Film Database
Ceres	Церера (значения)
Lambar Tubaxan	Троичная система счисления
Dagaalkii (2006–2009)	Сомалийская война
Ciidamada Qalabka Sida ee Masaarida	Египетские вооружённые силы
Dadka Tigrega	Тигре (народ)
Kaniini	Пилюля
26 Juun 1960	Государство Сомалиленд
Taleex	Талех
Liverpool FC	Ливерпуль (футбольный клуб)
Xariiqanta Cagaaran	Зелёная линия (Израиль)
Samo ku waar	Гимн Сомалиленда
Duurjoog	Humbug
Gobolada somaliland	Административное деление Сомалиленда
Tusbax	Субха
Raas Caseyr	Гвардафуй
Sacad bin Zeyd	Саид ибн Зейд
GCompris	GCompris
Mucaad Bin Jabal	Муаз ибн Джабаль
Jacfar Bin Abii Daalib	Джафар ибн Абу Талиб
Saynab bint Muxamed	Зайнаб бинт Мухаммад
Ciise (qabiil)	Исса (народ)
Sunanka ibnu Maajah	Сунан Ибн Маджа
Wikipedia:Safaarad	Википедия:Посольство
Dhoobley	Доблей
Naafto	Дизель
U qeybin	Деление (математика)
Samuel Eto'o	Это’о, Самюэль
Dhamaag	Garcinia livingstonei
RedTube	Redtube
Taariikhda Somaliland	История Сомалиленда
Shabiixa	Шабиха
Maakhir	Маахир
Ra'iisul wasaarayaashii Soomaaliya	Премьер-министр Сомали
Imtixaan	Экзамен
Agnes Monica	Агнес Моника
Ismaaciil	Исмаил (имя)
Sabuur	Забур (книга)
Farta Cismaaniya	Сомалийское письмо
Mustafa Maxamed	Мохамед, Мустафа
Ibn Mandhuur	Ибн Манзур
Category:Jarmal	Категория:Германия
Category:Talyaaniga	Категория:Италия
Category:Qaramada Midoobey ee Maraykanka	Категория:США
Category:Ruushka	Категория:Россия
Category:Midowga boqortooyada Britan	Категория:Великобритания
Category:Isbania	Категория:Испания
Category:Shiinaha	Категория:Китай
Category:Hindiya	Категория:Индия
Category:Sucuudiga	Категория:Саудовская Аравия
Category:Turki	Категория:Турция
Category:Koonfur Afrika	Категория:ЮАР
Category:Masar	Категория:Египет
Category:Iiraan	Категория:Иран
Category:Arjantiina	Категория:Аргентина
Category:Afqaanistan	Категория:Афганистан
Category:Austriya	Категория:Австрия
Category:Itoobiya	Категория:Эфиопия
Category:Ciraaq	Категория:Ирак
Category:Nederland	Категория:Нидерланды
Category:Bakistaan	Категория:Пакистан
Category:Boland	Категория:Польша
Category:Bortuqaal	Категория:Португалия
Category:Suudaan	Категория:Судан
Category:Iswisarland	Категория:Швейцария
Category:Fiyetnam	Категория:Вьетнам
Category:Shimbir	Категория:Птицы
Category:Fiisikis	Категория:Физика
Category:Bayoloji	Категория:Биология
Category:Kimisteri	Категория:Химия
Category:Taariikh	Категория:История
Category:Juqraafi	Категория:География
Category:Diin	Категория:Религия
Category:Ciyaaraha	Категория:Спорт
Category:Saynis	Категория:Наука
Category:Isgaadhsiin	Категория:Связь
Jamhuuriyadda Dimuqraadiga Soomaaliya	Демократическая Республика Сомали
Jabhadda Wadaniga Xoreynta Ogaadeenya)	Фронт национального освобождения Огадена
Wabiga Togdheer	Тог-Дер
Jilib	Джилиб
Hergab	Дымогарные трубы
Bolol	Домовой гриб
Railway Mogadiscio-Villabruzzi	Железная дорога Могадишо — Виллабруцци
Qardho	Кардо (город)
Ciidamada Midowga Afrika	АМИСОМ
Cabdiraxmaan bin Cawf	Абдуррахман ибн Ауф
Dalxa bin Cubeydilah R.C.	Тальха ибн Убайдуллах
Ciidamada Somaliland	Вооружённые силы Сомалиленда
Ras kambooni	Рас-Камбони
Luqmaan Alxakiim	Лукман
Cali Cadde	Али-Аддэ
Template:Box-footer	Шаблон:Box-footer
Nabi Nuux C.S.	Нух
Laas Geel	Лаас-Гааль
Nabi Luud C.S.	Лут
Aragtida doobnimada	Социальные проблемы
Muxaram	Мухаррам
Ciyaalmaamo	Мадзакон
Category:Filasoofiyada	Категория:Философия
Category:Cilminafsi	Категория:Психология
Category:Masiixiyad	Категория:Христианство
Category:Islaam	Категория:Ислам
Goronyo soomaaliyeed	Сомалийский страус
Garbisaar	Платок
Qoryooley	Корьолей
Doorashadii madaxtinimo ee somaliland 2010	Президентские выборы в Сомалиленде (2010)
Nabi Ilyaas	Ильяс
Dafo	Орлиные
Ramla bint Abi Sufyan	Рамля бинт Абу Суфьян
May 2013	Май 2013 года
Sunanka Nisaa'i	Сунан ан-Насаи
10-ka saxaabi ee Janada loogu bishaareeyay iyagoo nool	Ашара аль-мубашшира
Diig	Петух
Suxufi Ibraahim	Сухуф
Bankiga Dhexe ee Soomaaliya	Центральный банк Сомали
Ruqiya bint Muxamed	Рукайя бинт Мухаммад
Kobra	Кобра
Xaasaska Nebi Muxamed	Жёны пророка Мухаммеда
Ciidanka Booliska Soomaaliya	Полиция Сомали
Saldanadii Cadal	Адал
Nabi Zakariye C.S.	Закария
Umm Kaltuum bint Muxamed	Умм Кульсум бинт Мухаммад
Nabi Yuunus C.S.	Иона (пророк)
Dad	Народ
Ciidanka Soomaaliya	Вооружённые силы Сомали
Nuur ibn Mujaahid	Нур ибн Муджахид
Boon (firimbi)	Конх (музыкальный инструмент)
Awdalland	Авдаленд
Cuud	Бахур
Cayn	Айн (регион)
Khaatumo state	Хатумо
Cabdi Shakuur Sheekh Xassan Farax	Абди Шакур Шейх Хасан
Laan	Ветвь
Category:Dhaqan	Категория:Культура
Category:Tobaneeyada sano	Категория:Десятилетия
Category:Sanad	Категория:Годы
Category:Qaaradaha	Категория:Континенты
Sheikh Mukhtar Mohamed Hussein	Хусейн, Моктар Мухаммед
Sunanka Tirmidhi	Джами ат-Тирмизи
Degmooyinka arjentiin	Административное деление Аргентины
Portal:Cilmi Fallag	Портал:Астрономия
Portal:Juqraafi	Портал:География
Jagada Madaxwaynaha Somaliland	Список президентов Сомалиленда
Gunbur	Пирамида (геометрия)
Jano	Рай
Turunbo	Танбур
Ximan iyo xeeb	Химан и Хеб
Saami qumman	Соотношение
Anna Rita Del Piano	Дель Пиано, Анна Рита
Category:Wikipedia bots	Категория:Участники:Боты
XVideos	XVideos
Portal:Bulsho	Портал:Общество
Cufka atamka	Атомная масса
Hotmail	Hotmail
Wikipedia:Su'aal/Hordhac	Википедия:Форум/Вопросы
Wikipedia:Graphics Lab	Проект:Графическая мастерская
Wikipedia:Soo Bandhigga Sawirka Xulka	Википедия:Изображение дня
Template:Gradient	Шаблон:Градиент
Template:Wikipedialang	Шаблон:Wikipedialang
Category:Wadamada	Категория:Страны
Wikipedia:Maamulka	Википедия:Администраторы
Category:Shaqsiyadaad	Категория:Люди
Wikipedia:Requests for adminship	Википедия:Заявки на статус администратора
Wikipedia:Bots	Википедия:Бот
Category:Amin	Категория:Время
Category:Internet	Категория:Интернет
Caynaba	Айнабо
Category:Siyaasad	Категория:Политика
Category:Waxbarasho	Категория:Образование
Category:Araga	Категория:Оптика
Category:Fan	Категория:Искусство
Khaalid Yaasiin	Халид Ясин
Masar	Египет
Category:Filasoofiyaasha	Категория:Философы
Category:Doorashooyinka	Категория:Выборы
Template:Bot	Шаблон:Bot
Kanada	Канада
Category:Denmark	Категория:Дания
Category:Giriig	Категория:Греция
Category:Iswiidhan	Категория:Швеция
Category:Islofaakiya	Категория:Словакия
Wikipedia:Copyright	Википедия:Авторские права
Wikipedia:Ku saabsan	Википедия:Описание
Sheekooyinka soomaalida	Сомалийская мифология
Category:Dagaalada	Категория:Войны
Qolobaa Calankeed	Гимн Сомали
Category:Microsoft	Категория:Microsoft
Portal:Saynis	Портал:Наука
Wikipedia:Ogaysiiska Maamulka	Википедия:Форум администраторов
Wikipedia:Goob/Farsamo	Википедия:Форум/Технический
Template:Flagicon	Шаблон:Флаг
Category:Wadamada Yurub	Категория:Страны Европы
Category:Yurub	Категория:Европа
Wikipedia:Bogga Isticmaalaha	Википедия:Личная страница участника
Portal:Dhacdooyinka Hadda	Портал:Текущие события
Template:Documentation	Шаблон:Doc
Category:Delete	Категория:Википедия:Удаление страниц
Wikipedia:Ilaalinta badelka	Википедия:Правила защиты страниц
Wikipedia:Albaabka bulshada	Википедия:Портал сообщества
Category:Luqadaha wikipediyaasha	Категория:Википедия:Участники по языкам
Wikipedia:Shan walxood	Википедия:Пять столпов
Wikipedia:Userboxes	Википедия:Юзербоксы
Wikipedia:Saxiix	Википедия:Подписывайтесь на страницах обсуждения
Sung Jae-ki	Сон Джэги
Caa'isha binti Abiibakar	Аиша бинт Абу Бакр
Cimraan	Амран (значения)
Lo	Крупный рогатый скот
Ganacsi	Предпринимательство
Template:Softredirect	Шаблон:Soft redirect
Template:Tirtir	Шаблон:К быстрому удалению
Category:Teknooloji	Категория:Технология
Category:Afafka	Категория:Языки
Category:Kalandar	Категория:Календарь
Category:Wikipedia	Категория:Википедия
Wikipedia:Masuul la'aan guud	Википедия:Отказ от ответственности
Category:Pages with broken file links	Категория:Страницы со ссылками на отсутствующие файлы
Wikipedia:Tirakoob	Википедия:Статистика
Wikipedia:Xeerka Wiki	Википедия:Политика конфиденциальности
Template:Navbox	Шаблон:Navbox
Template:Xaqiiq	Шаблон:Нет источника
Portal:Siiro	Портал:Персоналии
Template:Tnavbar	Шаблон:Tnavbar
Template:Clear	Шаблон:Clear
Template:Nowrap	Шаблон:Nobr
Dawladda federaalka Soomaaliya	Федеральное правительство Сомали
Millan	Раствор
Wikipedia:Codsiga maamulka/Hordhac	Википедия:Заявки на статусы
Wikipedia:Maqaalada aan u baahan laheen	Википедия:Список статей, которые должны быть во всех языковых версиях
Category:Afrika	Категория:Африка
Category:Elektaroonig	Категория:Электроника
Category:Kitaabka quduska	Категория:Библия
Category:Buugta	Категория:Книги
Category:Bilaha	Категория:Месяцы
Template:Babel	Шаблон:Babel
Template:Reflist	Шаблон:Примечания
Category:Isbitaal	Категория:Больницы
Wikipedia:Soo bandhigida xogta	Википедия:Ссылки на источники
Wikipedia:Habka maqaalada Xulka Ah	Википедия:Что такое избранная статья
Template:Digniin	Шаблон:Предупреждение
Template:Gumud	Шаблон:Заготовка
Template:User ar-1	Шаблон:User ar-1
Template:See also	Шаблон:См. также
Template:User da-2	Шаблон:User da-2
Template:User da	Шаблон:User da
Template:User de	Шаблон:User de
Template:User de-1	Шаблон:User de-1
Template:User es	Шаблон:User es
Template:User de-3	Шаблон:User de-3
Template:User en-3	Шаблон:User en-3
Template:User en-1	Шаблон:User en-1
Template:User en-2	Шаблон:User en-2
Template:User en-4	Шаблон:User en-4
Template:User fi	Шаблон:User fi
Template:User en-0	Шаблон:User en-0
Template:User en	Шаблон:User en
Template:User de-2	Шаблон:User de-2
Template:User fi-1	Шаблон:User fi-1
Template:User fr-1	Шаблон:User fr-1
Template:User sk	Шаблон:User sk
Template:User fr-2	Шаблон:User fr-2
Template:User ja	Шаблон:User ja
Template:User ja-1	Шаблон:User ja-1
Template:User fr	Шаблон:User fr
Category:Aasiya	Категория:Азия
Category:Jili	Категория:Чили
Category:Ameerikada koonfureed	Категория:Южная Америка
Template:Intricate template	Шаблон:Эзотерика
Template:Mod	Шаблон:Mod
Template:User es-2	Шаблон:User es-2
Template:Country data Belgium	Шаблон:Флагификация/Бельгия
Category:Maalmaha usbuuca	Категория:Дни недели
Template:Country data Ethiopia	Шаблон:Флагификация/Эфиопия
Template:Country data Cuba	Шаблон:Флагификация/Куба
Template:Country data Kenya	Шаблон:Флагификация/Кения
Template:Country data Denmark	Шаблон:Флагификация/Дания
Template:Country data Bosnia and Herzegovina	Шаблон:Флагификация/БиГ
Template:Number of defined parameters	Шаблон:Количество определённых параметров
Template:Country data Norway	Шаблон:Флагификация/Норвегия
Template:Country data Argentina	Шаблон:Флагификация/Аргентина
Template:Image label	Шаблон:Метка изображения
Template:Country data Mexico	Шаблон:Флагификация/Мексика
Template:Country data Saudi Arabia	Шаблон:Флагификация/Саудовская Аравия
Template:Dalalka Afrika	Шаблон:Страны Африки
Template:Country data Iraq	Шаблон:Флагификация/Ирак
Template:Country data United Arab Emirates	Шаблон:Флагификация/ОАЭ
Template:Country data Australia	Шаблон:Флагификация/Австралия
Template:Sidebar	Шаблон:Боковая навигационная таблица
Template:Infobox Xooga Dalka Soomaaliyeed	Шаблон:Карточка вооружённых сил
Template:Country data Austria	Шаблон:Флагификация/Австрия
Template:Collapsible option	Шаблон:Опция скрытия
Template:Country data Nepal	Шаблон:Флагификация/Непал
Template:Country data Finland	Шаблон:Флагификация/Финляндия
Template:Country data Netherlands	Шаблон:Флагификация/Нидерланды
Template:Hatnote	Шаблон:Другое значение
Template:Maqaal Xul Ah	Шаблон:Избранная статья
Template:Country data Russian Federation	Шаблон:Флагификация/Россия
Category:Gaana	Категория:Гана
Category:User en	Категория:User en
Category:User en-2	Категория:User en-2
Template:Infobox	Шаблон:Карточка
Template:User eo	Шаблон:User eo
Template:User zh	Шаблон:User zh
Category:Farta	Категория:Алфавиты
Template:Template other	Шаблон:Template other
Template:Country data Italy	Шаблон:Флагификация/Италия
Template:Pp-template	MediaWiki:Protectedpagetext
Template:Min	Шаблон:Min
Category:Astaannta Qaranka	Категория:Гербы
Category:Beeraha	Категория:Сельское хозяйство
Template:Babel-4	Шаблон:Babel-4
Category:Dowladaha	Категория:Государство
Category:Bahda Midaysay Qoraxdu	Категория:Планеты Солнечной системы
Template:Country data Soviet Union	Шаблон:Флагификация/СССР
Template:Country data India	Шаблон:Флагификация/Индия
Category:Falastiin	Категория:Палестина
Category:Language user templates	Категория:Шаблоны участников:По языкам
Template:Navbox subgroup	Шаблон:Navbox subgroups
Template:Farac	Шаблон:Народ
Template:Category redirect	Шаблон:Переименованная категория
Template:Macluumaad Qof Madax Ah	Шаблон:Государственный деятель
Category:Kacaanka	Категория:Революционеры
Template:Border	Шаблон:Граница
Template:Country data Turkey	Шаблон:Флагификация/Турция
Category:Qoraaga	Категория:Писатели
Category:Jaamacadaha	Категория:Университеты
Wikipedia:Maxaan akoon usamaynayaa	Википедия:Регистрация
Template:Country data Nigeria	Шаблон:Флагификация/Нигерия
Template:Hidden begin	Шаблон:Начало скрытого блока
Template:Country data Malaysia	Шаблон:Флагификация/Малайзия
Template:User pt-1	Шаблон:User pt-1
Template:Infobox planet	Шаблон:Карточка планеты
Template:User nl	Шаблон:User nl
Template:Infobox website	Шаблон:Карточка сайта
Template:Image label end	Шаблон:Image label end
Template:Documentation subpage	Шаблон:Docpage
Template:Infobox number	Шаблон:Натуральное число
Template:Rtl-lang	Шаблон:Rtl-lang
Template:Please don't change this page	Википедия:Введение 2
Category:Dekedaha	Категория:Порты
Template:Lang-la	Шаблон:Lang-la
Template:Macluumaad askariga	Шаблон:Военный деятель
Template:User	Шаблон:User
Template:References	Шаблон:Нет ссылок
Template:Jadwal	Шаблон:Prettytable
Template:PD-because	Шаблон:PD-because
Template:Infobox former country	Шаблон:Историческое государство
Template:1	Шаблон:1
Template:Infobox Political post	Шаблон:Государственная должность
Template:Kaydka wadahadalka	Шаблон:Архив обсуждения
Portal:Fiisikis	Портал:Физика
Template:User de-0	Шаблон:User de-0
Template:Usbuuc	Шаблон:Неделя
Template:User fr-0	Шаблон:User fr-0
Template:Country data West Germany	Шаблон:Флагификация/ФРГ
Template:Hooyga Maqaalada	Шаблон:Индекс
Template:Hidden end	Шаблон:Конец скрытого блока
Category:Booliis	Категория:Полиция
Template:Fb	Шаблон:Футбол
Template:Astaamayn	Шаблон:Пунктуационные знаки
Template:Plain link	Шаблон:Plain link
Template:Country data Comoros	Шаблон:Флагификация/Коморы
Template:Geobox	Шаблон:Географический объект
Template:Dhintey	Шаблон:Death date
Template:High-risk	Шаблон:СИШ
Template:Country data Qadar	Шаблон:Флагификация/Катар
Template:Country data Ukrain	Шаблон:Флагификация/Украина
Template:Country data Pakistan	Шаблон:Флагификация/Пакистан
Template:User pt-0	Шаблон:User pt-0
Template:MainPageInterwikis	Шаблон:Интервики на заглавной
Template:Higgaad	Шаблон:Опечатки
Template:User pt-3	Шаблон:User pt-3
Template:User pt-2	Шаблон:User pt-2
Category:User sk	Категория:User sk
Category:User eo	Категория:User eo
Category:User ja	Категория:User ja
Category:User da-2	Категория:User da-2
Category:Ganacsi	Категория:Бизнес
Template:Correct title	Шаблон:Неверный заголовок
Category:User ar	Категория:User ar
Category:Jasiirad	Категория:Острова
Category:User da	Категория:User da
Category:User sk-N	Категория:User sk-N
Category:User de	Категория:User de
Category:User fi	Категория:User fi
Category:Nabiyada Islaamka	Категория:Исламские пророки
Category:Tiirarka Islaamka	Категория:Пять столпов ислама
Template:Country data Burundi	Шаблон:Флагификация/Бурунди
Template:Country data Germany	Шаблон:Флагификация/Германия
Template:Country data UK	Шаблон:Флагификация/Великобритания
Template:Color sample	Шаблон:Colorsample
Template:Lambarada	Шаблон:Числа
Category:User ja-1	Категория:User ja-1
Category:User ko	Категория:User ko
Template:Macluumaad	Шаблон:Изображение
Template:Gobollada Soomaaliya	Шаблон:Сомали в темах
Template:Biological classification	Шаблон:Биологическая классификация
Wikipedia:Babel	Википедия:Вавилон
Template:Help contents back	Шаблон:Help contents back
Category:Abwaanada	Категория:Поэты
Template:Sidebar with collapsible lists	Шаблон:Sidebar with collapsible lists
Category:Badaha	Категория:Моря
Template:No2	Шаблон:No2
Category:Ingiriiska	Категория:Англия
Template:Str ≥ len	Шаблон:Str ≥ len
Category:Taariikhda Soomaaliya	Категория:История Сомали
Leilani Leeane	Лиэн, Лейлани
Template:Country data Brazil	Шаблон:Флагификация/Бразилия
Template:Yes2	Шаблон:Yes2
Category:Ururada caalamiga ah	Категория:Международные организации
Category:Gobolada Soomaaliya	Категория:Провинции Сомали
Category:Juquraafiga Soomaaliya	Категория:География Сомали
Template:Country data Somaliland	Шаблон:Флагификация/Сомалиленд
Category:Madaxda Soomaaliya	Категория:Президенты Сомали
Category:Cilmiga bulshada	Категория:Общественные науки
Category:Wadamada Afrika	Категория:Страны Африки
Template:User da-3	Шаблон:User da-3
Template:User pt-4	Шаблон:User pt-4
Category:1542	Категория:1542 год
Fenerbahce SK	Фенербахче (футбольный клуб)
Template:Country data United States	Шаблон:Флагификация/США
Category:Farshaxanka	Категория:Художники
Template:Raadiyoow	Шаблон:Радиостанция
Wikipedia:Habaynta Maqaalada Cusub	Википедия:Кандидаты в хорошие статьи/К лишению статуса
Category:Dhirta	Категория:Деревья
Portal:Hiddaha iyo Dhaqanka	Портал:Культура
Wikipedia:Habaynta Maqaalada Xulka Ah	Википедия:Кандидаты в устаревшие избранные статьи
Portal:Baayooloji	Портал:Биология
Category:Juquraafiga Hindiya	Категория:География Индии
Category:Jilaaga	Категория:Актрисы
Category:Jabuuti	Категория:Джибути
Category:Ereteriya	Категория:Эритрея
Category:Kiinya	Категория:Кения
Category:Komoros	Категория:Коморы
Category:Libiya	Категория:Ливия
Category:Dhaqaalaha Soomaaliya	Категория:Экономика Сомали
Category:Lacagta	Категория:Валюты
Category:Webiyada	Категория:Реки
Category:Juquraafiga Jabuuti	Категория:География Джибути
Template:User pt	Шаблон:User pt
Category:Soomaaliya	Категория:Сомали
Category:Webiyada Soomaaliya	Категория:Реки Сомали
Template:DecreasePositive	Шаблон:Положительное падение
Category:Juquraafiga Yemen	Категория:География Йемена
Category:Magaalooyinka Yemen	Категория:Города Йемена
Template:Maanta	Участник:Box/Календарик
Template:Country data Djibouti	Шаблон:Флагификация/Джибути
Category:User nl	Категория:User nl
Category:Hay'ada laanqayrta cas	Категория:Красный Крест
Template:Country data Federated States of Micronesia	Шаблон:Флагификация/Микронезия
Category:Diffusion	Категория:Диффузия
Category:Suuriya	Категория:Сирия
Category:Qarniyada	Категория:Века
Category:Qarnigii 16aad	Категория:XVI век
Category:Qooriyada	Категория:Пляжи
Category:Filasoofiyaasha Jarmalka	Категория:Философы Германии
Category:Ciidanka Soomaaliya	Категория:Вооружённые силы Сомали
Category:Esoteric templates	Категория:Шаблоны:Эзотерические
Category:Harraha Afrika	Категория:Озёра Африки
Category:Madaxda Faransiiska	Категория:Президенты Франции
Category:Madaxda Iiraan	Категория:Президенты Ирана
Category:Norway	Категория:Норвегия
Category:Yemen	Категория:Йемен
Category:Malaay	Категория:Рыбы
Category:Mutolojiyada	Категория:Мифология
Category:Qaamuus	Категория:Словари
Category:Axdiga Cusub	Категория:Новый Завет
Category:Ilko	Категория:Зубы
Category:Dhaqanka Soomaalida	Категория:Культура Сомали
Category:Wikimedia	Категория:Викимедиа
Category:Radio	Категория:Радио
Category:Xayawaan	Категория:Животные
Category:Jamhuriyadda	Категория:Республики
Category:Jilaaga barasiiliyanka	Категория:Актрисы Бразилии
Category:Bartamaha Ameerika	Категория:Центральная Америка
Category:Caasimadaha	Категория:Столицы государств
Category:Magaalooyinka Hindiya	Категория:Города Индии
Category:Isgaarsiinta	Категория:Телекоммуникации
Category:Gaadiidka	Категория:Транспорт
Category:Ameerikada waqooyi	Категория:Северная Америка
Category:Harraha	Категория:Озёра
Category:Saxaabada	Категория:Сахабы
Category:Calamada	Категория:Флаги
Template:Flagcountry	Шаблон:Флагификация
Template:Macluumaad luqadda	Шаблон:Язык
Category:Dimoqraadi	Категория:Демократия
Kaaroot	Морковь посевная
Category:Caasimadaha afrika	Категория:Столицы Африки
Template:Infobox polygon	Шаблон:Многоугольник
Category:Komunistiyaasha Jarmalka	Категория:Коммунисты Германии
Category:Magaalooyinka Soomaaliya	Категория:Города Сомали
Category:Magaalooyinka Jabuuti	Категория:Города Джибути
Category:Guurka	Категория:Брак
Category:Aadam iyo Xaawo	Категория:Адам и Ева
Category:Lahjadaha looga hadlo Soomaaliya	Категория:Языки Сомали
Category:Caasimadaha yurub	Категория:Столицы европейских государств
Category:Somaliland	Категория:Сомалиленд
Template:Politics browsebar	Шаблон:Политические порталы
Template:Country data Puntland	Шаблон:Флагификация/Пунтленд
Template:Rounddown	Шаблон:Rounddown
Portal:Dhacdooyinka Hadda/Hooyga Wararka	Портал:Текущие события/News Browser
Portal:Dhacdooyinka Hadda/Dhacdooyinkii Dambe	Портал:Текущие события/Заголовки
Category:Caafimaadka	Категория:Здоровье
Xiriirka Turkiga-Soomaaliya	Сомалийско-турецкие отношения
Template:Country data Canada	Шаблон:Флагификация/Канада
Template:Convert/numdisp/frac	Шаблон:Convert/numdisp/frac
Template:Convert/numdisp/frac1	Шаблон:Convert/numdisp/frac1
Template:Country data Malawi	Шаблон:Флагификация/Малави
Template:Country data South Yemen	Шаблон:Флагификация/НДРЙ
Template:Country data Uganda	Шаблон:Флагификация/Уганда
Template:Country data Yemen	Шаблон:Флагификация/Йемен
Template:Lang-pl	Шаблон:Lang-pl
Category:Buuraha Soomaaliya	Категория:Горы Сомали
Category:Maamulada Soomaaliya	Категория:Государственные образования на территории Сомали
Portal:Xisaab	Портал:Математика
Trojany	Трояны (Мазовецкое воеводство)
Category:Wadamada Aasiya	Категория:Страны Азии
Category:Wikipedia uncategorized templates	Категория:Шаблоны:Некатегоризованные
Portal:Siyaasadda	Портал:Политика
Portal:Qaynuun	Портал:Право
Category:Abidjan	Категория:Абиджан
Tiirarka Iimaanka	Иман
Category:Antananarifo	Категория:Антананариву
Lug (xubin)	Голень
Category:Bamako	Категория:Бамако
Template:Colonne	Шаблон:Multicol
Eray bixin	Терминология
Category:Esperanto	Категория:Эсперанто
Template:Lang-am	Шаблон:Lang-am
Template:Lang-sv	Шаблон:Lang-sv
Category:Taariikhda Somaliland	Категория:История Сомалиленда
Khilaafadii Umawiyiinta	Омейядский халифат
Portal:Kimistari	Портал:Химия
Category:Linux	Категория:Linux
Category:Siyaasada Soomaaliya	Категория:Политика Сомали
Category:Komunistiyaasha	Категория:Коммунисты
Category:Qiyaasaha Masaafooyinka	Категория:Единицы измерения расстояния
Category:Midabada	Категория:Цвет
Category:Triboli	Категория:Триполи
Category:User nl-4	Категория:User nl-4
Category:Bahalada sheeko xariirka	Категория:Русалки
Template:Country data Somalia	Шаблон:Флагификация/Сомали
Template:Image label begin	Шаблон:Image label begin
Category:Suuradaha Qur'aanka	Категория:Суры Корана
Template:Tirada Maqaalada Cusub	Шаблон:Счётчик ХС
Category:User en-1	Категория:User en-1
Template:Turjumid	Шаблон:Закончить перевод
Portal:Caafimaad	Портал:Медицина
Template:Afarta xilli	Шаблон:Времена года
Kalagoyn	Минус
Template:User nl-3	Шаблон:User nl-3
Luqadaha Somaliland	Языки Сомалиленда
Template:Wayback	Шаблон:Wayback
Template:Significant figures	Шаблон:Sigfig
Template:Ku saabsan wikipedia	Шаблон:Википедия сейчас
Template:ForLoop/aux	Шаблон:For/aux
Template:For year month day	Шаблон:Продолжительность
Portal:Soomaaliya	Портал:Сомали
Template:Efn	Шаблон:Efn
Template:Man/default	Шаблон:Man/die.net
Parvoviruses	Парвовирусы
Wikipedia:Editnotice	Википедия:Editnotice
Template:Flagbig	Шаблон:Флагбол
Magaca Muuse	Моисей (имя)
Adnan Januzaj	Янузай, Аднан
Gobolada Soomaaliya	Провинции Сомали
Barkhad Cabdi	Абди, Бархад
Special:RecentChanges	Служебная:Свежие правки
Module:Navbox	Модуль:Navbox
Category:Wabiyada Afrika	Категория:Реки Африки
