ئافرىقا	Африка
ياپونىيە	Япония
جەنۇبىي ئامېرىكا	Южная Америка
نورۋېگىيە	Норвегия
Shotlandiye	Шотландия
Wélsh	Уэльс
ۋېنگرىيە	Венгрия
ئىسپانىيە	Испания
ئامېرىكا قوشما شىتاتلىرى	Соединённые Штаты Америки
بېلگىيە	Бельгия
ليۇكسېمبۇرگ	Люксембург
يەر شارى	Земля
گېئورگى ۋاشىنگتون	Вашингтон, Джордж
فىنلاندىيە	Финляндия
شۋېتسىيە	Швеция
دانىيە	Дания
لەھىستان	Польша
لىتۋا	Литва
ئىتالىيە	Италия
شۋېتسارىيە	Швейцария
ئاۋستىرىيە	Австрия
گرېتسىيە	Греция
تۈركىيە جۇمھۇرىيىتى	Турция
پورتۇگالىيە	Португалия
ياۋروپا	Европа
ئاسىيا	Азия
شىمالىي ئامېرىكا	Северная Америка
ۋىكىپېدىيە	Википедия
گوللاندىيە	Нидерланды
Nyu York Shehiri	Нью-Йорк
ۋاشىنگتون	Вашингтон (округ Колумбия)
San Fransisko	Сан-Франциско
Bérlin	Берлин
Los Anjélés	Лос-Анджелес
كومپيۇتېر	Компьютер
بېرن	Берн
Jenwe	Женева
سيۇرىخ	Цюрих
خەلقارالىق تور	Интернет
باراك ئوباما	Обама, Барак
ئۇرۇگۋاي	Уругвай
London	Лондон
كايرو	Каир
ئالما	Яблоко
پارىژ	Париж
مېكسىكا	Мексика
Kaliforniye Shitati	Калифорния
Boston	Бостон
مارس	Марс
كېنىيە	Кения
ئېفىئوپىيە	Эфиопия
گانا جۇمھۇرىيىتى	Гана
شىر	Лев
فرانسىيە	Франция
ئېسپېرانتو	Эсперанто
ئىت	Собака
بۈيۈك بېرىتانىيە	Великобритания
مۈشۈك	Кошка
جۇڭخۇا خەلق جۇمھۇرىيىتى	Китайская Народная Республика
فرانسۇز تىلى	Французский язык
برازىلىيە	Бразилия
روسىيە	Россия
قارا دېڭىز	Чёрное море
مانگو	Манго (фрукт)
Toronto	Торонто
Alabama Shitati	Алабама
San Pawlo	Сан-Паулу
Kwébék	Квебек
ۋىكىپېدىيە ۋەخپى	Фонд Викимедиа
جىمى ۋالىس	Уэйлс, Джимми
گېرمانىيە	Германия
بېلورۇسسىيە	Белоруссия
نېمىس تىلى	Немецкий язык
ئىسلاندىيە	Исландия
ئېستونىيە	Эстония
ساتۇرن	Сатурн
ئايروپىلان	Самолёт
جورج ۋولكېر بۇش	Буш, Джордж Уокер
لاتۋىيە	Латвия
ئۇكرائىنا	Украина
چېخ جۇمھۇرىيەتى	Чехия
سلوۋاكىيە	Словакия
سلوۋېنىيە	Словения
مولدوۋا	Молдавия
رۇمىنىيە	Румыния
بۇلغارىيە	Болгария
Rim	Рим
ماكېدونىيە	Республика Македония
ئالبانىيە	Албания
گرېنلاندىيە	Гренландия (административная единица)
كرودىيە	Хорватия
بوسنىيە ۋە ھېرسېگوۋىنا	Босния и Герцеговина
ئەزەربەيجان	Азербайджан
ئاندوررا	Андорра
سىپرۇس	Республика Кипр
گرۇزىيە	Грузия
قازاقىستان	Казахстан
مالتا	Мальта
موناكو	Монако
چېرنوگورىيە	Черногория
ۋاتىكان شەھىرى	Ватикан
سان مارىنو	Сан-Марино
Bryussél	Брюссельский столичный регион
كۇبا	Куба
بېلىز	Белиз
باربادوس	Барбадос
ئاممىباپ ئاپتوموبىل	Volkswagen
ھىندونېزىيە	Индонезия
Wolfgang Amadeus Mozart	Моцарт, Вольфганг Амадей
بىتخوۋىن	Бетховен, Людвиг ван
تۈرك تىلى	Турецкий язык
جەنۇبىي ئافرىقا	Южно-Африканская Республика
ئالجىرىيە	Алжир
ئۆزبېكىستان	Узбекистан
Poznan	Познань
Tashkent	Ташкент
Warshawa	Варшава
ياۋروۋىزىيون ناخشا مۇسابىقىسى	Конкурс песни Евровидение
تېلېۋىزور	Телевидение
ئىسلاندىيە تىلى	Исландский язык
چىلى	Чили
ئەيسا مەسىھ	Иисус Христос
گالىلېي	Галилей, Галилео
مېركۇرىي	Меркурий
تارىخ	История
ئالما شىركىتى	Apple
ۋېنېرا	Венера
مۇھاببەت	Любовь
يۇپىتېر	Юпитер
سامان يولى سىستىمېسى	Млечный Путь
ئۇران (پلانىت)	Уран (планета)
نىكولا ساركوزى	Саркози, Николя
نېپتۇن	Нептун
ئاسترونومىيە	Астрономия
سىنگاپور	Сингапур
پلۇتون	Плутон
Montréal	Монреаль
لىختېنشتېين	Лихтенштейн
Kambrij	Кембридж
Facebook	Facebook
بىرىنچى دۇنيا ئۇرۇشى	Первая мировая война
Kolon	Кёльн
سكوپليې	Скопье
Shchétsin	Щецин
لاتىن تىلى	Латинский язык
بەھرېيىن	Бахрейн
ئەرمېنىيە	Армения
سېربىيە	Сербия
Istanbul	Стамбул
ئاۋستىرالىيە	Австралия
فىزىكا	Физика
ئارگېنتىنا	Аргентина
پېرۇ	Перу
بىئولوگىيە	Биология
شىمالىي چاۋشيەن	Корейская Народно-Демократическая Республика
كامبوجا	Камбоджа
قۇرئان كەرىم	Коран
دىنوزاۋر	Динозавры
ئىسلام دىنى	Ислам
ليۇبليانا	Любляна
Lion	Лион
ياۋروپا ئىتتىپاقى	Европейский союз
سوفىيە	София
شېئىر	Поэзия
Milan	Милан
Turin	Турин
سوڭ	Анус
ئېۋېرېست	Джомолунгма
ﻧﺎﭘﻮﻟﯧﺌﻮﻥ ﺑﻮﻧﺎﭘﺎﺭﺕ	Наполеон I
ۋېزۇۋىي	Везувий
قۇياش	Солнце
قۇياش سىستېمىسى	Солнечная система
ھىدروگېن	Водород
گېلىي	Гелий
چىش	Зубы человека
لىتىي	Литий
بېرىللىي	Бериллий
شەرقىي تىمور	Восточный Тимор
ئوسلو	Осло
Bonn	Бонн
سېرېرا	Церера
لىسبون	Лиссабон
ئېرىدا	Эрида
دۇبائى	Дубай (эмират)
بور	Бор (элемент)
Wérsayl	Версаль (город)
كاربون	Углерод
ۋولگا دەرياسى	Волга
ئازوت	Азот
ئوكسىگېن	Кислород
مۇزىكا	Музыка
Wénitsiye	Венеция
Rénn Shehiri	Ренн
Lil	Лилль
Moskwa	Москва
فىتور	Фтор
ئىتاليان تىلى	Итальянский язык
نىئون گازى	Неон
Sankt-Pétérburg	Санкт-Петербург
چاد	Чад
ناترىي	Натрий
ماگنىي	Магний
ئاليۇمىن	Алюминий
يېڭى زېلاندىيە	Новая Зеландия
ھىندىستان	Индия
سىلىتسىي	Кремний
فرانسىي	Франций
Tuwalu	Тувалу
فوسفور	Фосфор
تۆمۈر	Железо
Ton’ga	Тонга
گۈڭگۈرت	Сера
ساموئا	Самоа
سولومون تاقىم ئاراللىرى	Соломоновы Острова
ۋانۇئاتۇ	Вануату
خلور گازى	Хлор
پاپۇئا يېڭى گۋىنېيە	Папуа — Новая Гвинея
پالاۋ	Палау
ئارگون	Аргон
ناۋرۇ	Науру
مىكرونېزىيە فېدېراتسىيىسى	Федеративные Штаты Микронезии
كالىي	Калий
كالتىسىي	Кальций
قوغۇشۇن	Свинец
مارشال تاقىم ئاراللىرى	Маршалловы Острова
كىرىباتى	Кирибати
موڭغۇلىيە	Монголия
فىجى	Фиджи
سكاندىي	Скандий
تىتان	Титан (элемент)
ۋېنېسۇئېلا	Венесуэла
چىڭگىزخان	Чингисхан
ۋانادىي	Ванадий
Méané Shitati	Мэн (штат)
خروم	Хром
ئات	Домашняя лошадь
ئامستېردام	Амстердам
ھايۋانات	Животные
سۇرىنام	Суринам
مانگان	Марганец
پاراگۋاي	Парагвай
گايانا	Гайана
ئېكۋادور	Эквадор
رېنىي	Рений
كولومبىيە	Колумбия
كوبالت	Кобальт
ۋولفرام	Вольфрам
نىكېل	Никель
بۇددا دىنى	Буддизм
بولىۋىيە	Боливия
مىس	Медь
ترىنىداد ۋە توباگو	Тринидад и Тобаго
سېنت ۋىنسېنت ۋە گرېنادىن ئاراللىرى	Сент-Винсент и Гренадины
سىنك	Цинк
Yéngi Xampishir Shitati	Нью-Гэмпшир
سېنت ليۇسىيە	Сент-Люсия
داۋېىنچى	Леонардо да Винчи
سېنت كىتس ۋە نېۋىس	Сент-Китс и Невис
زەمبۇرۇغ	Грибы
يامايكا	Ямайка
گرېنادا	Гренада
Massachuséts Shitati	Массачусетс
گۋاتېمالا	Гватемала
باھاما	Багамские Острова
Konnéktikat Shitati	Коннектикут
ئانتىگۇئا ۋە باربۇدا	Антигуа и Барбуда
Haway Shitati	Гавайи
ھوندۇراس	Гондурас
دومىنىكا	Доминика
دومىنىكان جۇمھۇرىيەتى	Доминиканская Республика
ھايتى	Республика Гаити
ئەل سالۋادور	Сальвадор
ئىران	Иран
ئىراق	Ирак
Alyaska Shitati	Аляска
كوستارىكا	Коста-Рика
ئىسرائىلىيە	Израиль
پاناما	Панама
يەمەن	Йемен
پولەك تىلى	Польский язык
ئىئوردانىيە	Иордания
نىكاراگۇئا	Никарагуа
Florida Shitati	Флорида
قىرغىزىستان	Киргизия
Arizona Shitati	Аризона
كۇۋەيت	Кувейт
لائوس	Лаос
لىۋان	Ливан
Orégon Shitati	Орегон
مالدىۋ ئاراللىرى	Мальдивы
ئامېرىكا قىتئەسى	Америка
Yuta Shitati	Юта
مالايسىيا	Малайзия
بىرما	Мьянма
نېپال	Непал
ئومان	Оман
پاكىستان	Пакистан
قاتار	Катар
سەئۇدى ئەرەبىستان	Саудовская Аравия
سرىلانكا	Шри-Ланка
ستالىن	Сталин, Иосиф Виссарионович
سۇرىيە	Сирия
بىراتۇ	Платон
گاللىي	Галлий
تاجىكىستان	Таджикистан
تەيۋەن	Китайская Республика
گېرمانىي	Германий
تايلاند	Таиланд
ئارسېن	Мышьяк
تۈركمەنىستان	Туркмения
سېلېن	Селен
ئەرەب بىرلەشمە خەلىپىلىكى	Объединённые Арабские Эмираты
بروم	Бром
Platina	Платина
ۋيېتنام	Вьетнам
Nowosibirski	Новосибирск
جەنۇبىي چاۋشيەن	Республика Корея
كرىپتون	Криптон
ئافغانىستان	Афганистан
رۇبىدىي	Рубидий
ئالتۇن	Золото
قازان	Казань
بانگلادېش	Бангладеш
مالى	Мали
ئانگولا	Ангола
بۇتان	Бутан
برۇنېي	Бруней
تانزانىيە	Танзания
فىلىپپىن	Филиппины
ئوتتۇرا ئافرىقا جۇمھۇرىيىتى	Центральноафриканская Республика
جەنۇبى قۇتۇپ	Южный полюс
شىمالى قۇتۇپ	Северный полюс
ئىسساك نيوتۇن	Ньютон, Исаак
ئالبېرىت ئېينىشتېين	Эйнштейн, Альберт
سترونتسىي	Стронций
ئىتترىي	Иттрий
ۋىسمۇت	Висмут
سېرىق رەڭ	Жёлтый цвет
توگو	Того
تۇنىس	Тунис
زامبىيە	Замбия
زىمبابۋې	Зимбабве
بېيجىڭ شەھىرى	Пекин
تۇۋا	Тыва
بېنىن	Бенин
بوتسۋانا	Ботсвана
بۇركىنا فاسو	Буркина-Фасо
بۇرۇندى	Бурунди
كومور ئاراللىرى	Коморы
كونگو جۇمھۇرىيىتى	Республика Конго
كونگو دېموكراتىك جۇمھۇرىيىتى	Демократическая Республика Конго
San Antonio	Сан-Антонио
جىبۇتى	Джибути
پولونىي	Полоний
ئېكۋاتور گۋىنېيىسى	Экваториальная Гвинея
ئېرىترېيە	Эритрея
Yéngi Déhli	Нью-Дели
تبىلىسى	Тбилиси
ئاستاتىن	Астат
گابون	Габон
گامبىيە	Гамбия
ۋىنېيە	Гвинея
گۋىنېيە بىسسائۇ	Гвинея-Бисау
پىل چىشى قىرغىغى	Кот-д’Ивуар
كامېرۇن	Камерун
يېشىل تۇمشۇق ئاراللىرى	Кабо-Верде
لېسوتو	Лесото
لىبېرىيە	Либерия
لىۋىيە	Ливия
ماداگاسكار	Мадагаскар
مالاۋى	Малави
Shtutgart	Штутгарт
ماۋرىتانىيە	Мавритания
ماۋرىتىئۇس	Маврикий
ماراكەش	Марокко
موزامبىك	Мозамбик
نامىبىيە	Намибия
نىگېر	Нигер
نىگېرىيە	Нигерия
دارۋىن	Дарвин, Чарлз
ئۇگاندا	Уганда
رۋاندا	Руанда
سىركونىي	Цирконий
San Tomé we Prinsipé	Сан-Томе и Принсипи
سېنېگال	Сенегал
سېيشېل ئاراللىرى	Сейшельские Острова
سيېررا لېئونې	Сьерра-Леоне
سومالى	Сомали
نىئوبىي	Ниобий
جولیس سیزر	Гай Юлий Цезарь
سۇدان	Судан
سۋازىلېند	Свазиленд
مولبېدىن	Молибден
تېخېتىسىي	Технеций
Hamburg	Гамбург
گۇجارات	Гуджарат
بىرلەشكەن دۆلەتلەر تەشكىلاتى	Организация Объединённых Наций
گېئولوگىيە	Геология
Exmetabad	Ахмадабад
يۈرەك	Сердце
تېرە	Кожа
پراگا	Прага
كۆك رەڭ	Синий цвет
كۈمۈش	Серебро
قەلەي	Олово
ئۇران	Уран (элемент)
سۈرمە	Сурьма
پلوتونىي	Плутоний
نېپتونىي	Нептуний
كسېنون	Ксенон
سېزىي	Цезий
پروتاكتىنىي	Протактиний
بارىي	Барий
تورىي	Торий
گافنىي	Гафний
ئاكتىنىي	Актиний
تانتال	Тантал (элемент)
بىل كلىنتون	Клинтон, Билл
رادىي	Радий
رادون	Радон
Bombay	Мумбаи
Michigan Shitati	Мичиган
پوئېرتو رىكو	Пуэрто-Рико
Illinoyiz Shitati	Иллинойс
Shimaliy Dakota Shitati	Северная Дакота
لومبارد	Ломбардия
Jenubiy Dakota Shitati	Южная Дакота
Montana Shitati	Монтана
Wyoming Shitati	Вайоминг
قۇدس	Иерусалим
Aydaxo Shitati	Айдахо
Washin'giton Shitati	Вашингтон (штат)
رۇزېرفوردىي	Резерфордий
Néwada shitati	Невада
دۇبنىي	Дубний
سىبورگىي	Сиборгий
بوھرىي	Борий
ھاسسىي	Хассий
مېيتنېرىي	Мейтнерий
Kolorado Shitati	Колорадо
دارمستادتىي	Дармштадтий
رۆنتگېنىي	Рентгений
كوپېرنىي	Коперниций
تۈر:تۈرلەر يولباشچىسى	Категория:Всё
ئاپېنىن تاغ تىزمىسى	Апеннинские горы
ئالپ تاغلىرى	Альпы
پاسكال	Паскаль, Блез
Gant	Гент
Chikago	Чикаго
ئۇنۇنترىي	Унунтрий
فلېروۋىي	Флеровий
ئۇنۇنپېنتىي	Унунпентий
لىۋىرمورىي	Ливерморий
ئۇنۇنسېپتىي	Унунсептий
ئۇنۇنئوكتىي	Унуноктий
Arném	Арнем
ئىسپان تىلى	Испанский язык
مونتېۋىدېئو	Монтевидео
Filadélfiye	Филадельфия
Kalkutta	Калькутта
Déhli	Дели
داكا	Дакка
Ban'galor	Бангалор
Ömüchük	Пауки
ئىسلامئاباد	Исламабад
ظاصتاص يئضةن مئؤة	Плод
مايمۇن	Обезьяны
Wirginiye Shitati	Виргиния
غەربىي ۋىرگىنىيە شىتاتى	Западная Виргиния
Nyuyork Shitati	Нью-Йорк (штат)
سېرىي	Церий
پرازېئودىمىي	Празеодим
Rodé Arili Shitati	Род-Айленд
نېئودىي	Неодим
Maryland Shitati	Мэриленд
Délawiyer Shitati	Делавэр
يېۋروپىي	Европий
Oxayo Shtati	Огайо
Pénsilwaniye Shitati	Пенсильвания
Yéngi Jérséy Shtati	Нью-Джерси
فىنلاندىيە تىلى	Финский язык
Indiyanna Shitati	Индиана
ئاپتوموبىل	Автомобиль
Giorgiye Shitati	Джорджия
Zagréb	Загреб
Téksas Shitati	Техас
Jenubiy Karolina Shitati	Южная Каролина
سىتسىلىيە	Сицилия
مانىلا	Манила
ساردىنىيە ئارىلى	Сардиния
Bordo	Бордо
Buénos Ayrés	Буэнос-Айрес
مېكسىكا شەھىرى	Мехико
توكيو	Токио
Barsélona	Барселона
Missisipi Shitati	Миссисипи (штат)
Ténnéssi Shitati	Теннесси
Astana	Астана
Yéngi Méksika Shitati	Нью-Мексико
ئافېنا	Афины
Minnésota Shitati	Миннесота
باغداد	Багдад
Karakas	Каракас
Wiskonsin Shitati	Висконсин
Puna	Пуна
AC مىلان	Милан (футбольный клуб)
Lowa Shitati	Айова
Nébraska Shitati	Небраска
گۋاتېمالا شەھىرى	Гватемала (город)
Kanzas Shitati	Канзас
ھىندى تىلى	Хинди
ماراتىچە	Маратхи (язык)
Missori Shitati	Миссури (штат)
Loyizanna Shitati	Луизиана
Kéntukki Shitati	Кентукки
Arkanzas Shtati	Арканзас
ئوردو تىلى	Урду
Oklaxoma Shitati	Оклахома
Potsdam	Потсдам
Hanofér	Ганновер
Myunxén	Мюнхен
Drézdén	Дрезден
ۋالىبول	Волейбол
Wyéna	Вена
Kopénhagén	Копенгаген
Stokgolm	Стокгольм
Xélsinki	Хельсинки
دۇبلىن	Дублин
رېيكياۋىك	Рейкьявик
Tallin	Таллин
رىگا	Рига
براتىسلاۋا	Братислава
Budapésht	Будапешт
Danzig	Гданьск
Frankfort	Франкфурт-на-Майне
Wroklaw	Вроцлав
لانتان	Лантан
جۈي	Прометий
چالغا	Самарий
گادولنىي	Гадолиний
تېربىي	Тербий
Katolik dini	Католицизм
ليۇكسېمبۇرگ شەھىرى	Люксембург (город)
دىسپروزىي	Диспрозий
ۋادۇز	Вадуц
ئىنجىل	Библия
گولمىي	Гольмий
ئېربىي	Эрбий
فنوم پېن	Пномпень
تۇلىي	Тулий
سايگون	Хошимин
ئىتتېربىي	Иттербий
لۇتېتسىي	Лютеций
خانوي	Ханой
ھەقىقى ئەيسا چېركاۋى	Церковь истинного Иисуса
ئىنگىلىز تىلى	Английский язык
Bangkok	Бангкок
ئاندوررا كەنتى	Андорра-ла-Велья
كۇئالالۇمپۇر	Куала-Лумпур
تەيبېي شەھىرى	Тайбэй
ئامېرىتسىي	Америций
كىيۇرىي	Кюрий
Concepción, Chile	Консепсьон (город, Чили)
بېركېلىي	Берклий
كالىفورنىي	Калифорний
ئېينشتېينىي	Эйнштейний
فېرمىي	Фермий
مېندېلېيېۋىي	Менделевий
كىيېۋ	Киев
نوبېلىي	Нобелий
لاۋرېنسىي	Лоуренсий
كارېلىيە	Республика Карелия
Ottawa	Оттава
Manitoba Ölkisi	Манитоба
Albérta	Альберта
Nowa Skotiye Ölkisi	Новая Шотландия
يېرېۋان	Ереван
دارېسسالام	Дар-эс-Салам
خارتۇم	Хартум
Yéngi Brunswik Ölkisi	Нью-Брансуик
Britani Kolumbiye	Британская Колумбия
Saskachéwan	Саскачеван
Néwfundland Ölkisi	Ньюфаундленд и Лабрадор
Gherbiy Shimal Rayoni	Северо-Западные территории
Yukon Rayoni	Юкон (территория)
Florénsa	Флоренция
Ésén	Эссен
كومى	Республика Коми
Léypzig	Лейпциг
Nyurnbérg	Нюрнберг
Édmonton	Эдмонтон
Man'géym	Мангейм
Wiktoriye, Britani Kolumbiye	Виктория (Британская Колумбия)
Winnipég	Виннипег
Halifaks	Галифакс (Новая Шотландия)
Kwébék Shehiri	Квебек (город)
ئېلېكترون	Электрон
Birmin'gxam	Бирмингем
مىنىسكى	Минск
مىكروسوفىت شىركىتى	Microsoft
پروتون	Протон
Kurow	Курув
Naplés	Неаполь
Braunshwéyg	Брауншвейг
Madrid	Мадрид
سۇ ئاستى كېمىسى	Подводная лодка
مايكېل جېكسۇن	Джексон, Майкл
Bogota	Богота
لىما	Лима
Santiyago	Сантьяго
كىتو	Кито
سۇكرې	Сукре (город)
ئاسۇنسىئون	Асунсьон
Öçke	Коза домашняя
Héydélbérg	Хайдельберг
كاتماندۇ	Катманду
سان خوسې (كوستارىكا)	Сан-Хосе (Коста-Рика)
سان سالۋادور	Сан-Сальвадор
Kanbérra	Канберра
Sidnéy	Сидней
يېشىل رەڭ	Зелёный цвет
Mélburn	Мельбурн
قىزىل رەڭ	Красный цвет
ماناگۇئا	Манагуа
رابات	Рабат
قۇيرۇقلۇق يۇلتۇز	Комета
ئالجىر	Алжир (город)
تۇنىس شەھىرى	Тунис (город)
ترىپولى	Триполи
تېھران	Тегеран
جاكارتا	Джакарта
Enqere	Анкара
رىياد	Эр-Рияд
بېلگراد	Белград
ئادىگېيە	Адыгея
پرايا	Прая
دەمەشىق	Дамаск
يامۇسسۇكرو	Ямусукро
فرانسىيىگە قاراشلىق گۋىئانا	Французская Гвиана
لومې	Ломе
ئاممان	Амман
بېيرۇت	Бейрут
مۇسكات	Маскат
نىكوسىيە	Никосия
دوھا	Доха
نايروبى	Найроби
لۇساكا	Лусака
ئامازون	Amazon.com
قۇياش تۇتۇلۇشى	Солнечное затмение
كامپالا	Кампала
Mektep	Школа
ھارارې	Хараре
Prétoriye	Претория
Astiraxan	Астрахань
Tiktak top	Настольный теннис
Wikipedia:Sandbox	Википедия:Песочница
قالماقىستان	Калмыкия
Osasko	Озаску
Glasgow	Глазго
Kuritiba	Куритиба
Orman	Лес
بوغاز كۆۋرۈكى	Босфорский мост
كۇڭزى	Конфуций
كوربين بيلو	Блю, Корбин
Surat	Сурат
ياۋرۇ	Евро
ئامېرىكا دولىرى	Доллар США
يەر ئوتتۇرا دېڭىزى	Средиземное море
خاڭجۇ شەھىر	Ханчжоу
مەسىھچىلىك	Христианство
قېلىپ:ئاسىيا	Шаблон:Страны Азии
Séatl	Сиэтл
Baltimor	Балтимор
ئادېلايدې	Аделаида
داغىستان	Дагестан
Monzón	Монсон
گۇجارات تىل	Гуджарати
پورتۇگال تىلى	Португальский язык
مۇستاپا كامال	Ататюрк, Мустафа Кемаль
چېچېنىيە	Чечня
كۋېچۇئا تىلى	Кечуанские языки
ئىنگۇشېتىيە	Ингушетия
شىمالىي ئوسېتىيە	Северная Осетия
كاباردىنو-بالقارىستان	Кабардино-Балкария
ئالماس	Алмаз
ياپون تىلى	Японский язык
Énsklopédiye	Энциклопедия
ئۇيغۇرچە ۋىكىپىدىيە	Заглавная страница
Latex	LaTeX
كوندېنساتور	Электрический конденсатор
قاراچاي-چېركېسىيە	Карачаево-Черкесия
موردوۋىيە	Мордовия
ۋاسكېتبول	Баскетбол
چاڭجياڭ دەرياسى	Янцзы
ئۇدمۇرتىيە	Удмуртия
مارى	Марий Эл
ھىمالايا تاغ تىزمىسى	Гималаи
ئاند تاغلىرى	Анды
قىيىلىق تاغلار	Скалистые горы
Kapétown	Кейптаун
چۇۋاشىيە	Чувашия
تەڭرىتاغ	Тянь-Шань
كاۋكاز تاغ تىزمىسى	Кавказские горы
تاتارىستان	Татарстан
1279-يىلى	1279 год
ۋېىنىست	Ван Гог, Винсент
باشقۇرتىستان	Башкортостан
Semerqend	Самарканд
Buxara	Бухара
بېتلېخېم	Вифлеем
Andalusiye	Андалусия
كايمان تاقىم ئاراللىرى	Острова Кайман
Kordowa	Кордова (город, Испания)
شىئەن شەھىرى	Сиань
كابۇل	Кабул
لاسا شەھىرى	Лхаса
غىلاپ	Влагалище женщины
تامىل تىلى	Тамильский язык
پەلسەپە	Философия
ئالەم ئايرۇپىلانى	Космический полёт
ئالتاي تاغ تىزمىسى	Алтайские горы
تۈر:Candidates for speedy deletion	Категория:Википедия:К быстрому удалению
ئالتاي	Республика Алтай
پىئانىنو	Фортепиано
Hebe Camargo	Камарго, Эбе
Portland, Orégon	Портленд (Орегон)
ئانارخىزم	Анархизм
لىبېرالىزىم	Либерализм
فاشىسىت	Фашизм
مىللەتچىلىك	Национализм
غەربىي ساھارا	Западная Сахара
ھىلاري كلىنتون	Клинтон, Хиллари
خاكاسىيە	Хакасия
Strasburg	Страсбург
ياكۇتىيە	Якутия
كرودىيە تىلى	Хорватский язык
گائۇس	Гаусс, Карл Фридрих
بۇرياتىيە	Бурятия
جامىس جويىس	Джойс, Джеймс
كاتالان تىلى	Каталанский язык
Burχa	Будда
دىنسىزلىق	Атеизм
لى بەي	Ли Бо
دۇنيا بانكىسى	Всемирный банк
كونسېرۋاتىپ	Консерватизм
شىمالىي ئاتلانتىك ئەھدى تەشكىلاتى	Организация Североатлантического договора
نوبېل مۇكاپاتى	Нобелевская премия
چىن شىخۇاڭ	Цинь Шихуанди
خەن سۇلالىسى	Хань (династия)
فېمىنىزم	Феминизм
ئىدېئولوگىيە	Идеология
پەي توپ	Бадминтон
يۈەن سۇلالىسى	Юань (династия)
كولۇمبو	Колумб, Христофор
يەھۇدىلار	Евреи
سېرىق دەريا	Хуанхэ
قۇلاق	Ухо
بۇرۇن	Нос
كۆز	Глаз
مۇسكۇل	Мышцы
Töge	Верблюды
پىل	Слон
چۈمۈلە	Муравьи
سۈي سۇلالىسى	Суй
گوللاندىيە تىلى	Нидерландский язык
ماگرىت ساچىر	Тэтчер, Маргарет
ياڭ جىيەن	Вэнь-ди (династия Суй)
دېئوكسىرىبونۇكلېئىك كىسلاتا	Дезоксирибонуклеиновая кислота
سۇڭ سۇلالىسى	Империя Сун
Çeyze	Баклажан
رۇس تىلى	Русский язык
ساخالىن	Сахалин
نېفىت ئېكىسپورت قىلغۇچى دۆلەتلەر تەشكىلاتى (OPEC)	Организация стран — экспортёров нефти
خەلقئارا پۇل فوندى تەشكىلاتى	Международный валютный фонд
دۇنيا سودا تەشكىلاتى	Всемирная торговая организация
سۋاھىلىچە	Суахили
توكيو ئۇنىۋېرستېتى	Токийский университет
خەنزۇ تىلى	Китайский язык
ئۆپكە	Лёгкие
نەپەسلىنىش سىستېمى	Дыхательная система
رۇمىنىيە تىلى	Румынский язык
بۇلغارىيە تىلى	Болгарский язык
يەر تەۋرەش	Землетрясение
ماگادان	Магадан
تەبىئىي پەن	Естествознание
فرانكلىن روزۋېلت	Рузвельт, Франклин
ﺋﯩﺒﯩﻦ ﺳﯩﻨﺎ	Ибн Сина
نىلسۇن ماندىلا	Мандела, Нельсон
مارتىن لوتىر كىڭ	Кинг, Мартин Лютер
Yanardag	Вулкан
ئىسسىق بەلباغ سىكلونى	Тропический циклон
تېلۇگۇ تىلى	Телугу
گرۇزىن تىلى	Грузинский язык
ئىقتىسادشۇناسلىق	Экономика (наука)
يېن	Японская иена
قىزىل تۈلكە	Обыкновенная лисица
ئىسكىرىپكا	Скрипка
چوڭ ئىسكىروپكا	Виолончель
ئىسكەندەر زۇلقەرنەيىن	Александр Македонский
ئۆمەر ئىبنى خەتتاب	Умар ибн аль-Хаттаб
ئامۇ دەرياسى	Амударья
سۈت	Молоко
سۇن جۇڭشەن	Сунь Ятсен
شياڭگاڭ	Гонконг
Miami	Майами
كاراچى	Карачи
Rio dé Janéyro	Рио-де-Жанейро
سوغۇق ئۇرۇش	Холодная война
شاڭخەي شەھىرى	Шанхай
Bilbaw	Бильбао
Séwéliye	Севилья
چىڭ سۇلالىسى	Империя Цин
توماس ئىدىسون	Эдисон, Томас Алва
ئالبان تىلى	Албанский язык
باسكى تىلى	Баскский язык
ئاراگون تىلى	Арагонский язык
ئەرمەن تىلى	Армянский язык
ئۇكرائىن تىلى	Украинский язык
Walénsiye	Валенсия
Malaga	Малага
شۋېتسىيە تىلى	Шведский язык
دانىش تىلى	Датский язык
نورۋېگىيە تىلى	Норвежский язык
ليۇكسېمبۇرگ تىلى	Люксембургский язык
چېخ تىلى	Чешский язык
سلوۋاك تىلى	Словацкий язык
كارل ماركىس	Маркс, Карл
سلوۋېن تىلى	Словенский язык
ماجار تىلى	Венгерский язык
ۋولتىر	Вольтер
ئېستون تىلى	Эстонский язык
لاتۋىيە تىلى	Латышский язык
لىتۋا تىلى	Литовский язык
ھىندى دىنى	Индуизм
بېلورۇس تىل	Белорусский язык
يېلىن	Женская грудь
ئاتوم	Атом
گرېك تىلى	Греческий язык
ئرېلاندىيە تىلى	Ирландский язык
مالتا تىلى	Мальтийский язык
پارس تىلى	Персидский язык
ئىسلام	Религия
كورىيەچە	Корейский язык
Injilning birinchi tomi	Книга Бытия
كانتونچە	Кантонский диалект
ئېكسودۇس	Книга Исход
ۋيېتنام تىلى	Вьетнамский язык
كخمېر تىلى	Кхмерский язык
لائوس تىلى	Лаосский язык
تايلاندچە	Тайский язык
بىرما تىلى	Бирманский язык
مالاي تىلى	Малайский язык
ھىندونېزىيە تىلى	Индонезийский язык
موڭغۇل تىلى	Монгольский язык
Baku	Баку
قازاق تىلى	Казахский язык
قىرغىز تىلى	Киргизский язык
تاجىك تىلى	Таджикский язык
ئۆزبېك تىلى	Узбекский язык
تۈركمەن تىلى	Туркменский язык
يەھۇدى دىنى	Иудаизм
تىمپۇ	Тхимпху
باندار سەرى بەگاۋان	Бандар-Сери-Бегаван
ئىبرانى تىلى	Иврит
ئەزەربەيجان تىلى	Азербайджанский язык
ماكېدون تىلى	Македонский язык
سېرب تىلى	Сербский язык
سېربو-كرودىيىلىكلەر تىلى	Сербохорватский язык
بوسنىيە تىلى	Боснийский язык
گالىسىيەچە	Галисийский язык
ۋېلش تىلى	Валлийский язык
دىلى	Дили
شوتلاندىيە گائېل تىلى	Шотландский язык (кельтский)
Wyéntyan	Вьентьян
مالې	Мале
Bishkek	Бишкек
Düshenbe	Душанбе
جىگەر	Печень
تلا	Селезёнка
بۆرەك	Почка (анатомия)
دوۋساق	Мочевой пузырь
نېرۋا سىستىمېسى	Нервная система
ئوكيانىيە	Океан
مۇھەممەد ئەلەيھىسسالام	Мухаммед
ئىمام ئەلغازالىي	Абу Хамид аль-Газали
رىچارد نىكسون	Никсон, Ричард
قورساق قىسم	Брюшко
داۋجياۋ دىنى	Даосизм
سوپىزم (تەسەۋۋۇپ)	Суфизм
ۋېنا تومۇرى	Вена (анатомия)
بېنگال تىلى	Бенгальский язык
تىل	Язык (анатомия)
پانكرېئاتىت	Поджелудочная железа
بويۇن	Шея
ئېغىز بوشلۇقى	Рот
بوغۇز	Гортань
فالكلاند تاقىم ئاراللىرى	Фолклендские острова
سازاڭسىمان ئۆسۈكچە	Аппендикс человека
ئېلىزابېت II	Елизавета II
تاڭ سۇلالىسى	Тан (династия)
كېننېدى	Кеннеди, Джон Фицджеральд
تاڭ تەيزوڭ	Тай-цзун (династия Тан)
بالزاك	Бальзак, Оноре де
مىڭ سۇلالىسى	Империя Мин
جۇ يۈەنجاڭ	Хунъу
رېگان	Рейган, Рональд
زۇلۇچە	Зулу
زازا تىلى	Зазаки
پلازما	Плазма
رىم گىلادىئاتورلار مەيدانى	Колизей
Saragossa	Сарагоса
Bélfast	Белфаст
ئېلېمېنتلارنىڭ دەۋرىي جەەدۋىلى	Периодическая система химических элементов
قۇرۇق ئۈزۈم	Виноград (ягода)
ھەسەل	Мёд
شېكەر	Сахар
روبوت	Робот
ماشىنىسازلىق	Машина
ئايلىنىش سىستېمىسى	Кровообращение
ئىچكى ئاجراتما سىستېمىسى	Эндокринная система
كىسلاتا	Кислота
سارايېۋو	Сараево
تۇز	Поваренная соль
فۇنكسىيە	Функция (математика)
مولېكۇلا	Молекула
ئېنېرگىيە	Энергия
ئىنفرا قىزىل نۇر	Инфракрасное излучение
ماسسا	Масса
مېتال	Металлы
پولات	Сталь
نانو تېخنىكىسى	Нанотехнология
ئەينەك	Стекло
ۋاكۇئۇم	Вакуум
ئېلېكترون ئىلمى	Электроника
.توك (توك ئېقىمى)	Электрический ток
ئىككى پۇتلۇق لامپا	Диод
ئامېرىكىغا قاراشلىق ۋىرگىن تاقىم ئاراللىرى	Виргинские Острова (США)
شېنياڭ شەھىرى	Шэньян
چۇڭچىڭ شەھىرى	Чунцин
تيەنجىن شەھىرى	Тяньцзинь
Lahor	Лахор
ۋۇخەن شەھىرى	Ухань
نۆۋەتتىكى ھادىسە	Алфавитный список стран и территорий
ناگويا	Нагоя
تاش قورال دەۋرى	Каменный век
ئېيىق	Медвежьи
فوتوسىنتېز رولى	Фотосинтез
برېتون تىلى	Бретонский язык
پىرېنېي تاغلىرى	Пиренеи
Détroyt	Детройт
بۇرج دۇبەي	Бурдж-Халифа
Sedichin Sépili	Великая Китайская стена
ئاياسوڧيا	Собор Святой Софии (Константинополь)
ئابباسىيلار خاندانلىقى	Аббасидский халифат
سەلىپنىڭ شەرققە يۈرۈش قىلىشى	Крестовые походы
موڭغۇل ئىمپېرىيىسى	Монгольская империя
ئوسمان ئىمپېرىيىسى	Османская империя
ئىسپانىيە-ئامېرىكا ئۇرۇشى	Испано-американская война
مىللى دارامەت	Валовой внутренний продукт
ئېلېكتر	Электричество
يادرو ئېنېرگىيىسى	Ядерная энергия
ھور ماشىنىسى	Паровая машина
Antwérp	Антверпен
باش سۆڭىكى	Череп
ئانار	Гранат обыкновенный
ئاپېلسىن	Апельсин
دۇنيا تىلى	Романшский язык
جۇاڭزۇ تىلى	Чжуанский язык
شىبە تىلى	Сибинский диалект
ئۇيغۇر تىلى	Уйгурский язык
سىنگال تىلى	Сингальский язык
ناخۇئاتل تىلى	Астекские языки
مونتسەررات	Монтсеррат
خارۋارد ئۇنىۋېرسىتېتى	Гарвардский университет
Pisa	Пиза
باشقۇرتچە	Башкирский язык
قېلىپ:Location map Earth	Шаблон:ПозКарта Земля
باغلانغان ئۆردەك	Канар аншене
ئەرەب تىلى	Арабский язык
كيۇسيۇ ئارىلى	Кюсю
خونسيو ئارىلى	Хонсю
شىكوكۇ	Сикоку
كورسىكا ئارىلى	Корсика
ئاڧرىقانچە	Африкаанс
بۆرە بورسۇق	Росомаха
ئاۋمېن	Макао
خۇ جىنتاۋ	Ху Цзиньтао
شى جىنپىڭ	Си Цзиньпин
زىراپە	Жираф
شېنجېن شەھىرى	Шэньчжэнь
گۇئاڭدوڭ ئۆلكىسى	Гуандун
گۇاڭشى جۇاڭزۇ ئاپتونۇم رايونى	Гуанси-Чжуанский автономный район
سوۋېت ئىتتىپاقى	Союз Советских Социалистических Республик
شياڭگاڭ ئۇنىۋېرستېتى	Гонконгский университет
شياڭگاڭ جۇڭگو تىللىرى ئۇنۋېرسىتېتى	Китайский университет Гонконга
رۇبلى	Рубль
پۇت	Стопа
دولا	Плечевой сустав
قالقانبەز	Щитовидная железа
Wikipedia:Tor Jamiyeti	Википедия:Форум
Wérmont Shitati	Вермонт
San Diyégo	Сан-Диего
San Xosé	Сан-Хосе (Калифорния)
Dénwér	Денвер
Hyuston	Хьюстон
Féniks	Финикс
Dallas	Даллас
Austin	Остин (Техас)
Mémfis, Ténnéssi	Мемфис (Теннесси)
Sharlot	Шарлотт (Северная Каролина)
Kolumbu, Oxéo	Колумбус (Огайо)
گۇاڭجۇ شەھىرى	Гуанчжоу
جىياڭ جىشى	Чан Кайши
ۋېن جىياباۋ	Вэнь Цзябао
Guam Aril	Гуам
ئامېرىكىغا قاراشلىق ساموئا	Американское Самоа
شىمالىي مارىئانا فېدېراتسىيىسى	Северные Марианские острова
نەنجىڭ شەھىرى	Нанкин
بېيجىڭ ئۇنىۋېرسىتېتى	Пекинский университет
ئۈرۈمچى شەھىرى	Урумчи
جياڭسۇ ئۆلكىسى	Цзянсу
جېجياڭ ئۆلكىسى	Чжэцзян
گۇئادەلوپە	Гваделупа
مارتىنىكا	Мартиника
شىزاڭ ئاپتونوم رايونى	Тибетский автономный район
دالاي لاما	Далай-лама XIV
تۆگىقۇش	Страус
Sakraménto	Сакраменто (Калифорния)
چاۋشيەن	Корея
لى كېچياڭ	Ли Кэцян
Manchéstér	Манчестер
تۇركس ۋە كايكوس تاقىم ئاراللىرى	Теркс и Кайкос
ۋىتامىن A	Витамин A
ياۋروپا چىمپيونلۇق لوڭقىسى	Лига чемпионов УЕФА
پالمىزارلىق ئىپار مۈشۈكى	Мусанг
Pyongyang	Пхеньян
New Testament	Новый Завет
ئادالەت ۋە تەرەققىيات پارتىيىسى	Партия справедливости и развития (Турция)
گۈللىنىش پارتىيىسى	Республиканская народная партия (Турция)
مىللى دارامەت بويىچە دۆلەت تەرتىپى	Список стран по ВВП (номинал)
خېيلوڭجياڭ ئۆلكىسى	Хэйлунцзян
ما يىنجىئۇ	Ма Инцзю
بۇخارېست	Бухарест
پوئىرتورىكان مۇستەقىللىق پارتىيىسى	Партия независимости Пуэрто-Рико
Tirana	Тирана
ئېشەك	Домашний осёл
سىچۈەن ئۆلكىسى	Сычуань
مۇھەممەر قەززافى	Каддафи, Муаммар
بارس	Тигр
چۆپ ئاش	Вермишель
سامسۇڭ گۇرۇھى	Samsung
شىمالىي ياۋروپا	Скандинавия
كىشىنېۋ	Кишинёв
بیلگیسايار مۈھەندیسلیغی	Информатика
Şalom	Şalom
ئارۇبا	Аруба
خېبېي ئۆلكىسى	Хэбэй
پرىنسېتون ئۇنىۋېرستېتى	Принстонский университет
نېفىت	Нефть
پېنسىلۋانىيە نېمىس تىلى	Пенсильванско-немецкий диалект
پرژىۋالسكى ياۋا ئات	Лошадь Пржевальского
قوي	Бараны
ئىرلاندىيە	Ирландия (остров)
Chéshir	Чешир
Nortumbér Wilayiti	Нортамберленд
Staffordshir	Стаффордшир
ﻟﯘﺷﯜﻥ	Лу Синь
Shimaliy Amptonshir	Нортгемптоншир
Bédfordshir	Бедфордшир
Kornwél	Корнуолл
Bristol	Бристоль
Déwonshir	Девон (графство)
خالتىلىق چاشقانلار ئائىلىسى	Кенгуровые
Nashwil	Нашвилл
Xampishir	Хэмпшир
Bérkshir	Беркшир
Bukkinxamshir	Бакингемшир
Ésséks	Эссекс
Ként	Кент
Ulanbatur	Улан-Батор
ئېرنېست ھېمىڭۋاي	Хемингуэй, Эрнест
Idinburg	Эдинбург
ئاشخاباد	Ашхабад
پىياز	Лук репчатый
پەمىدۇر	Томат
جورج بۇش	Буш, Джордж Герберт Уокер
بالقانلار	Балканский полуостров
پروتېستانت دىنى	Протестантизм
سەلەنا	Селена (певица)
Atlanta	Атланта
بېرمۇدا	Бермудские Острова
باش	Голова
ۋېللىنگتون	Веллингтон
روبوتلارنىڭ ئۈچ قانۇنى	Три закона роботехники
ئالفېرد نوبىل	Нобель, Альфред
لیلا چڑھاو	Даунс, Лила
907-يىلى	907 год
Wankuwér	Ванкувер
Liwérpol	Ливерпуль
Brémén	Бремен
يېڭى نورۋېگىيە تىلى	Новонорвежский язык
پوند ستېرلىڭ	Фунт стерлингов
ئانگۋىللا	Ангилья
فائېروس تىل	Фарерский язык
مۈشۈك ئائىلىسى	Кошачьи
ISO 3166-1	ISO 3166-1
تاتار تىلى	Татарский язык
ئەنگلىيىگە قاراشلىق ۋىرگىن تاقىم ئاراللىرى	Британские Виргинские острова
كىچىك سېسىق كۈزەنى	Ласка
فرىزانچە	Фризские языки
ئاق ئاغمىخان	Горностай
قارشىلىق	Электрическое сопротивление
ناۋاسسا ئاراللىرى	Навасса (остров)
سېنت بارتھېلەمي ئاراللىرى	Сен-Бартелеми
شىمالىي گېرمانىيە دىئالېكتى	Нижненемецкий язык
ئاغمىخان ئائىلىسى	Куньи
ساينت مارتىن	Сен-Мартен (остров)
بۆكەن	Антилопы
قارا بۇلغۇن	Соболь
سۈنئىي ھەمراھ	Искусственный спутник Земли
قوتاز	Як
ب م ۋ	BMW
Kuk Taqim Aralliri	Острова Кука
رەشىدە داتى	Дати, Рашида
شەرقىي ئاسىيا	Восточная Азия
ئوتتۇرا ئاسىيا	Центральная Азия
ئاق تۆش بۇلغۇن	Каменная куница
ياۋا ئات	Дикая лошадь
ئامخارا تىلى	Амхарский язык
Képinek	Чешуекрылые
چاچ	Волосы
ھىجرىيە كالېندارى	Исламский календарь
جيامۇسى شەھىرى	Цзямусы
كەبەك	Кебек-хан
دىرىخلې	Дирихле, Петер Густав Лежён
ئاستۇرىيە تىلى	Астурийский язык
خىتاي	Китайская цивилизация
قاما	Выдра
چېڭدۇ شەھىر	Чэнду
يىلپىز	Ирбис
جېڭجۇ شەھىرى	Чжэнчжоу
تېرېسا ئانا	Мать Тереза
DELL شىركىتى	Dell
فرانسىيىگە قاراشلىق پولىنېزىيە	Французская Полинезия
618-يىلى	618 год
روژدېستۋو ئاراللىرى	Остров Рождества (Австралия)
Krakow	Краков
بېيجىڭ پايتەخت ئايروپورتى	Шоуду
تىراختور	Трактор Сази
ۋېنىسىيە تىلى	Современный венетский язык
جامى	Мечеть
دۇڭشياڭ تىلى	Дунсянский язык
تۇڭگان تىلى	Дунганский язык
كورسىكا تىلى	Корсиканский язык
فىلىپىنچە	Филиппинский язык
چۇۋاش تىلى	Чувашский язык
قرىم تاتار تىلى	Крымско-татарский язык
ھايتى كرېئول تىلى	Гаитянский креольский язык
قارا قالپاق تىلى	Каракалпакский язык
ياۋا تىلى	Яванский язык
مۈشۈكئېيىق	Большая панда
قالماق تىلى	Калмыцкий язык
مانجۇ تىلى	Маньчжурский язык
كانناداچە	Каннада
مۇڭغۇل تىللىرى	Монгольские языки
پوچېركا	Кисть (анатомия)
دۇفۇ	Ду Фу
يېڭى كالېدونىيە	Новая Каледония
ئورىياچە	Ория (язык)
نېپال تىلى	Непальский язык
نېئاپول تىلى	Неаполитанский язык
نورمان تىلى	Нормандский язык
تېئودور روزېۋېلت	Рузвельт, Теодор
تېلاۋىف	Тель-Авив
Nis	Ницца
سالار تىلى	Саларский язык
سىتسىلىيە تىلى	Сицилийский язык
ساردىنىيە تىلى	Сардинский язык
ژىيۇل ۋېرن	Верн, Жюль
سىندى تىلى	Синдхи (язык)
سۇندا تىلى	Сунданский язык
شونا تىلى	Шона (язык)
Niué Arili	Ниуэ
تاگالوگ تىلى	Тагальский язык
تۈركى تىللار ئائىلىسى	Тюркские языки
تونگاچە	Тонганский язык
ئۇرال تىللىرى	Уральские языки
تىگرىنىيەچە	Тигринья
Oksford	Оксфорд
غەربىي يۇغۇر تىلى	Сарыг-югурский язык
تۇنگۇس مانجۇ تىللىرى	Тунгусо-маньчжурские языки
زاڭزۇ تىلى	Тибетский язык
سارى ئۇغۇر	Жёлтые уйгуры
ۋۇ تىلى	У (язык)
ۋىلسون	Вильсон, Вудро
ياقۇت تىلى	Якутский язык
يورۇباچە	Йоруба (язык)
سېسوتوچە	Сесото
Rottérdam	Роттердам
Yéngi Orléan	Новый Орлеан
فۇشەن شەھىر	Фошань
ئوكسفورد ئۇنىۋېرسىتېتى	Оксфордский университет
ئەھمىدى نىجات	Ахмадинежад, Махмуд
Saynt Xéléna Arili	Остров Святой Елены
بارماق	Палец
ساينت پىئېر ئارىلى ۋە مىكېلون تاقىم ئاراللىرى	Сен-Пьер и Микелон
ئون پەرھىز	Десять заповедей
Yohannésburg	Йоханнесбург
قاپلان	Леопард
Saltzburg	Зальцбург
X نۇرى	Рентгеновское излучение
شىنجاڭ ئۇيغۇر ئاپتونوم رايونى	Синьцзян-Уйгурский автономный район
Albukwér kwé	Альбукерке
Oklaxoma Shehiri	Оклахома-Сити
برىسبان	Брисбен
ئىسساك ئاسىموۋ	Азимов, Айзек
جەنۇبىي گىئورگىيە ۋە ساندۋىچ ئاراللىرى	Южная Георгия и Южные Сандвичевы Острова
كۇۋائىت شەھىرى	Эль-Кувейт
ئەرەبلەر	Арабы
سۇمېرلار	Шумер
كولومبو	Коломбо
ئالمۇتا	Алма-Ата
قانداغاي	Лось
ۋاللىس ۋە فۇتۇنا تاقىم ئاراللىرى	Уоллис и Футуна
تاتار مىللىتى	Татары
خوككايدو ئارىلى	Хоккайдо
ئۇرال تاغلىرى	Уральские горы
ماددا	Материя (физика)
ئوساكا	Осака
كامبرىج ئۇنىۋېرستېتى	Кембриджский университет
ئاكا-ئۇكا رايتلار	Братья Райт
گۇئارانچە	Гуарани (язык)
شور دېڭىز	Аральское море
ئىستانبۇل بوغازى	Босфор
Izmir	Измир
كەئەلىڭ كوكوس تاقىم ئاراللىرى	Кокосовые острова
مېرسېدېس - بېنز	Mercedes-Benz
كۋېنسلاند	Квинсленд
Minnéapolis	Миннеаполис
دەرەخ خالتىلىق ئېيىقى	Коала
2011-يىلدىكى ياپونىيە يەر تەۋرەش ۋە دېڭىز تاشقىنى	Землетрясение в Японии (2011)
لىنگالاچە	Лингала
مالايالامچە	Малаялам
يىپەك يولى	Великий шёлковый путь
Kalgari	Калгари
ئوستىيىن	Остин, Джейн
قوڭۇر ئېيىق	Бурый медведь
كۇرد تىلى	Курдские языки
مولداۋىيە تىلى	Молдавский язык
يېڭى تاش قۇرال دەۋرى	Неолит
مورېسبى پورتى	Порт-Морсби
خىمىيىلىك رېئاكسىيە	Химическая реакция
لاھەي	Гаага
جۇاڭزۇ مىللىتى	Чжуаны
ئوسمانلى تۈركچىسى	Османский язык
يۇھاننا بايان قىلغان خۇش خەۋەر	Евангелие от Иоанна
توكېلاۋ تاقىم ئاراللىرى	Токелау
چاغاتاي ئۇيغۇر يېزىقى	Чагатайский язык
تۋىچە	Чви
چېڭلۇڭ	Чан, Джеки
توخار تىلى	Тохарские языки
ئېلان	Реклама
Zeytun	Олива европейская
ئاۋكلاند	Окленд (Новая Зеландия)
سەككىز دۆلەت گۇرۇھى (G8)	Большая восьмёрка
ئاۋكادۇر	Авокадо
قىزىل قان دانىچىلىرى	Эритроциты
ئوقۇتقۇچى	Учитель
تىز	Коленный сустав
ئۆرۈك	Абрикос
گلۇكوزا	Глюкоза
Sint-Truiden	Синт-Трёйден
ئالتاي تىللىرى سىستېمىسى	Алтайские языки
ناتالىيە پورتمەن	Портман, Натали
Ran'gon	Янгон
ناگاساكى	Нагасаки
يوكوخاما	Иокогама
ئادانا	Адана
لازېر نۇرى	Лазер
Lyuju shehiri	Лючжоу
خەلق پۇلى يۈەنى	Китайский юань
Ritis	Лидс
رەجەپ تاييىپ ئەردوغان	Эрдоган, Реджеп Тайип
قىزغۇچ سېرىق	Оранжевый цвет
شىمال بۇغىسى	Северный олень
لۇقا بايان قىلغان خۇش خەۋەر	Евангелие от Луки
كونا تاش قۇرال دەۋرى	Палеолит
ئانتاليا ۋىلايىتى	Анталья (ил)
ھەزرىتى ئەيسا ئەلچىلىرىنىڭ پائالىيەتلىرى	Деяния святых апостолов
پەرۋەز مۇشەررەڧ	Мушарраф, Первез
ئادانا ۋىلايىتى	Адана (ил)
تاشقا ئايلانغان جىسىم	Фоссилии
بۇرسا	Бурса (город)
ئۇرۇق	Семя
ئەنخۇي ئۆلكىسى	Аньхой
خەلقئارا ئولىمپىك كومىتىتى	Международный олимпийский комитет
ماڭلاي	Лоб
ئىچكى موڭغۇل ئاپتونوم رايونى	Внутренняя Монголия
Nottingxam	Ноттингем
راكېتا	Ракета
كۇردىستان	Курдистан
ستانفورد ئۇنىۋېرستېتى	Стэнфордский университет
فۇجيەن ئۆلكىسى	Фуцзянь
Kanzas Shehiri, Missuri	Канзас-Сити (Миссури)
كىچىك مۈشۈكئېيىق	Малая панда
موڭغۇل مىللىتى	Монголы
ۋەھىيلەر	Откровение Иоанна Богослова
Sirtlan	Гиены
كاسا	Ягодицы
خەينەن ئۆلكىسى	Хайнань
رىمان	Риман, Бернхард
گەنسۇ ئۆلكىسى	Ганьсу
ئاق قان ھۈجەيرىسى	Лейкоциты
ئەنگلىيىلىكلەر	Англичане
ئاناتول فرانس	Франс, Анатоль
ئوتلاق ياۋا مۈشۈكى	Степной кот
جەينەك	Локтевой сустав
سۇجۇ شەھىرى	Сучжоу (Цзянсу)
جاڭگال مولۇنى	Камышовый кот
بېنگال مولۇنى تاغ مۈشۈكى	Бенгальская кошка
Wénju shehiri	Вэньчжоу
ۋۇشى شەھىرى	Уси
Shawshin shehiri	Шаосин
خەنزۇ مىللىتى	Хань (народ)
نىڭبو شەھىرى	Нинбо
ئابدۇللاھ گۈل	Гюль, Абдулла
نېمىسلار	Немцы
خاربىن شەھىرى	Харбин
Orkéstr	Оркестр
تۈرك قەھۋەسى	Кофе по-восточному
قىزىل ياقۇت	Рубин
كەشمىر	Кашмир
گالاتا ساراي	Галатасарай (спортивное общество)
كەۋىن رۇد	Радд, Кевин
يۈننەن ئۆلكىسى	Юньнань
مالكولم X	Малкольм Икс
مەۋلانا جالالىددىن رۇمى	Джалаладдин Руми
Plimowt	Плимут (Англия)
شەندۇڭ ئۆلكىسى	Шаньдун
قول	Плечо (часть тела)
Dérbi	Дерби (Англия)
ياقۇت رەڭلىك	Изумруд
كىرىستال	Кристаллы
خېنەن ئۆلكىسى	Хэнань
بۇرسا ۋىلايىتى	Бурса (ил)
ئارتۋىن ۋىلايىتى	Артвин (ил)
كىندىك	Пуп
ئادىيامان ۋىلايىتى	Адыяман (ил)
لياۋنىڭ ئۆلكىسى	Ляонин
خىمىيىلىك باغ	Химическая связь
GNU	GNU
توچىگى ناھىيىسى	Тотиги (префектура)
سېمونت	Цемент
جىلىن ئۆلكىسى	Гирин
ئافيون قاراھىسار ۋىلايىتى	Афьонкарахисар (ил)
بېربېرلار	Берберы
ئېچىتقۇ	Дрожжи
خۇنەن ئۆلكىسى	Хунань
ھونلار	Гунны
چىڭخەي ئۆلكىسى	Цинхай
ئۇيغۇر مىللىتى	Уйгуры
بىلەجىك ۋىلايىتى	Биледжик (ил)
خۇبېي ئۆلكىسى	Хубэй
شەنشى ئۆلكىسى	Шаньси
يۈز	Щека
قوڭۇر رەڭلىك	Коричневый цвет
گۇيلىن ئۆلكىسى	Гуйчжоу
بالىكەسىر ۋىلايىتى	Балыкесир (ил)
كيوتو كىلىشىمنامىسى	Киотский протокол
ئانىلار بايرىمى	День матери
خەلقئارا ئىسلام كېڭىشى تەشكىلاتى	Организация исламского сотрудничества
چاناققالە ۋىلايىتى	Чанаккале (ил)
مىياگى ناھىيىسى	Мияги (префектура)
Luknow	Лакхнау
شېنشى ئۆلكىسى	Шэньси
رىملىقلارغا يېزىلغان خەت	Послание к Римлянам
مالىكىي مەزھىبى	Маликитский мазхаб
ئوقۇغۇچى	Студент
Kobe	Кобе
ئىۋاتە ناھىيىسى	Иватэ (префектура)
كولۇمبىيە ئۇنىۋېرستېتى	Колумбийский университет
بوستون ئۇنىۋېرستېتى	Бостонский университет
يالې ئۇنىۋېرسىتېتى	Йельский университет
پېنسىلۋانىيە ئۇنىۋېرستېتى	Пенсильванский университет
Portland, Méané	Портленд (Мэн)
نيۇيورك ئۇنىۋېرستېتى	Нью-Йоркский университет
ئىتاليانلار	Итальянцы
پارىژ مېتروسى	Парижский метрополитен
پىرىت	Пирит
فىلىپىلىكلەرگە يېزىلغان خەت	Послание к Филиппийцам
ئېگىزلىك گېرمان تىلى	Верхненемецкие языки
قېلىپ:Taxobox	Шаблон:Taxobox
قارا ئېقىم	Куросио
خەلق گېزىتى	Жэньминь жибао
جياڭشى ئۆلكىسى	Цзянси
ئىلھام ئالىيېۋ	Алиев, Ильхам Гейдар оглы
زاردارى	Зардари, Асиф Али
نۇرسۇلتان نازاربايېۋ	Назарбаев, Нурсултан Абишевич
نىڭشيا خۇيزۇ ئاپتونۇم رايونى	Нинся-Хуэйский автономный район
ئىسلام كەرىموۋ	Каримов, Ислам Абдуганиевич
شۈجو شەھىرى	Сюйчжоу
Lyenyün'gang shehiri	Ляньюньган
ساۋكات مىرزىيويەۋ	Мирзиёев, Шавкат Миромонович
خۇەيئەن شەھىرى	Хуайань
Yangjo shehiri	Янчжоу
Teyju shehiri, Jyangsu	Тайчжоу (Цзянсу)
Nentung shehiri	Наньтун
جاڭجياڭ شەھىرى	Чжэньцзян
چاڭجو شەھىر	Чанчжоу
ئەھمەد داۋۇد ئوغلۇ	Давутоглу, Ахмет
تەيجۇ شەھىرى	Тайчжоу (Чжэцзян)
جۇشەن شەھىرى	Чжоушань
شىجياجۇاڭ شەھىرى	Шицзячжуан
تاڭشەن شەھىرى	Таншань
Chinxuangdaw shehiri	Циньхуандао
خەندەن شەھىرى	Ханьдань
Bawding shehiri	Баодин
پەنجاب تىلى	Панджаби
پاشتوچە	Пушту
ساڭجو شەھىرى	Цанчжоу
Langfang shehiri	Ланфан
Juxey shehiri	Чжухай
شەنتۇ شەھىرى	Шаньтоу
Xuyjo shehiri	Хойчжоу
Dongwen shehiri	Дунгуань
Jongshen shehiri	Чжуншань (город)
مىقدار سۆز	Имя числительное
ئۆت خالتىسى	Жёлчный пузырь
Jaypur	Джайпур
فۇجو شەھىرى	Фучжоу
Nenping shehiri	Наньпин
Putyen shehiri	Путянь
Senming shehiri	Саньмин
Chüenju shehiri	Цюаньчжоу
شيامېن شەھىرى	Сямынь
Jyangju shehiri	Чжанчжоу
Longyen shehiri	Лунъянь
Ningdé shehiri	Ниндэ
Shining shehiri	Синин
تاغىل سېسىق كۈزەن	Перевязка
ئادەم ئەلەيھىسسالام	Адам
خۇئاڭشى شەھىرى	Хуанши
ئائومورى ناھىيىسى	Аомори (префектура)
فۇكۇشىما ناھىيىسى	Фукусима (префектура)
تەييۈەن شەھىرى	Тайюань
داتۇڭ شەھىر	Датун
داليەن شەھىرى	Далянь
ئەنشەن شەھىرى	Аньшань
يىڭكۇ شەھىرى	Инкоу
لياۋياڭ شەھەر	Ляоян
يوزگات ۋىلايىتى	Йозгат (ил)
چوڭ مېڭە پوستلاق ماددىسى	Кора больших полушарий
ئوڭچى	Правые (политика)
كارل ۋون دونىتىز	Дёниц, Карл
سۆسۈنە ياقۇت	Аметист
بىنگۆل ۋىلايىتى	Бингёль (ил)
تايغان بۇغا	Благородный олень
ئارداھان ۋىلايىتى	Ардахан (ил)
ئايدىن ۋىلايىتى	Айдын (ил)
ئاماسيا ۋىلايىتى	Амасья (ил)
قازاق مىللىتى	Казахи
ئاغرى ۋىلايىتى	Агры (ил)
بۇردۇر ۋىلايىتى	Бурдур (ил)
كورىنتلىقلارغا يېزىلغان بىرىنچى خەت	1-е послание к Коринфянам
باتمان ۋىلايىتى	Батман (ил)
كۇرىل ئاراللىرى	Курильские острова
يېڭى يەر	Новая Земля
Patna	Патна
سۇلتان ئاخمەت جامىي	Голубая мечеть (Стамбул)
ۋان ۋىلايىتى	Ван (ил)
كونيا ۋىلايىتى	Конья (ил)
ئاكىتا ناھىيىسى	Акита (префектура)
سېگولەن رويال	Руаяль, Сеголен
بولۇ ۋىلايىتى	Болу (ил)
دېنىزلى ۋىلايىتى	Денизли (ил)
شافىئىي مەزھىپى	Шафиитский мазхаб
گىپىس	Гипс
ئېڭەك	Подбородок
ئامېرىكا ياۋا كالىسى	Бизон
Léyséstér	Лестер
ساكاريا ۋىلايىتى	Сакарья (ил)
ئاقساراي ۋىلايىتى	Аксарай (ил)
قارس ۋىلايىتى	Карс (ил)
دىيارباقىر ۋىلايىتى	Диярбакыр (ил)
مور	Гриб
تەيبېي 101	Тайбэй 101
ئەدىرنە ۋىلايىتى	Эдирне (ил)
ظوسذث	Латук посевной
بىتلىس ۋىلايىتى	Битлис (ил)
ئىباراكى ناھىيىسى	Ибараки
ھاتاي ۋىلايىتى	Хатай (ил)
زىيا گۆكئالىپ	Зия Гёкальп
پان تۈركىزم	Пантюркизм
يۇگوسلاۋىيە سوتسىيالىست فېدېرال جۇمھۇرىيىتى	Социалистическая Федеративная Республика Югославия
تۈرك	Тюрки
بارتىن ۋىلايىتى	Бартын (ил)
باش بارماق	Большой палец
كوجائەلى ۋىلايىتى	Коджаэли (ил)
تۈرك خاقانلىقى	Турки
سازاڭسىمان مەددە	Caenorhabditis elegans
چاڭچۈن شەھىرى	Чанчунь
جىلىن شەھىرى	Гирин (город)
ئېمۇ قۇشى	Эму
خاككارى ۋىلايىتى	Хаккяри (ил)
راۋالپىندى	Равалпинди
Emir Kusturica	Кустурица, Эмир
ماشىنىىسازلىق ئىنژىنىرلىقى	Машиностроение
ئاينۇ مىللىتى	Айны
ئورانگوتان	Человекообразные обезьяны
يېشىل ياقۇت	Берилл
Markus bayan qilghan xush xewer	Евангелие от Марка
ئازۇرىت	Азурит
بېلىز شەھىرى	Белиз (город)
قۇشۇق ئارىلى	Кашыкадасы
مارشال	Маршал
Chuju shehiri	Чучжоу
Rékazé shehiri	Шигадзе
قىرىم	Крымские татары
كىلون تېخنىكىسى	Клонирование (биология)
پروڧېسسور	Профессор
كورىنتلىقلارغا يېزىلغان ئىككىنچى خەت	2-е послание к Коринфянам
مۇغلا ۋىلايىتى	Мугла (ил)
ئاسىيا قارا ئېيىق	Гималайский медведь
گۈلچىلىك	Садоводство
ئىغدىر ۋىلايىتى	Ыгдыр (ил)
ياماگاتا ناھىيىسى	Ямагата (префектура)
قاڭشارلىق بۆكەن	Сайга
كۈتاھيا ۋىلايىتى	Кютахья (ил)
كۆك ياقۇت	Сапфир
كۈرەشچى ئايروپىلان	Истребитель
ئېرتىش دەرياسى	Иртыш
ئىبرانىيلارغا يېزىلغان خەت	Послание к Евреям
گالاتىيلىقلارغا يېزىلغان خەت	Послание к Галатам
شاڭ سۇلالىسى	Шан (династия)
كىلىس ۋىلايىتى	Килис (ил)
تەكىرداغ ۋىلايىتى	Текирдаг (ил)
سان	Бедро
مانىسا ۋىلايىتى	Маниса (ил)
كىچىك مېڭە	Мозжечок
كولوسىلىقلارغا يېزىلغان خەت	Послание к Колоссянам
ياقۇپ يازغان خەت	Послание Иакова
يۇھاننا يازغان بىرىنچى خەت	1-е послание Иоанна
فىلىمۇنغا يېزىلغان خەت	Послание к Филимону
سالونىكىلىقلارغا يېزىلغان ئىككىنچى خەت	2-е послание к Фессалоникийцам
پاۋىل كرۇگمەنن	Кругман, Пол
سالونىكىلىقلارغا يېزىلغان بىرىنچى خەت	1-е послание к Фессалоникийцам
پېترۇس يازغان بىرىنچى خەت	1-е послание Петра
پېترۇس يازغان ئىككىنچى خەت	2-е послание Петра
تىموتىيغا يېزىلغان بىرىنچى خەت	1-е послание к Тимофею
ئېسكىموسلار	Эскимосы
IMMAGINE&POESIA	Живопись и поэзия
چىكاگو ئۇنىۋېرستېتى	Чикагский университет
ماردىن ۋىلايىتى	Мардин (ил)
مالاتيا ۋىلايىتى	Малатья (ил)
مۇش ۋىلايىتى	Муш (ил)
يۇھاننا يازغان ئىككىنچى خەت	2-е послание Иоанна
يۇھاننا يازغان ئۈچىنچى خەت	3-е послание Иоанна
يەھۇدا يازغان خەت	Послание Иуды
تىموتىيغا يېزىلغان ئىككىنچى خەت	2-е послание к Тимофею
تىتۇسغا يېزىلغان خەت	Послание к Титу
قىرقلارەلى ۋىلايىتى	Кыркларели (ил)
ئاليۇمىن ئوكسىدى	Корунд
مەرسىن ۋىلايىتى	Мерсин (ил)
ئوتتۇرا ئاسىيا ياۋا تۆگىسى	Двугорбый верблюд
بۇشەھر ۋىلايىتى	Бушир (остан)
تەكلىماكان قۇملۇقى	Такла-Макан
پاچاق	Нога человека
قاشقىئوغلاق	Енотовидная собака
ئاشمورە ۋە كارتىئەر ئاراللىرى	Острова Ашмор и Картье
قىرشەھەر ۋىلايىتى	Кыршехир (ил)
ئەردەبىل ۋىلايىتى	Ардебиль (остан)
سىنوپ ۋىلايىتى	Синоп (ил)
Ajax	AJAX
ئاتىلار بايرىمى	День отца
شۆلگەي بېزى	Слюнные железы
سېرىق قاشتېشى	Топаз
بىھارى تىلى	Бихарские языки
Teynen shehiri	Тайнань
ۋىتامىنE	Витамин E
سۇلتان توغرۇلبەگ	Тогрул-бек
Xéngyang shehiri	Хэнъян
مالاي ئېيىقى	Малайский медведь
زامان گېزىتى	Zaman
مانجۇ مىللىتى	Маньчжуры
تېرەك	Осина
ھېيدېلبېرگ ئۇنىۋېرستېتى	Гейдельбергский университет
سۇلايمان دېمىرەل	Демирель, Сулейман
ۋەيران بولۇش	Несостоятельность
ج.ۋىللارد گىببس	Гиббс, Джозайя Уиллард
پۇت بارمىقى	Палец ноги
ياغاچچى	Плотник
نىغدە ۋىلايىتى	Нигде (ил)
ئوتتۇرا ئاناتولىيە رايونى	Центральная Анатолия
قارا دېڭىز رايونى	Черноморский регион
شەرقىي ئاناتولىيە رايونى	Восточная Анатолия
يەر ئوتتۇرا دېڭىزى رايونى	Средиземноморский регион (Турция)
ئېگېي رايونى	Эгейский регион
مارمارا رايونى	Мраморноморский регион
شەرقىي جەنۇبىي ئاناتولىيە رايونى	Юго-Восточная Анатолия
لېيدېن ئۇنىۋېرستېتى	Лейденский университет
مېڭە ئاستى بېزى	Гипофиз
تۈر:سىياسىي جۇغراپىيە	Геополитика
مۇرادئۈچ	Мурад III
ئىدىنبۇرگ ئۇنىۋېرستېتى	Эдинбургский университет
فارابى	Аль-Фараби
كۆك قۇتان	Рыжая цапля
گەۋدە	Туловище
ياپونىيىلىك	Японцы
پامىر ئېگىزلىكى	Памир
تولۇق كۇرس	Бакалавр
تۆش بېزى	Тимус
دۆڭچە مېڭىنىڭ ئاستى	Гипоталамус
ئېلېكتر سىغىمى	Электрическая ёмкость
يېشىل تاش	Малахит
سولچى	Левые (политика)
چاناق قەلئە ئۇرۇشى	Дарданелльская операция
بىريۇزا(ياقۇت)	Бирюза
ئەخمەت نەدجەت سەزەر	Сезер, Ахмет Недждет
ۋيېنا ئۇنىۋېرسىتېتى	Венский университет
توشقانسىمان سۈلەيسۈن	Манул
ئافيون قاراھىسار	Афьон-Карахисар
ئوتتۇرا بارماق	Средний палец
ئەبۇ مۇسا جابىر بىن ھەييام	Джабир ибн Хайян
ئوشۇق	Лодыжка
ئادىياما	Адыяман
تاغ ئۆچكىسى	Ибекс
پەنجاب	Пенджаб (регион)
شىيا سۇلالىسى	Ся (династия)
جىنەن شەھىرى	Цзинань
يول بەلگىسى	Дорожный знак
چىڭداۋ شەھىرى	Циндао
كالسېدونىيە	Халцедон
ئاسىيا تېنچ ئوكيان ئىقتىسادىي ھەمكارلىق تەشكىلاتى	Азиатско-Тихоокеанское экономическое сотрудничество
Glutséstér	Глостер
قەشقەر شەھرى	Кашгар
ئىلام ۋىلايىتى	Илам (остан)
نەنچاڭ شەھىرى	Наньчан
بېشىكتاش گىمناستىكا كۇلۇبى	Бешикташ (футбольный клуб)
تۈرك لىراسى	Турецкая лира
ئۆچكە	Горные козлы
بورمودىلى	Боровская модель атома
ھەزىم يولى	Пищевод человека
چاڭشا شەھىر	Чанша
ئۆكچە	Пятка
كېكىردەك	Глотка
ئۇيغقاشتېشى	Жад
ۋىتامىن D	Витамин D
قۇتۇبى ناھىيىسى	Хутуби
2010 دۇنيا لوڭقىسى	Чемпионат мира по футболу 2010
نەسىرىدىن ئەپەندى	Ходжа Насреддин
سۇلايمانىيە جامىى	Сулеймание (мечеть)
كاۋاپ	Кебаб
Wéstminstér Shehiri	Вестминстер (боро Лондона)
نەننىڭ شەھىرى	Наньнин
Durham	Дарем
تۇرغۇت ئۆزال	Озал, Тургут
ﮔﺎﮔﺎﯞﯗﺯ	Гагаузы
بادام بەز	Миндалины
مۇھەممەد خاتەمى	Хатами, Мохаммад
تورونتو ئۇنىۋېرستېتى	Торонтский университет
ساردونىكس	Оникс
تروچكىزم	Троцкизм
ياڭ جىننىڭ	Янг Чжэньнин
Gawshyung	Гаосюн
بىرىكمە ماتېرىيال	Композиционный материал
مېڭە غولى	Мозговой ствол
تاموژنا	Таможня
كۈنمىڭ شەھىرى	Куньмин
ۋىتامىنB	Витамины группы B
ئىسمەت ئىنۆنۈ	Инёню, Исмет
مارگارېت ئاتۋود	Этвуд, Маргарет
خۇيزۇ مىللىتى	Хуэй (народ)
لەنجۇ شەھىرى	Ланьчжоу
Halva	Халва
لى جىڭداۋ	Ли Чжэндао
ماگىستىر	Магистр
كۆرسەتكۈچ بارماق	Указательный палец
ئوتتۇرا مېڭە	Средний мозг
ئۇپسالا ئۇنىۋېرستېتى	Уппсальский университет
Multan	Мултан
خېفېي شەھىر	Хэфэй
ھىيلە	Лучезапястный сустав
ئىپار مۈشۈك ئائىلىسى	Виверровые
ئارقار	Архар
كوپېنھاگېن ئۇنىۋېرستېتى	Копенгагенский университет
قارساق	Корсак
لوياڭ شەھىرى	Лоян
كۇئېنلۇن تاغ تىزمىسى	Куньлунь
تىبەت مىللىتى	Тибетцы
لوندون ئىمپېرىيە ئىنستېتۇت	Имперский колледж Лондона
يىلىك	Продолговатый мозг
گۇيلىن شەھىرى	Гуйлинь
گېئوتىت	Гётит
Xeyko shehir	Хайкоу
مولتىمىتىر	Мультиметр
چىپار بۇغا	Пятнистый олень
بەل	Конечности
يۇگوسلاۋىيە پادىشاھلىقى	Королевство Югославия
ئېۋېنكى مىللىتى	Эвенки
راھىبە	Монахиня
سېرىق ياۋا مۈشۈك	Кошка Темминка
گۇيياڭ شەھىرى	Гуйян
نامسىز بارماق	Безымянный палец
لىمبىك سىستېما	Лимбическая система
تۇرپان	Турфан
ئىلى دەرياسى	Или (река)
مېڭە كۆۋرۈكى	Варолиев мост
دەريا بۇغىسى	Водяной олень
ﺑﺎﻟﻘﺎﺭ ﻣﯩﻠﻠﯩﺘﻰ	Балкарцы
ﻧﻮﻏﺎﻱ ﻣﯩﻠﻠﯩﺘﻰ	Ногайцы
كالا گۆشى	Говядина
گلاسگوۋ ئۇنىۋېرستېتى	Университет Глазго
توخارلار	Тохары
ئابادە	Абаде
ئىستانبۇل ئۇنىۋېرسىتېتى	Стамбульский университет
Tuwa	Тувинцы
بۇرما مۈڭگۈزلۈك بۆكەن	Такин
ئېلېكترون قەۋەت	Электронная оболочка
مۇھەررىر	Редактирование
مىكروسكوپ	Микроскоп
كېمىنىڭ يان تىرەكلىرى	Ребро
جاڭ خىڭ	Чжан Хэн
جاڭ چيەن	Чжан Цянь
موڭغۇلكۈرە ناھىيىسى	Монголкюре
Juko shehiri	Чжоукоу
جۇگىلىياڭ	Чжугэ Лян
زىبو شەھىرى	Цзыбо
سۇلتان ئالىپ ئارىسلان	Алп-Арслан
گوللاندىيىلىكلەر	Голландцы
مەن، ماشىنا ئادەم (كىنو)	Я, робот (фильм)
جۇڭخۇا خەلق جۇمھۇرىيىتىنىڭ ئاساسىي قانۇنى	Конституция Китайской Народной Республики
قاشتېشى	Яшма
تگرین اعظم	Тигран II
كۆكمۇچ	Стручковый перец
چۆل مۈشۈكى	Китайская кошка
جۇڭگو شىنخۇا ئاگېنتلىقى	Синьхуа
Lankastér	Ланкастер
لىجياڭ شەھىرى	Лицзян
چىچىخار شەھىرى	Цицикар
گەبزە	Гебзе
ئەلنى ئىدارە قىلىشقا پايدىلىق ئومۇمىي ئۆرنەكلەر	Цзы чжи тун цзянь
ئۇزۇن قۇيرۇق بۇغا	Олень Давида
سېرىق تەنلىكلەر	Монголоидная раса
Keyféng shehiri	Кайфын
پارىژ ئۇنىۋېرسىتىتى	Парижский университет
مياۋزۇ مىللىتى	Мяо
بېيخەي شەھىرى	Бэйхай
يەنتەي شەھىرى	Яньтай
ﻗﯘﻣﯩﻖ	Кумыки
يىنچۈئەن شەھىرى	Иньчуань
سەئىد قۇتوب	Кутб, Сайид
ئېيقسىمان ئىپار مۈشۈك	Бинтуронг
ئامستېردام ئۇنىۋېرستېتى	Амстердамский университет
ماتېرىيال	Материал
دۇڭزۇ مىللىتى	Дун (народ)
تارىم ئويمانلىقى	Таримская впадина
بۈيۈك ئويۇن	Большая игра
قاراماي يۇقىر سۇرئەتلىك يولى	Каракорумское шоссе
داغۇر مىللىتى	Дауры
ساكاريا دەرياسى	Сакарья (река)
ﺭﺍﺩﯨﺸﺸﯧﯟ	Радищев, Александр Николаевич
ئوۋتېز	Оутс, Джойс Кэрол
مۇدەنجياڭ شەھىرى	Муданьцзян
ناشى مىللىتى	Наси (народ)
ۋاشىنگتون ئۇنىۋېرستېتى	Вашингтонский университет
زونگۇلداق ۋىلايىتى	Зонгулдак (ил)
سېرىق بوغۇز بولغۇن	Харза
شىزاڭ ياۋا ئېشىكى	Кианг
بىرمىنگام ئۇنىۋېرستېتى	Бирмингемский университет
چىمەلتەك	Мизинец
بىلەك	Предплечье
ماتېرىيال ئىلمى	Материаловедение
ھەنبەلىي مەزھىبى	Ханафитский мазхаб
سەي لۇن	Цай Лунь
قوڭۇر بۇغا	Индийский замбар
مىچىگان ئۇنىۋېرستېتى	Мичиганский университет
ئىرۇسالىمغا قايتىش ھەركىتى	Назад в Иерусалим!
ﺋﺎﻗﺴﺎﻱ ﭼﯩﻦ	Аксайчин
مانچېستېر ئۇنىۋېرستېتى	Манчестерский университет
تارپان	Тарпан
امينة ساندال	Яхович, Эмина
ئاق تەنلىكلەر	Белые люди
تارىم دەرياسى	Тарим
مىننېسوتا ئۇنىۋېرستېتى	Миннесотский университет
فۇكاڭ شەھىرى	Фукан
ئورخان پامۇك	Памук, Орхан
ئەرتۇغرۇل غازى	Эртогрул
ﻗﺎﺭﺍ ﭼﺎﻱ ﻣﯩﻠﻠﯩﺘﻰ	Карачаевцы
نەجمەتتىن ئەرباقان	Эрбакан, Неджметтин
ﺋﺎﻟﺘﺎﻱ مىللىتى	Алтайцы
Teyjong shehiri	Тайчжун
ﻛﺎﺷﻜﺎﻱ	Кашкайцы
مىللەتچى ھەركەت پارتىيىسى	Партия националистического движения (Турция)
ھەيبەلى ئارىلى	Хейбелиада
ﭼﯘﯞﺍﺵ ﻣﯩﻠﻠﯩﺘﻰ	Чуваши
گيېموسخۇس بۇغىسى	Водяной оленёк
ئىسپارتا ۋىلايىتى	Ыспарта (ил)
قوڭۇر يىلپىز	Дымчатые леопарды
چىقچىق	Малый погоныш
سېرىق ئاغمىخان	Колонок
شىزاڭ بۆكىن	Оронго
چانقىرى ۋىلايىتى	Чанкыры (ил)
چورۇم ۋىلايىتى	Чорум (ил)
ئىران ئەزەربەيجان	Иранский Азербайджан
تۈركىيە بۈيۈك مىللەت مەجلىسى	Великое национальное собрание Турции
بەيزۇ مىللىتى	Бай (народ)
ﻗﺎﺭﺍ ﻗﺎﻟﭙﺎﻕ ﻣﯩﻠﻠﯩﺘﻰ	Каракалпаки
ئوسمانىيە ۋىلايىتى	Османие (ил)
تۇرپان ئويمانلىغى	Турфанская впадина
رابىيە قادىر	Кадир, Рабия
سەزەن ئاقسۇ	Сезен Аксу
جاندان ارچتین	Эрчетин, Джандан
ۋەن مارۋىجىك	Марвейк, Берт ван
Hidayet Türkoghli	Туркоглу, Хедо
داچىڭ شەھىر	Дацин
لىزۇ مىللىتى	Ли (народ)
سۇلتان مەلىك شاھ	Мелик-шах I
مەھمەت ئەلىي تالات	Талат, Мехмет Али
ئابدۇراخمان جامى	Джами
مېلبۇرن ئۇنىۋېرستېتى	Мельбурнский университет
Dünxuang Shehiri	Дуньхуан
لوپنۇر	Лобнор
Senya shehiri	Санья (город)
Dostum	Дустум, Абдул-Рашид
ئەكمەلىتتىن ئىھسان ئوغلۇ	Ихсаноглу, Экмеледдин
مۇستاپا ساندال	Сандал, Мустафа
تاغ بورسۇقى	Китайский барсук
ئۈرۈمچى ناھىيىسى	Урумчи (уезд)
سالار مىللىتى	Салары
كيوتو ئۇنىۋېرستېتى	Киотский университет
بادام؛بادام؛بادام	Миндалевидное тело
ئىستانبۇل تېخنىكا ئۇنىۋېرسىتېتى	Стамбульский технический университет
ئىزمىر ۋىلايىتى	Измир (ил)
ئاد قەۋمى	Адиты
بۇغدىيەك	Выступ гортани
بېڭبۇ شەھەرى	Бэнбу
خۇەينەن شەھىرى	Хуайнань
مائەنشەن شەھىرى	Мааньшань
ئەنچىڭ شەھىرى	Аньцин
ياۋزۇ مىللىتى	Яо (народ)
ئەرزۇرۇم ۋىلايىتى	Эрзурум (ил)
يۇنۇس ئەمرە	Юнус Эмре
بىلگە قاغان	Бильге-хан Богю
باتۇر تەڭرىقۇت	Модэ
ئەپراسىياپ	Афрасиаб (правитель)
سۇلتان بەكيارۇق	Баркиярук
شانلى ئۇرفا ۋىلايىتى	Шанлыурфа (ил)
شهرزاد	Шахерезада (композитор)
ترابزون ۋىلايىتى	Трабзон (ил)
برىتانى كولۇمبىيە ئۇنىۋېرستېتى	Университет Британской Колумбии
Metta bayan qilghan xush xewer	Евангелие от Матфея
ئەلبورز ۋىلايىتى	Альборз
خوجا ئەھمەد يەسەۋى	Ахмед Ясави
Tekshi choqqiliq tagh shehiri	Пиндиншань
شىنشياڭ شەھىرى	Синьсян
Nenyang shehiri	Наньян
Shinyang shehiri	Синьян
ئەفەسلىكلەرگە يېزىلغان خەت	Послание к Ефесянам
زەمچە	Сульфат алюминия-калия
ﺋﯩﻜﻜﯩﻨﭽﻰ ﻗﯩﺘﯩﻤﻠﯩﻖ ﯬﭘﻴﯘﻥ ﯰﺭﯗﺷﻰ	Вторая Опиумная война
ئاقچى ناھىيىسى	Акчи
ئاقسۇ ۋىلايىتى	Аксу (округ)
ئاقسۇ شەھىرى	Аксу (уезд)
ئاقسۇ دەرياسى	Аксу (приток Тарима)
تېتراپىررول	Тетрапирролы
ئاقتو ناھىيىسى	Акто
ميەنياڭ شەھىرى	Мяньян
ھلا رەڭ	Розовый цвет
نەۋشەھەر ۋىلايىتى	Невшехир (ил)
نازارې	Назарет
سۇماترا بۆكىنى	Суматранский серау
دۈزجە ۋىلايىتى	Дюздже (ил)
ئالتاي شەھىرى	Алтай (город, Китай)
قۇندۇز ئۇرۇقدىشى	Выдры
بەشىكتاش	Бешикташ (район)
برىستول ئۇنىۋېرستېتى	Бристольский университет
ئاق بوغۇز بۆكەن	Джейран
يىزۇ مىللىتى	И (народ)
روزا ھېيت	Ураза-байрам
كۆكمەت	Нахур
شېڭ شىسەي	Шэн Шицай
بۈلەنت ئەرسوي	Эрсой, Бюлент
يالىڭاچ قۇياش	Обнажённое солнце
نوتتىڭخام ئۇنىۋېرستېتى	Ноттингемский университет
تايلاندلىقلار	Тайцы
نەمەنگان ۋىلايىتى	Наманганская область
ھانى مىللىتى	Хани (народ)
پولات قەلئەلەر	Стальные пещеры
گىرەسۇن ۋىلايىتى	Гиресун (ил)
گۈمۈشخانە ۋىلايىتى	Гюмюшхане (ил)
سىئىرت ۋىلايىتى	Сиирт (ил)
قاھرامان ماراش ۋىلايىتى	Кахраманмараш (ил)
ئومۇرتقا	Позвоночник
قارامان ۋىلايىتى	Караман (ил)
سامسۇن ۋىلايىتى	Самсун (ил)
ئۆزبېك مىللىتى	Узбеки
ئەسكىشەھەر ۋىلايىتى	Эскишехир (ил)
بايبۇرت ۋىلايىتى	Байбурт (ил)
ئۇشاق ۋىلايىتى	Ушак (ил)
يالوۋا ۋىلايىتى	Ялова (ил)
ئەلازىغ ۋىلايىتى	Элязыг (ил)
سىۋاس ۋىلايىتى	Сивас (ил)
غازى ئانتەپ ۋىلايىتى	Газиантеп (ил)
قارابۈك ۋىلايىتى	Карабюк (ил)
ئەرزىنجان ۋىلايىتى	Эрзинджан (ил)
ئوردۇ ۋىلايىتى	Орду (ил)
كاستامونۇ ۋىلايىتى	Кастамону (ил)
توقات ۋىلايىتى	Токат (ил)
نورۇز بايرىمى	Новруз
كايسەرى ۋىلايىتى	Кайсери (ил)
رىزە ۋىلايىتى	Ризе (ил)
تاجىك مىللىتى	Таджики
مۇھەممەد ئىقبال	Икбал, Мухаммад
پارسلار	Персы
قاراقالپاقىستان	Каракалпакстан
قىرىققالە ۋىلايىتى	Кырыккале (ил)
قىرغىز مىللىتى	Киргизы
شاڭخەي ھەمكارلىق تەشكىلاتى	Шанхайская организация сотрудничества
تۈركىيە دەرىجىدىن تاشقىرى ئايلانمىسى	Чемпионат Турции по футболу
تاركان	Таркан
ﻳﺎﻗﯘﺕ ﻣﯩﻠﻠﯩﺘﻰ	Якуты
فەرغانە ئويمانلىقى	Ферганская долина
فەرغانە	Фергана
Kanzas Shehiri, Kanzas	Канзас-Сити (Канзас)
پەرغانە ۋىلايىتى	Ферганская область
بۇخارا ۋىلايىتى	Бухарская область
ئەنجان ۋىلايىتى	Андижанская область
سەمەرقەنت ۋىلايىتى	Самаркандская область
سۇرخاندەريا ۋىلايىتى	Сурхандарьинская область
چاغاتاي خان	Чагатай
سىردەريا ۋىلايىتى	Сырдарьинская область
سىدنېي ئۇنىۋېرستېتى	Сиднейский университет
خارەزىم ۋىلايىتى	Хорезмская область
نەۋايى ۋىلايىتى	Навоийская область
قاشقادەريا ۋىلايىتى	Кашкадарьинская область
تاشكەنت ۋىلايىتى	Ташкентская область
ئانا ۋەتەن پارتىيىسى	Партия Отечества
جىزاق ۋىلايىتى	Джизакская область
ئاۋكلاند ئۇنىۋېرستېتى	Оклендский университет
قاراخانىيلار خانلىقى	Караханидское государство
چىپار بۆكەن	Горал
ئوغۇزلار	Огузы
كۆمۈرچەك	Хрящ
ئەلشىر ناۋائى	Алишер Навои
جەنۋە ئۇنىۋېرستېتى	Университет Женевы
قىزىل تاغ	Огненные горы
تارىم توشقىنى	Яркендский заяц
Openoffice	OpenOffice
قۇربان ھېيت	Курбан-байрам
تىمساھ	Аллигаторы
ئىستانبۇل ۋىلايىتى	Стамбул (ил)
Kökxot shehiri	Хух-Хото
بەزگە مۇناسىۋەتلىك	Аденоиды
ياقۇب بەگ	Магомет Якуб бек Бадаулет
يەكەن دەرياسى	Яркенд (река)
مەھمۇد قەشقىرى	Махмуд аль-Кашгари
باۋتۇ شەھىر	Баотоу
كۈنەس ناھىيىسى	Кюнес
سوغدى يېزىقى	Согдийское письмо
كىنالى ئارىلى	Кыналыада
رومبىسىمان كرىستال كاتەكچىسى	Тригональная сингония
تۇجيا مىللىتى	Туцзя (народ)
توقسۇن ناھىيىسى	Токсун
تېھران ۋىلايىتى	Тегеран (остан)
تۆش	Грудь беспозвоночных
موناش ئۇنىۋېرستېتى	Университет Монаша
بوکان	Букан
رېگان ئىقتىسادشۇناسلىقى	Рейганомика
ئۇلۇغچات ناھىيىسى	Улугчат
دۇلۇڭ مىللىتى	Дулуны
تۇنجەلى ۋىلايىتى	Тунджели (ил)
ئارال شەھرى	Арал (Китай)
خوتەن دەرياسى	Хотан (река)
چىپار يۈز قوڭغارچا	Гималайская цивета
ئارا تۈرۈك ناھىيىسى	Аратюрюк
مۇز تاغ ئاتا	Музтагата
قابا ناھىيىسى	Каба (уезд)
ئالبېرتا ئۇنىۋېرستېتى	Альбертский университет
قوي گۆشى	Баранина
چەرچەن ناھىيىسى	Черчен (уезд)
تارباغاتاي ۋىلايىتى	Чугучак (округ)
قوڭۇر تاغ	Конгур
خەينە بۇغىسى	Олень-лира
شىرناق ۋىلايىتى	Ширнак (ил)
چۆچەك شەھىرى	Чугучак
قالقانسىمان يان بەز	Паращитовидные железы
قۇمۇل شەھىرى	Хами
ئوساكا ئۇنىۋېرستېتى	Осакский университет
ﺗﻮﻓﺎ ﻣﯩﻠﻠﯩﺘﻰ	Тофалары
قاراماي شەھىرى	Карамай
ئاتۇش شەھىرى	Артуш
ئارىشاڭ ناھىيىسى	Аршан (Синьцзян)
بۇيى مىللىت	Буи (народ)
سۈلەيسۈن	Рыси
تارماشىرىن	Тармаширин
نان	Наан (блюдо)
دۇنيا ئۇيغۇر قۇرۇلتىيى	Всемирный уйгурский конгресс
بۆرەك ئۈستى بېزى	Надпочечники
لىمفا ئىشلەپچىقىرىدىغان	Лимфатическая система
يانپاش	Таз (анатомия)
ISO 639-1	ISO 639-1
چوسون مىللىتى	Корейцы в Китае
تەيۋەن بۆكىنى	Capricornis swinhoei
جاڭ چۈنشيەن	Чжан Чуньсянь
ۋاڭ لېچۈەن	Ван Лэцюань
يۇڭ تاجلىق بۇغا	Хохлатый олень
ھىمالايا چۇپۇرلۇق قويى	Гималайский тар
ئاق تۇمشۇق بۇغا	Беломордый олень
ئۇرال - ئالتاي تىللىرى سېستىمىسى	Урало-алтайская гипотеза
جەم يىلماز	Йылмаз, Джем
تيېرى مېيىسسان	Мейсан, Тьерри
شېزۇ مىللىتى	Шэ (народ)
ﺗۈﺭﻛﯩﻲ ﺗﯩﻠﻼﺭ ﺩﯨﯟﺍﻧﻰ	Диван лугат ат-турк
قەشقەر ۋىلايىتى	Кашгар (округ)
نەي	Ней (инструмент)
تىن تىننىڭ سەرگۈزەشتىلىرى	Приключения Тинтина
يوپۇرغا ناھىيىسى	Юпурга
دۇڭشياڭ مىللىتى	Дунсян
لاخۇ مىللىتى	Лаху (народ)
بازا	Основание (роман)
قارىقۇيرۇق	Дзерен
چوڭ ئىپار مۈشۈك	Большая виверра
مەكىت ناھىيىسى	Меркет (уезд)
ئۈرۈمچى دىۋوپۇ خەلقئارا ئايروپورتى	Дивопу (аэропорт)
ئالتاي ۋىلايىتى	Алтай (округ)
ۋۇجياچۈ شەھىرى	Уцзяцюй
ئاۋات ناھىيىسى	Ават
ئايدىڭكۆل	Айдынкёль
بابۇر	Бабур
جەرەنبۇلاق رايونى	Джеренбулак
باركۆل قازاق ئاپتونوم ناھىيىسى	Баркёль-Казахский автономный уезд
باي ناھىيىس	Бай (уезд)
بايىنغولىن موڭغۇل ئاپتونوم ئوبلاستى	Баянгол-Монгольский автономный округ
بونان مىللىتى	Баоань (народ)
ئورخۇن ئۇيغۇر خانلىقى	Уйгурский каганат
بورىس ۋاسىلىيىۋ	Васильев, Борис Львович
كورلا شەھىرى	Корла
بازا ۋە ئىمپىرىيە	Основание и Империя
دەيزۇ مىللىتى	Дайцы
مېنبا مىللىتى	Монпа
شەرقىي تۈركىستان	Восточный Туркестан
چياڭزۇ مىللىتى	Цян (народ)
ۋازۇ مىللىتى	Ва
5-ئىيۇل ۋەقەسى	Волнения уйгур в Урумчи (2009)
تاجىسىمان يۇرەك قان تومۇر كېسىلى	Коронарная недостаточность
شىمالىي ئامېرىكىلىق	Американцы США
ئىلى قازاق ئاپتونوم ۋىلايىتى	Или-Казахский автономный округ
قىز مۇنارى	Девичья башня (Стамбул)
شىخەنزە شەھىرى	Шихэцзы
دوكتور ئاسپرانتى	Докторантура
ئاچاڭ مىللىتى	Ачаны
تۇزۇ مىللىتى	Монгоры
ئېگىز تاغ بۆكىنى	Тибетский дзерен
ئىككىنچى بازا	Второй фонд
لوبا مىللىتى	Лоба (народ)
يەكەن ناھىيىسى	Яркенд
لىسۇ مىللىتى	Лису (народ)
QQ	Tencent QQ
تېڭشۈن شىركىتى	Tencent
قىزىلسۇ قىرغىز ئاپتونوم ئوبلاستى	Кызылсу-Киргизский автономный округ
كۋېنسلاند ئۇنىۋېرستېتى	Квинслендский университет
غۇلجا شەھىرى	Кульджа
نۇزۇ مىللىتى	Ну (народ)
مۇلاۋ مىللىتى	Мулао
تۇرپان ۋىلايىتى	Турфан (округ)
تۇڭگان مىللىتى	Дунгане
بورتالا موڭغۇل ئاپتونوم ئوبلاستى	Боро-Тала-Монгольский автономный округ
ﺷﻮﺭ ﻣﯩﻠﻠﯩﺘﻰ	Шорцы
پۇمى مىللىتى	Пуми (народ)
قئارئاهوجئا	Гаочан
布朗族	Буланы
باغراش ناھىيىسى	Баграш
بورتالا شەھىرى	Боро-Тала (уезд)
جىمىسار ناھىيىسى	Джимасар
تاشقۇرقان تاجىك ئاپتونوم ناھىيىسى	Ташкурган-Таджикский автономный уезд
روبوت چاتما رومانى	Детектив Элайдж Бейли и робот Дэниел Оливо
قىزىل بۆكەن	Тибетский горал
ياردەم:ياردەم	Википедия:Справка
خوتەن ناھىيىسى	Хотан (уезд)
لوپ ناھىيىسى	Лоп (уезд)
بازىنىڭ چېتى	Академия на краю гибели
يۈسۈپ خاس ھاجىپ	Юсуф Баласагуни
ئورقۇ رايونى	Урхо
تاشقۇرغان	Ташкурган (Китай)
شىنجاڭ ئۇنىۋېرستېتى	Синьцзянский университет
ئىپارخان	Ипархан
شەرقى تۈركىستان جۇمھۇرىيىتى	Восточно-Туркестанская Исламская республика
تۇمشۇق شەھىرى	Тумшук
بۈيۈك ئارال	Бююкада
خوتەن ۋىلايىتى	Хотан (округ)
قۇمۇل ۋىلايىتى	Хами (округ)
سانجى خۇيزۇ ئاپتونوم ئوبلاستى	Чанцзи-Хуэйский автономный округ
كۈيتۇن شەھىرى	Куйтун (город, Китай)
سانجى شەھىرى	Чанцзи
چاپچال شىبە ئاپتونوم يېزىسى	Чапчал-Сибоский автономный уезд
فارس ۋىلايىتى	Фарс (остан)
بۇرگاز ئارىلى	Бургаз
بۇرچىن ناھىيىسى	Бурчун
بۇرۇلتوقاي ناھىيىسى	Бурултокай
يېڭىسار ناھىيىسى	Янгигисар
ۋۇسۇ شەھىرى	Усу
دۆربىلجىن ناھىيىسى	Дурбульджин
پوسكام ناھىيىسى	Посгам
گۇچۇڭ ناھىيىسى	Цитай
قورغاس ناھىيىسى	Хочэн
يەنجى خۇيزۇ ئاپتونوم ناھىيىسى	Яньци-Хуэйский автономный уезд
لوپنۇر ناھىيىسى	Лоп-Нур
كوكتوقاي ناھىيىسى	Кёктокай (уезд)
قوبۇقسار موڭغۇل ئاپتونوم ناھىيىسى	Хобоксар-Монгольский автономный уезд
قەشقەر كونا شەھەر ناھىيىسى	Шуфу
ساۋەن ناھىيىسى	Шавань (Чугучак)
قاغىلىق ناھىيىسى	Каргалык (уезд)
خېجىڭ ناھىيىسى	Хэцзин
چاغانتوقاي ناھىيىسى	Юйминь
پىچان ناھىيىسى	Пичан (уезд)
كۇچار ناھىيىسى	Куча (уезд)
مايتاغ رايونى	Майтаг
چاقىلىق ناھىيىسى	Чарклык (уезд)
بۈگۈر ناھىيىسى	Бугур
قەشقەر يېڭىشەھەر ناھىيىسى	Янгишар
شايار ناھىيىسى	Шахъяр
مارالبېشى ناھىيىسى	Маралбаши
ماناس ناھىيىسى	Манас (уезд)
ئونسۇ ناھىيىسى	Вэньсу
چىڭگىل ناھىيىسى	Чингиль (уезд)
پەيزاۋات ناھىيىسى	Пайзиват
مورى قازاق ئاپتونوم ناھىيىسى	Моры-Казахский автономный уезд
تولى ناھىيىسى	Толи
خوشۇت ناھىيىسى	Хошуд
يېڭىشەھەر رايونى	Синьши (Урумчи)
تۇدۇڭخابا رايونى	Тоутуньхэ
تەڭرىتاغ رايونى	Тяньшань (Урумчи)
داۋانچىڭ رايونى	Дабаньчэн
گۇما ناھىيىسى	Гума (уезд)
سايباغ رايونى	Сайбаг
ئاشقازان	Желудок человека
ئېلىك	Косули
شىبە مىللىتى	Сибо
كىنو مىللىتى	Цзино (народ)
كروران قەدىمكى شەهىرى	Лоулань
ئورۇنچون مىللىتى	Орочоны
ئەنقەرە ئۇنىۋېرسىتېتى	Университет Анкары
مۇسئەب ئىبن ئۆمەير	Мусаб ибн Умайр
پېشاۋار	Пешавар
دۇتار	Дутар
كونا تاڭنامە	Книга Тан
مۇئاز ئىبنى جەبەل	Муаз ибн Джабаль
قاراشەھەر بازىرى	Карашар
سۈينامە	Книга Суй
سەئىدىيە خانلىقى	Могулия
تۇغلۇق تۆمۇرخان	Тоглук-Тимур
قارا ھۈلەگۈ	Хара-Хулагу
ئۇچتۇرپان ناھىيىسى	Учтурфан
چىرا ناھىيىسى	Чира (уезд)
كەلپىن ناھىيىسى	Кельпин
قاراقاش ناھىيىسى	Каракаш (уезд)
جىڭ ناھىيىسى	Цзинхэ
نىيە ناھىيىسى	Ния (уезд)
غۇلجا ناھىيىسى	Кульджа (уезд)
شۇيموگۇ رايونى	Шуймогоу
كېرىيە ناھىيىسى	Керия (уезд)
تۇخۇم نەيچىسى	Фаллопиевы трубы
ئابادە ناھىيىسى	Абаде (шахрестан)
شىنجاڭ ئىشلەپچىقىرىش - قۇرۇلۇش بىڭتۇەنى	Синьцзянский производственно-строительный корпус
قەشقەر ھېيتگاھ مەسچىتى	Ид Ках
شياڭگاڭ پەن ـ تېخنىكا ئۇنىۋېرسىتېتى	Гонконгский университет науки и технологии
دۇۋا	Дува
باراق	Борак-хан
ﻣﯧﯔ ﺟىيەنﺠﯘ	Мэн Цзяньчжу
جېمىنەي ناھىيىسى	Зимунай
توققۇزتارا ناھىيىسى	Токкузтара
قاراماي رايونى	Карамай (район)
نىلقا ناھىيىسى	Нилки (уезд)
مۇرات ناسىروۋ	Насыров, Мурат Исмаилович
رۇس مىللىتى	Русские в Китае
تېكەس ناھىيىسى	Текес (уезд)
توقسۇ ناھىيىسى	Токсу
ئېسفەھان ۋىلايىتى	Исфахан (остан)
تۈر:تۈركىيە	Категория:Турция
تۈر:ئۆسۈملۈك	Категория:Растения
تۈر:فىزىكا	Категория:Физика
تۈر:تەبىئىي پەن	Категория:Естественные науки
تۈر:Geografia	Категория:География
غازى ئۇنىۋېرسىتېتى	Университет Гази
قەشقەر دەرياسى	Кашгар (река)
غىجەك	Гайчак
كۆكتوقاي بازىرى	Кёктокай
لەغمەن	Лагман
خۇيزۇ	Хуй (значения)
دوگانا	Догана
سالانق تەشمەسى	Саланг
تۈر:خرىستىئان دىنى	Категория:Христианство
بارلاس قەبىلىسى	Барласы
قەدىمكى ئۇيغۇر يېزىقى	Староуйгурское письмо
جىڭزۇ مىللىتى	Вьеткьеу
ئائىلە جەمئىيەتشۇناسلىقى	Социология семьи
ئەنقەرە ۋىلايىتى	Анкара (ил)
قاراقاش دەرياسى	Каракаш (река)
يورۇڭقاش دەرياسى	Юрункаш
ئەرەب ھەرپلىرى ئاساسىدىكى ئۇيغۇر يېزىقى	Уйгурская письменность
چەرچەن دەرياسى	Черчен (река)
تۇنيۇقۇق	Тоньюкук
قاراباغ	Карабах
ئىراق ۋە شام ئىسلام دۆلىتى	Исламское государство Ирака и Леванта
بۇزان	Бузан-хан
پۇشتۇ مىللىتى	Пуштуны
يەسۈ مۆڭكە	Есу-Мункэ
تارانچى	Илийские уйгуры
مەشرەپ	Мэшрэп
شىخەنزە ئۇنىۋېرسىتېتى	Университет Шихэцзы
قەشقەر ئايىرپورت	Кашгар (аэропорт)
مۇقام	Двенадцать уйгурских мукамов
ئابدۇخالىق ئۇيغۇر	Абдухалик Уйгур
ئەخمەتجان ﻗﺎﺳﯩﻤﻰ	Ахметжан Касыми
ئەلجىگىدەي	Ильчигидай
گېئورگى بۇچنېر ئەدەبىيات مۇكاپاتى	Премия Георга Бюхнера
تىيىندورىشۇتى تەڭرىقۇت	Шицзы
توشقان دەرياسى	Таушкандарья
شىتۇڭشىجۇ قۇت تەڭرىقۇت	Ди (шаньюй)
شولان شىسۇقۇتى تەڭرىقۇت	Туньтухэ
چاڭ	Ченг
كىئۇچۇ گۇيلىنت تەڭرىقۇت	Су (шаньюй)
ئەنگور تەڭرىقۇت	Аньго (шаньюй)
كىئۇفۇيۇتى تەڭرىقۇت	Мо (шаньюй)
غۇيەشى سۇقۇتى تەڭرىقۇت	Чжан (шаньюй)
مۇباراك شاھ	Мубарек-шах
ئابدۇرېھىم ئۆتكۈر	Абдурахим Тилешуп Откур
سۇلتان سەئىدخان	Султан-Саид-хан
دۇۋا تۆمۇرخان	Дурра Тимур-хан
قوغشار تەڭرىقۇت	Хуханье II
نۇر بەكرى	Нур Бекри
بىنەپشە رەڭ	Пурпурный цвет
سەيپىدىن ئەزىزى	Азизов, Сайфутдин
پراۋوسلاۋىيە دىنى	Православие
تەمبۈر	Танбур
Ördek	Утки
قېلىپ:Tl	Шаблон:Tl
قېلىپ:Userbox	Шаблон:Userbox
Wikipedia:Administrators	Википедия:Администраторы
تۈر:جۇڭخۇا مىللەتلىرى	Категория:Народы Китая
مىسىر	Египет
زوردۇن سابىر	Зордун Сабир
قېلىپ:Bot	Шаблон:Bot
كانادا	Канада
Wikipedia:ھەققىدە	Википедия:Описание
شىنجاڭ گېزىتى	Синьцзян жибао
قېلىپ:Flagicon	Шаблон:Флаг
قېلىپ:Documentation	Шаблон:Doc
Sung Jae-gi	Сон Джэги
ئىنەك	Крупный рогатый скот
قېلىپ:Softredirect	Шаблон:Soft redirect
قېلىپ:Delete	Шаблон:К быстрому удалению
تۈر:تىل	Категория:Языки
Wikipedia:General disclaimer	Википедия:Отказ от ответственности
قېلىپ:Navbox	Шаблон:Navbox
ئورقۇن-يېنسەي يېزىقى	Древнетюркское руническое письмо
خالتىلىق چاشقان	Кенгуру
قېلىپ:Tnavbar	Шаблон:Tnavbar
قېلىپ:Babel	Шаблон:Babel
قېلىپ:Commons	Шаблон:Commons
قېلىپ:Reflist	Шаблон:Примечания
قېلىپ:Stub	Шаблон:Заготовка
قېلىپ:User az	Шаблон:User az
قېلىپ:User de	Шаблон:User de
قېلىپ:User de-1	Шаблон:User de-1
قېلىپ:User es	Шаблон:User es
قېلىپ:User de-3	Шаблон:User de-3
قېلىپ:User en-3	Шаблон:User en-3
قېلىپ:User en-1	Шаблон:User en-1
قېلىپ:User en-2	Шаблон:User en-2
قېلىپ:User en-4	Шаблон:User en-4
قېلىپ:User en	Шаблон:User en
قېلىپ:User de-2	Шаблон:User de-2
قېلىپ:User es-1	Шаблон:User es-1
قېلىپ:User fr-1	Шаблон:User fr-1
قېلىپ:User ja-4	Шаблон:User ja-4
قېلىپ:User sk	Шаблон:User sk
قېلىپ:User tr-2	Шаблон:User tr-2
قېلىپ:User tr	Шаблон:User tr
قېلىپ:User ja	Шаблон:User ja
قېلىپ:User ja-1	Шаблон:User ja-1
قېلىپ:User fr	Шаблон:User fr
قېلىپ:Location map/Info	Шаблон:ПозКарта/Инфо
قېلىپ:Mod	Шаблон:Mod
قېلىپ:Welcome	Шаблон:Приветствие
تۈر:كىشلىك ئالاقە	Категория:Общение
تۈر:User fr-1	Категория:User fr-1
قېلىپ:ئافرىقا	Шаблон:Страны Африки
قېلىپ:Country data NEP	Шаблон:Флагификация/Непал
تۈر:User en-4	Категория:User en-4
تۈر:User en	Категория:User en
تۈر:User zh	Категория:User zh
تۈر:User zh-N	Категория:User zh-N
تۈر:User en-2	Категория:User en-2
قېلىپ:Infobox	Шаблон:Карточка
قېلىپ:ئىراننىڭ ۋىلايەتلىرى	Шаблон:Останы Ирана
قېلىپ:User zh	Шаблон:User zh
قېلىپ:Navbox/core	Шаблон:Navbox/core
قېلىپ:Legend	Шаблон:Легенда
قېلىپ:Ombox	Шаблон:Ombox
قېلىپ:Pp-template	MediaWiki:Protectedpagetext
قېلىپ:Babel-4	Шаблон:Babel-4
قېلىپ:User ru	Шаблон:User ru
تۈر:دۆلەت	Категория:Государство
قېلىپ:IPA	Шаблон:IPA1
قېلىپ:ئىنجىل	Шаблон:Книги Нового Завета
قېلىپ:ئوكيانىيە	Шаблон:Океания
قېلىپ:Unreferenced	Категория:Википедия:Статьи без ссылок на источники
قېلىپ:جۇڭخۇا خەلق جۇمھۇرىيىتى	Шаблон:Провинции КНР
قېلىپ:Provinces of Uzbekistan	Шаблон:Области Узбекистана
قېلىپ:ياپونىيە	Шаблон:Регионы и административное деление Японии
تۈر:User ja-N	Категория:User ja-N
تۈر:سانائەت	Категория:Отрасли экономики и промышленности
قېلىپ:Tick	Шаблон:Ok
قېلىپ:رۇسىيە	Шаблон:Субъекты Российской Федерации
قېلىپ:Infobox person	Шаблон:Персона
قېلىپ:ياۋروپا	Шаблон:Страны Европы
تۈر:User az	Категория:User az
تۈر:User sk	Категория:User sk
تۈر:User fr	Категория:User fr
تۈر:User ja	Категория:User ja
تۈر:User mn	Категория:User mn
تۈر:User az-3	Категория:User az-3
تۈر:User fr-3	Категория:User fr-3
تۈر:User ja-3	Категория:User ja-3
تۈر:User tr-3	Категория:User tr-3
تۈر:User tr-1	Категория:User tr-1
تۈر:User fr-4	Категория:User fr-4
تۈر:User fr-2	Категория:User fr-2
تۈر:User ja-2	Категория:User ja-2
تۈر:User kk-2	Категория:User kk-2
تۈر:User tr-2	Категория:User tr-2
تۈر:User ko-N	Категория:User ko-N
تۈر:User fr-N	Категория:User fr-N
تۈر:User ru-N	Категория:User ru-N
تۈر:User fr-5	Категория:User fr-5
تۈر:User az-1	Категория:User az-1
تۈر:User az-2	Категория:User az-2
تۈر:User az-4	Категория:User az-4
تۈر:User az-N	Категория:User az-N
تۈر:User sk-N	Категория:User sk-N
تۈر:User de	Категория:User de
تۈر:User de-2	Категория:User de-2
تۈر:User de-3	Категория:User de-3
تۈر:User de-4	Категория:User de-4
تۈر:User de-N	Категория:User de-N
شىراز	Шираз
تۈر:User en-3	Категория:User en-3
تۈر:User en-N	Категория:User en-N
تۈر:User es	Категория:User es
تۈر:User es-1	Категория:User es-1
تۈر:User es-N	Категория:User es-N
تۈر:User ja-1	Категория:User ja-1
تۈر:User kk	Категория:User kk
تۈر:User kk-3	Категория:User kk-3
تۈر:User kk-4	Категория:User kk-4
تۈر:User kk-N	Категория:User kk-N
تۈر:User ko	Категория:User ko
تۈر:User ko-3	Категория:User ko-3
تۈر:User ky	Категория:User ky
تۈر:User ky-2	Категория:User ky-2
تۈر:User ky-N	Категория:User ky-N
تۈر:User ru-1	Категория:User ru-1
تۈر:User mn-1	Категория:User mn-1
قېلىپ:Table Greekletters	Шаблон:Греческий алфавит
باشقۇرغۇچى مەشغۇلات قوللانمىسى	Википедия:Памятка администратору
تۈر:User zh-min-nan	Категория:User nan
قېلىپ:User ru-2	Шаблон:User ru-2
تۈر:User ru	Категория:User ru
تۈر:User tk	Категория:User tk
تۈر:User tr	Категория:User tr
تۈر:User tr-4	Категория:User tr-4
تۈر:User tr-N	Категория:User tr-N
تۈر:User ug	Категория:User ug
تۈر:User ug-1	Категория:User ug-1
تۈر:User ug-N	Категория:User ug-N
تۈر:User uz	Категория:User uz
تۈر:User uz-3	Категория:User uz-3
قېلىپ:Infobox City Japan	Шаблон:НП-Япония
تۈر:ۋىتامىنلار	Категория:Витамины
قېلىپ:User ru-1	Шаблон:User ru-1
قېلىپ:User tr-1	Шаблон:User tr-1
قېلىپ:User tr-3	Шаблон:User tr-3
قېلىپ:User uz	Шаблон:User uz
قېلىپ:User zh-1	Шаблон:User zh-1
قېلىپ:User zh-2	Шаблон:User zh-2
قېلىپ:User zh-3	Шаблон:User zh-3
قېلىپ:User zh-4	Шаблон:User zh-4
تۈر:User zh-1	Категория:User zh-1
تۈر:User zh-4	Категория:User zh-4
تۈر:User zh-3	Категория:User zh-3
تۈر:User zh-2	Категория:User zh-2
تۈر:خىمىيىۋى ئېلېمېنت	Категория:Химические элементы
تۈر:لېكسىكولوگىيە	Категория:Лексикология
تۈر:ئۆزبېكىستان	Категория:Узбекистан
تۈر:جەمئىيەت مەسلىسى	Категория:Социальные проблемы
تۈر:ئاتوم يادرو فىزىكىسى	Категория:Ядерная физика
ئەينەك تالا	Стеклопластик
سەۋزە	Морковь посевная
تۈر:جۇڭخۇا خەلق جۇمھۇرىيىتى	Категория:Китайская Народная Республика
تۈر:ئېتمولوگىيە	Категория:Этимология
قېلىپ:User ug-1	Шаблон:User ug-1
قېلىپ:User ug	Шаблон:User ug
قېلىپ:User mn-1	Шаблон:User mn-1
تۈر:بىيولوگ	Категория:Биологи
تراگۇلۇس بۇغىسى	Оленьковые
تۈر:خاس ئات ئىلمى	Категория:Ономастика
تۈر:Uyghur tili	Категория:Уйгурский язык
تۈر:User en-1	Категория:User en-1
تۈر:User de-1	Категория:User de-1
قېلىپ:User ug-0	Шаблон:User ug-0
ﻗﺎﺭﺍ ﭘﺎﭘﺎﻕ ﻣﯩﻠﻠﯩﺘﻰ	Карапапахи
قېلىپ:شىنجاڭ	Шаблон:СУАР
تاش	Рош (значения)
كۆكتۈرك خانلىقى	Тюркский каганат
خوتەن شەھىرى	Хотан
ئالاھىدە:RecentChanges	Служебная:Свежие правки
تۈر:User ja-4	Категория:User ja-4
