非洲	Африка
日本	Япония
南美洲	Южная Америка
挪威	Норвегия
英格兰	Англия
苏格兰	Шотландия
匈牙利	Венгрия
西班牙	Испания
美国	Соединённые Штаты Америки
比利时	Бельгия
卢森堡	Люксембург
地球	Земля
人	Человек разумный
欢喜	Счастье
芬兰	Финляндия
瑞典	Швеция
波兰	Польша
立陶宛	Литва
意大利	Италия
瑞士	Швейцария
奥地利	Австрия
希腊	Греция
土耳其	Турция
啤酒	Пиво
葡萄牙	Португалия
欧洲	Европа
亚洲	Азия
维基百科	Википедия
尼德兰	Нидерланды
PHP	PHP
纽约市	Нью-Йорк
旧金山	Сан-Франциско
洛杉矶	Лос-Анджелес
计算机	Компьютер
办合纳	Берн
极乃伐	Женева
苏黎世	Цюрих
巴拉克·奥巴马	Обама, Барак
乌拉圭	Уругвай
白才尔	Базель
打印机	Принтер
伦敦	Лондон
开罗	Каир
苹果	Яблоко
墨西哥	Мексика
大西洋	Атлантический океан
太平洋	Тихий океан
加利福尼亚	Калифорния
波士顿	Бостон
礼拜一	Понедельник
火星	Марс
肯尼亚	Кения
礼拜两	Вторник
礼拜三	Среда
礼拜四	Четверг
礼拜五	Пятница
礼拜六	Суббота
礼拜天	Воскресенье
法国	Франция
世界语	Эсперанто
狗	Собака
英国	Великобритания
貓	Кошка
中华人民共和国	Китайская Народная Республика
法文	Французский язык
鱼	Рыбы
巴西	Бразилия
俄罗斯	Россия
大海	Море
圓周率	Пи (число)
Π	Пи (буква)
聖保羅	Сан-Паулу
该办克	Квебек
德国	Германия
白俄罗斯	Белоруссия
德语	Немецкий язык
冰岛	Исландия
愛沙尼亞	Эстония
土星	Сатурн
巧克力	Шоколад
飞机	Самолёт
打仗	Война
拉脱维亚	Латвия
乌克兰	Украина
捷克	Чехия
斯洛伐克	Словакия
斯洛文尼亚	Словения
摩尔多瓦	Молдавия
罗马尼亚	Румыния
保加利亚	Болгария
罗马	Рим
马其顿	Республика Македония
阿爾巴尼亞	Албания
格陵兰	Гренландия (административная единица)
克罗地亚	Хорватия
波黑	Босния и Герцеговина
阿塞拜疆	Азербайджан
安道尔	Андорра
塞浦路斯	Республика Кипр
格鲁吉亚	Грузия
哈萨克斯坦	Казахстан
马耳他	Мальта
摩纳哥	Монако
黑山共和国	Черногория
梵蒂冈	Ватикан
圣马力诺	Сан-Марино
布鲁塞尔	Брюссель
古巴	Куба
大众汽车	Volkswagen
Java	Java
印度尼西亚	Индонезия
南非	Южно-Африканская Республика
阿尔及利亚	Алжир
乌兹别克斯坦	Узбекистан
欧罗维竞唱歌比赛	Конкурс песни Евровидение
水	Вода
木	Древесина
电视机	Телевидение
冰岛文	Исландский язык
智利	Чили
耶稣	Иисус Христос
語言	Язык
英语维基百科	Английская Википедия
尼古拉·萨科齐	Саркози, Николя
新加坡	Сингапур
科学	Наука
自由軟件	Свободное программное обеспечение
列支敦士登	Лихтенштейн
希特拉	Гитлер, Адольф
WikiLeaks	WikiLeaks
第二次世界大战	Вторая мировая война
科隆	Кёльн
Linux	Linux
数学	Математика
拉丁文	Латинский язык
巴林	Бахрейн
亚美尼亚	Армения
塞尔维亚	Сербия
月球	Луна
澳大利亚	Австралия
物理学	Физика
阿根廷	Аргентина
秘鲁	Перу
朝鲜民主主义人民共和国	Корейская Народно-Демократическая Республика
柬埔寨	Камбоджа
恐龙	Динозавры
回教	Ислам
里昂	Лион
欧洲联盟	Европейский союз
女性	Женщина
诗	Поэзия
米蘭	Милан
屁眼	Анус
古高尔	Гугол
珠穆朗玛峰	Джомолунгма
城市	Город
巴斯德	Пастер, Луи
村	Село
大洋洲	Океания
太阳系	Солнечная система
氢	Водород
维基共享	Викисклад
揚聲器	Громкоговоритель
东帝汶	Восточный Тимор
维嘞合朋纳	Вийёрбан
学纳河	Рона
迪拜	Дубай (эмират)
哥白尼	Коперник, Николай
碳	Углерод
音乐	Музыка
圣皮得斯堡	Санкт-Петербург
北	Север
新西兰	Новая Зеландия
南	Юг
印度	Индия
西	Запад
氯气	Хлор
铅	Свинец
蒙古国	Монголия
委内瑞拉	Венесуэла
国际象棋	Шахматы
缅因	Мэн (штат)
苏里南	Суринам
巴拉圭	Парагвай
圭亚那	Гайана
艺术	Искусство
厄瓜多尔	Эквадор
哥伦比亚	Колумбия
佛教	Буддизм
玻利维亚	Боливия
特里尼达搭仔多巴哥	Тринидад и Тобаго
新罕布什爾	Нью-Гэмпшир
马萨诸塞	Массачусетс
康涅狄格	Коннектикут
鸡	Курица
澤西島	Джерси (остров)
猪猡	Домашняя свинья
伊朗	Иран
伊拉克	Ирак
阿拉斯加	Аляска
以色列	Израиль
巴拿马	Панама
也門	Йемен
约旦	Иордания
佛罗里达州	Флорида
吉尔吉斯斯坦	Киргизия
科威特	Кувейт
老挝	Лаос
黎巴嫩	Ливан
俄勒冈	Орегон
马尔代芙	Мальдивы
马来西亚	Малайзия
缅甸	Мьянма
尼泊尔	Непал
阿曼	Оман
巴基斯坦	Пакистан
卡塔尔	Катар
沙特阿拉伯	Саудовская Аравия
斯里兰卡	Шри-Ланка
史太林	Сталин, Иосиф Виссарионович
叙利亚	Сирия
塔吉克斯坦	Таджикистан
口袋妖怪	Покемон
中华民国	Китайская Республика
泰国	Таиланд
火车	Поезд
土库曼斯坦	Туркмения
阿拉伯联合酋长国	Объединённые Арабские Эмираты
越南	Вьетнам
新西伯利亚	Новосибирск
大韩民国	Республика Корея
阿富汗	Афганистан
金	Золото
喀山	Казань
孟加拉	Бангладеш
马里	Мали
安哥拉	Ангола
不丹	Бутан
文莱	Бруней
菲律宾	Филиппины
牛顿	Ньютон, Исаак
OpenStreetMap	OpenStreetMap
量子力学	Квантовая механика
突尼斯	Тунис
赞比亚	Замбия
津巴布韦	Зимбабве
北京	Пекин
贝宁	Бенин
博茨瓦纳	Ботсвана
布隆迪	Бурунди
刚果共和国	Республика Конго
刚果民主共和国	Демократическая Республика Конго
甘地	Махатма Ганди
连环画	Комикс
冈比亚	Гамбия
科特迪瓦	Кот-д’Ивуар
喀麦隆	Камерун
尼日利亚	Нигерия
索马里	Сомали
铌	Ниобий
凱撒	Гай Юлий Цезарь
苏丹	Судан
汉堡	Гамбург
联合国	Организация Объединённых Наций
唐担	Данте Алигьери
艾哈迈德堡	Ахмадабад
锡	Олово
克林顿总统	Клинтон, Билл
孟买	Мумбаи
波多黎各	Пуэрто-Рико
卡纳塔克邦	Карнатака
列农	Леннон, Джон
爱达荷州	Айдахо
华盛顿州	Вашингтон (штат)
科索沃	Республика Косово
潘基文	Пан Ги Мун
Kofi Annan	Аннан, Кофи
分类:页面分类	Категория:Всё
多特蒙德	Дортмунд
冬天	Зима
西班牙语	Испанский язык
匹兹堡	Питтсбург
费城	Филадельфия
金奈	Ченнаи
班加罗尔	Бангалор
钞票	Деньги
纽约州	Нью-Йорк (штат)
罗德岛	Род-Айленд
昆虫	Насекомые
宾夕法尼亚	Пенсильвания
Uetersen	Итерзен
奧古斯都	Октавиан Август
微软视窗	Windows
直布罗陀	Гибралтар
布宜诺斯艾利斯	Буэнос-Айрес
东京都	Токио
爱荷华州	Айова
里昂地铁	Лионский метрополитен
印地语	Хинди
艾迪托·比娅呋	Пиаф, Эдит
因斯孛鲁克	Инсбрук
都柏林	Дублин
法兰克福	Франкфурт-на-Майне
天主教	Католицизм
圣经	Библия
金边	Пномпень
胡志明市	Хошимин
河內市	Ханой
真耶稣教会	Церковь истинного Иисуса
英语	Английский язык
曼谷	Бангкок
臺北市	Тайбэй
同海市	Донгхой
Końskowola	Коньсковоля
达累斯萨拉姆	Дар-эс-Салам
Al-Khartoum	Хартум
疾画合	Живор
1月11号	11 января
明斯克	Минск
微软公司	Microsoft
库鲁夫	Курув
化学	Химия
2月19号	19 февраля
Visual Basic	Visual Basic
本笃十六世	Бенедикт XVI
12月25号	25 декабря
8月4号	4 августа
8月31号	31 августа
迈克尔·杰克逊	Джексон, Майкл
巴西利亞	Бразилиа
大里昂	Большой Лион
圣地牙哥	Сантьяго
坎培拉	Канберра
悉尼	Сидней
墨尔本	Мельбурн
木卫三	Ганимед (спутник)
珀斯	Перт (Австралия)
西澳大利亚州	Западная Австралия
北领地 (澳大利亚)	Северная территория
苏门答腊岛	Суматра
突尼斯市	Тунис (город)
德黑兰	Тегеран
亚的斯亚贝巴	Аддис-Абеба
安卡拉	Анкара
贝尔格莱德	Белград
分类:维基百科模板	Категория:Википедия:Шаблоны
爪哇岛	Ява
法属圭亚娜	Французская Гвиана
安曼	Амман
贝鲁特	Бейрут
分类:国家模板	Категория:Шаблоны по странам
内罗毕	Найроби
分类:地理模板	Категория:Шаблоны:География
学堂	Школа
大学	Университет
Wikipedia:沙盘	Википедия:Песочница
屋	Жилище
卡尔梅克共和国	Калмыкия
地图	Географическая карта
奥萨斯库	Озаску
同海机场	Донгхой (аэропорт)
里昂祭光节	Праздник света
世界言话排名	Список языков по количеству носителей
分类:日本历史	Категория:История Японии
孔子	Конфуций
分类:数学	Категория:Математика
法罗群岛	Фарерские острова
分类:印度历史	Категория:История Индии
分类:泰国历史	Категория:История Таиланда
巴厘岛	Бали
分类:缅甸历史	Категория:История Мьянмы
欧元	Евро
美元	Доллар США
地中海	Средиземное море
威尼斯共和国	Венецианская республика
杭州市	Ханчжоу
基督教	Христианство
模板:亚洲行政区划	Шаблон:Страны Азии
模板:Support	Шаблон:За
金国	Династия Цзинь (1115—1234)
洲	Континент
模板:ALA	Шаблон:ALA
阿德来得	Аделаида
首都	Столица
葡萄牙语	Португальский язык
模板:Portal	Шаблон:Портал
公元1949年	1949 год
阿嘞玛桑	Альмасан
黄现璠	Хуан Сяньфань
日语	Японский язык
荧光屏	Монитор (устройство)
百科全书	Энциклопедия
封面	Заглавная страница
路由器	Маршрутизатор
棒球	Бейсбол
奧林匹克运动会	Олимпийские игры
长江	Янцзы
里海	Каспийское море
拉斐尔	Рафаэль Санти
电车	Трамвай
加泰罗尼亚	Каталония
毛泽东	Мао Цзэдун
西安	Сиань
拉萨市	Лхаса
性行为	Половой акт
加夫列尔·加西亚·马尔克斯	Гарсиа Маркес, Габриэль
分类:快速删除候选	Категория:Википедия:К быстрому удалению
莎里 嘛克嘞朗	Пирсон, Салли
马可·波罗	Поло, Марко
共产主义	Коммунизм
1368年	1368 год
國家	Страна
Joe Biden	Байден, Джо
希拉里·克林顿	Клинтон, Хиллари
Yelena Isinbayeva	Исинбаева, Елена Гаджиевна
大英博物馆	Британский музей
蒙彼利埃	Монпелье
分类:天文学	Категория:Астрономия
汉堡包	Гамбургер
班合比让	Перпиньян
标致汽车	Peugeot
李白	Ли Бо
图书馆	Библиотека
世界银行	Всемирный банк
汉武帝	У-ди
女权主义	Феминизм
元朝	Юань (династия)
库克船长	Кук, Джеймс
郑和	Чжэн Хэ
黃河	Хуанхэ
蚂蚁	Муравьи
宋朝	Империя Сун
宋高宗	Гао-цзун (династия Сун)
落苏	Баклажан
龙	Дракон
姆妈	Мать
隆波岛	Ломбок
小人	Ребёнок
俄语	Русский язык
普京	Путин, Владимир Владимирович
东南亚国家联盟	Ассоциация государств Юго-Восточной Азии
面包	Хлеб
国际货币基金组织	Международный валютный фонд
联合国教育科学文化组织	ЮНЕСКО
联合国卫生组织	Всемирная организация здравоохранения
漢語	Китайский язык
雨	Дождь
全球暖化	Глобальное потепление
纳尔逊·曼德拉	Мандела, Нельсон
马丁·路德·金	Кинг, Мартин Лютер
蛋白质	Белки
天灾	Стихийное бедствие
海啸	Цунами
云	Облака
电视	Телевизор
几何学	Геометрия
日圆	Японская иена
单词	Слово
漢字	Китайское письмо
希腊字母	Греческий алфавит
諺文	Хангыль
分类:法国	Категория:Франция
分类:音乐	Категория:Музыка
红楼梦	Сон в красном тереме
漫画	Манга
狐狸	Лисица
哈利波特	Серия романов о Гарри Поттере
小提琴	Скрипка
肛交	Анальный секс
教育	Образование
男性	Мужчина
婚姻	Брачный союз
法语维基百科	Французская Википедия
咖啡	Кофе
果汁	Сок
山	Гора
第29届奧林匹克运动会	Летние Олимпийские игры 2008
孙中山	Сунь Ятсен
香港	Гонконг
首尔	Сеул
上海	Шанхай
伦敦 海斯楼 飞机场	Хитроу
清朝	Империя Цин
越南战争	Война во Вьетнаме
巴斯克语	Баскский язык
阿拉贡语	Арагонский язык
瓦伦西亚	Валенсия
玛丽咏·高帝娅	Котийяр, Марион
麦克斯韦	Максвелл, Джеймс Клерк
原子	Атом
光	Свет
罗鲍斯	Роблес, Дайрон
韩语	Корейский язык
官話	Севернокитайский язык
高棉文	Кхмерский язык
弗洛伊德	Фрейд, Зигмунд
泰语	Тайский язык
马来语	Малайский язык
蒙古语	Монгольский язык
犹太教	Иудаизм
万象	Вьентьян
莫白桑	Мопассан, Ги де
司马迁	Сыма Цянь
朱熹	Чжу Си
廷巴克图	Томбукту
伦理学	Этика
沙·卢克·康	Хан, Шахрух
什叶派	Шииты
道教	Даосизм
子宫	Матка женщины
颈	Шея
富克朗特群岛	Фолклендские острова
马恩岛	Остров Мэн
戴安娜王妃	Диана, принцесса Уэльская
唐玄宗	Сюань-цзун (династия Тан, 712—756)
Α	Альфа (буква)
Ω	Омега (буква)
Μ	Мю
明朝	Империя Мин
朱元璋	Хунъу
Φ	Фи
朱由检	Чунчжэнь
Laura Robson	Робсон, Лора
2008年欧罗维竞唱歌比赛	Конкурс песни Евровидение 2008
里昂有轨电车	Лионский трамвай
强·马凯恩	Маккейн, Джон
金正日	Ким Чен Ир
元素周期表	Периодическая система химических элементов
罗別脫 姆格比	Мугабе, Роберт
自杀	Самоубийство
爬蟲類	Пресмыкающиеся
Λ	Лямбда
伍老虎	Вудс, Тайгер
洋山芋	Картофель
三宝垄	Семаранг
报纸	Газета
电话	Телефон
?	Вопросительный знак
美国空军	Военно-воздушные силы США
菲德尔·卡斯特罗	Кастро, Фидель
元素单子	Химический элемент
广域网	Глобальная компьютерная сеть
围棋	Го
电影	Фильм
气体	Газ
液体	Жидкость
固体	Твёрдое тело
脚踏车	Велосипед
农业	Сельское хозяйство
温度	Температура
面积	Площадь
数	Число
玛丽亚·莎拉波娃	Шарапова, Мария Юрьевна
重慶	Чунцин
天津市	Тяньцзинь
武汉	Ухань
世界地理索引	Алфавитный список стран и территорий
玫瑰人生 (歌)	La Vie en rose
担桑身	Беременность человека
Google地图	Карты Google
癌	Злокачественная опухоль
残疾人	Инвалидность
抗生素	Антибиотики
青霉素	Бензилпенициллин
肺炎	Пневмония
克来普	Тонкие блинчики
麻将	Маджонг
运河	Канал (гидрография)
坝	Плотина
牛顿 (单位)	Ньютон (единица измерения)
世界报 (法国)	Le Monde
万里长城	Великая Китайская стена
可再生能源	Возобновляемая энергия
电	Электричество
核武器	Ядерное оружие
Joomla!	Joomla!
吉卜赛语	Цыганский язык
壮语	Чжуанский язык
自由人报 (法国)	Libération
安吉丽娜	Джоли, Анджелина
阿拉伯语	Арабский язык
马多符	Мейдофф, Бернард
扬马延岛	Ян-Майен
弗	Доллар
科西嘉岛	Корсика
奥克语	Окситанский язык
克里斯蒂娜 艾伐脱	Эверт, Крис
李明博	Ли Мён Бак
Β	Бета (буква)
Γ	Гамма (буква)
Δ	Дельта (буква)
Ε	Эпсилон
Ζ	Дзета
Η	Эта
Θ	Тета
Ι	Йота
Κ	Каппа (буква)
Ν	Ню (буква)
Ξ	Кси (буква)
Ο	Омикрон
Ρ	Ро (буква)
Σ	Сигма (буква)
Τ	Тау
Υ	Ипсилон
Χ	Хи
Ψ	Пси (буква)
复活节岛	Остров Пасхи
澳门	Макао
联想计算机公司	Lenovo
董建华	Дун Цзяньхуа
胡锦涛	Ху Цзиньтао
习近平	Си Цзиньпин
深圳市	Шэньчжэнь
廣東省	Гуандун
广西壮族自治区	Гуанси-Чжуанский автономный район
国际金融中心 (香港)	Международный финансовый центр
施蒂文 呼克	Хукер, Стив
鹿儿岛县	Кагосима (префектура)
C语言	Си (язык программирования)
手铐	Наручники
艾米·麦克唐纳 (歌手)	Макдональд, Эми
Wikipedia:Featured articles	Википедия:Избранные статьи
Wikipedia:红茶坊	Википедия:Форум
釜山广域市	Пусан
佛蒙特	Вермонт
广州	Гуанчжоу
蔣中正	Чан Кайши
江泽民	Цзян Цзэминь
温家宝	Вэнь Цзябао
南京市	Нанкин
刘德华	Лау, Энди
张学友	Чун, Джеки
同济大学	Университет Тунцзи
首都圈电铁	Сеульский метрополитен
北京大学	Пекинский университет
清華大學	Университет Цинхуа
江苏省	Цзянсу
浙江省	Чжэцзян
邓小平	Дэн Сяопин
琶兰那克	Паранак
菲律宾比索	Филиппинское песо
西藏	Тибетский автономный район
圆	Окружность
同性婚姻	Однополый брак
Francesc Fàbregas	Фабрегас, Сеск
手机	Сотовый телефон
太平山 (香港)	Пик Виктория (Гонконг)
欧洲杯足球赛	Лига чемпионов УЕФА
马来亚半岛	Малакка (полуостров)
平壤市	Пхеньян
奥斯卡奖	Оскар (кинопремия)
各经济实体国内生产总值列表	Список стран по ВВП (номинал)
ی	Йуд (буква еврейского алфавита)
黑龍江省	Хэйлунцзян
芽庄市	Нячанг
教皇	Папство
波多黎各独立党	Партия независимости Пуэрто-Рико
钱塘江	Цяньтан
四川省	Сычуань
蔡元培	Цай Юаньпэй
圣诞	Рождество Христово
闰年	Високосный год
ب	Ба (буква арабского алфавита)
大田广域市	Тэджон
大邱广域市	Тэгу
仁川国际机场	Инчхон (аэропорт)
仁川广域市	Инчхон
京畿道	Кёнгидо
计算机科学	Информатика
阿鲁巴	Аруба
国际音标	Международный фонетический алфавит
河北省	Хэбэй
GNU自由文档许可证	GNU FDL
陈水扁	Чэнь Шуйбянь
台湾	Тайвань
纽约	Нью-Йорк (значения)
2012年欧洲足球冠军赛	Чемпионат Европы по футболу 2012
路由	Маршрутизация
人口密度	Плотность населения
爱尔兰	Ирландия (остров)
鲁迅	Лу Синь
湖	Озеро
黄瓜	Огурец обыкновенный
南奥赛西亚	Южная Осетия
阿什哈巴德	Ашхабад
岛屿	Остров
马赛	Марсель
风牙己榜国家公园	Фонгня-Кебанг
广平省	Куангбинь
赤道	Экватор
字典	Словарь
北塞浦路斯	Турецкая Республика Северного Кипра
死海	Мёртвое море
英镑	Фунт стерлингов
金兰国际机场	Камрань (аэропорт)
荷属安地列斯	Нидерландские Антильские острова
根西岛	Гернси
斯瓦尔巴群岛	Шпицберген
Benetice	Бенетице
摄氏温标	Градус Цельсия
大叻市	Далат
岘港市	Дананг
Washington	Вашингтон
甴巴子	Таракановые
鱷魚	Крокодилы
中国工商银行	Industrial and Commercial Bank of China
朝鮮正祖	Чонджо
人造卫星	Искусственный спутник Земли
太原省 (越南)	Тхайнгуен (провинция)
杀人鲸	Косатка (млекопитающее)
印科软件	Infosys
日本海	Японское море
东亚	Восточная Азия
北亚	Северная Азия
南欧	Южная Европа
东欧	Восточная Европа
北欧	Северная Европа
西欧	Западная Европа
中欧	Центральная Европа
辛基得语	Тлингитский язык
琉球国	Рюкю (государство)
扶余国	Пуё (государство)
县	Графство
氨基糖苷类抗生素	Аминогликозиды
伊斯兰历	Исламский календарь
柳京饭店	Гостиница Рюгён
霍顿汽车	Holden
市长	Мэр
中文维基百科	Китайская Википедия
总统	Президент
满洲国	Маньчжоу-го
安娜·伊凡诺维琪	Иванович, Ана
圣诞岛	Остров Рождества (Австралия)
明绞拉	Мингора
臺灣省	Тайвань (провинция Китайской Республики)
拳击	Бокс
樟宜国际机场	Чанги (аэропорт)
大西洋处女	Virgin Atlantic Airways
快达航空	Qantas
斑马	Зебры
同奈省	Донгнай (провинция)
广义省	Куангнгай (провинция)
金瓯省	Камау (провинция)
广南省 (越南)	Куангнам
槟椥省	Бенче (провинция)
庆和省	Кханьхоа
客家语	Хакка (язык)
北宁省	Бакнинь (провинция)
优八克	Международный союз теоретической и прикладной химии
赣语	Гань
海地克里奥耳语	Гаитянский креольский язык
大熊猫	Большая панда
孤立語言	Изолированные языки
卡纳达语	Каннада
杜甫	Ду Фу
瓦尔帕莱索	Вальпараисо
演员	Актёр
分类:程序编制言话	Категория:Языки программирования
瓦哈卡	Оахака (штат)
侗台语	Тай-кадайские языки
白脱	Сливочное масло
尼亚加拉瀑布	Ниагарский водопад
吴语	У (язык)
塔斯马尼亚	Тасмания
贝拉齐尔‧布托	Бхутто, Беназир
费利佩二世 (西班牙)	Филипп II (король Испании)
牛津大学	Оксфордский университет
基地 (恐怖组织)	Аль-Каида
英吉利海峡	Ла-Манш
柴尔兹孛格	Зальцбург
秦国	Цинь (царство)
半岛	Полуостров
新疆維吾爾自治區	Синьцзян-Уйгурский автономный район
布里司班	Брисбен
各国首都列表	Список столиц мира
平面镜	Зеркало
锡金语	Сиккимский язык
孛拉特 皮此	Питт, Брэд
欧洲足球联合会	УЕФА
美国个州	Штат США
议会	Парламент
大阪市	Осака
剑桥大学	Кембриджский университет
牙膏	Зубная паста
通货膨胀	Инфляция
艾美 羅森	Россум, Эмми
竹	Bambuseae
刚果	Конго
马失拉地	Maserati
科科斯群岛	Кокосовые острова
昆士兰州	Квинсленд
明尼阿波利斯	Миннеаполис
顺化市	Хюэ
马拉雅南语	Малаялам
逻辑语	Ложбан
北江省	Бакзянг (провинция)
耶稣会	Иезуиты
承天顺化省	Тхыатхьен-Хюэ
北𣴓省	Баккан (провинция)
阿伯丁	Абердин
莱州省	Лайтяу (провинция)
河南省 (越南)	Ханам (провинция)
上海浦东国际机场	Пудун (аэропорт)
政治學	Политология
闽东语	Восточноминьский язык (диалект)
闽南语	Южноминьский язык (диалект)
安江省	Анзянг
茶荣省	Чавинь
Tycho Brahe	Браге, Тихо
薄辽省	Бакльеу (провинция)
嘉莱省	Зялай
平福省	Биньфыок
同塔省	Донгтхап
约旦河西岸	Западный берег реки Иордан
河江省	Хазянг (провинция)
维克多利亚州	Виктория (Австралия)
多乐省	Даклак
平定省	Биньдинь
上海言话	Шанхайский диалект
得农省	Дакнонг
水晶之夜	Хрустальная ночь
潮州话	Чаошаньское наречие
台语	Тайваньский язык
门	Дверь
猪流感	Свиной грипп
高平省	Каобанг (провинция)
平阳省	Биньзыонг
平顺省	Биньтхуан
巴地头顿省	Бариа-Вунгтау
奠边省	Дьенбьен
三船敏郎	Мифунэ, Тосиро
印度电影观众奖	Filmfare Awards
AK-47	Автомат Калашникова
八国集团	Большая восьмёрка
孙武	Сунь-цзы
国际商用机器公司	IBM
互聯網電影數據庫	Internet Movie Database
贝克特	Беккет, Сэмюэл
达赖喇嘛	Далай-лама
邮政编码	Почтовый индекс
Nicole Kidman	Кидман, Николь
联合国安理会	Совет Безопасности ООН
洋火棒儿	Спичка
雹	Град
南海	Южно-Китайское море
肯波拉圣吉奥瓦尼	Кампора-Сан-Джованни
朝鮮世宗	Сечжон Великий
奥克兰格兰玛学校	Оклендская гимназия
电冰箱	Холодильник
黄海	Жёлтое море
大仲马	Дюма, Александр (отец)
孟加拉湾	Бенгальский залив
哈马斯	ХАМАС
阿斯旺水坝	Асуанский гидроузел
人民币	Китайский юань
富士山	Фудзияма
小鼠	Домовые мыши
索契	Сочи
迈克尔·菲尔普斯	Фелпс, Майкл
卡地马党	Кадима
加沙地带	Сектор Газа
霍巴特	Хобарт
金草莓奖	Золотая малина
律师	Адвокат
相扑	Сумо
希斯·莱杰	Леджер, Хит
安徽省	Аньхой
江原道	Канвондо
内蒙古自治区	Внутренняя Монголия
金日成	Ким Ир Сен
全罗北道	Чолла-Пукто
济州特别自治道	Чеджудо
郁陵岛	Уллындо
湄公河	Меконг
索尼	Sony
巴別塔	Вавилонская башня
力学	Механика
南半球	Южное полушарие
蔚山广域市	Ульсан
光州广域市	Кванджу
温室效应	Парниковый эффект
Julia Gillard	Гиллард, Джулия
华国锋	Хуа Гофэн
福建省	Фуцзянь
克拉耿富合脱	Клагенфурт
小熊猫	Малая панда
大溪地	Таити
安东市	Андон
海南省	Хайнань
汉语拼音	Пиньинь
远东	Дальний Восток
西班牙国家足球队	Сборная Испании по футболу
华氏温标	Градус Фаренгейта
海峡群岛	Нормандские острова
甘肃省	Ганьсу
苏州市	Сучжоу (Цзянсу)
无锡市	Уси
湖州市	Хучжоу
绍兴市	Шаосин
汉族	Хань (народ)
宁波市	Нинбо
ETA (民族组织)	ЭТА
隆城国际机场	Лонгтхань (аэропорт)
数据	Данные
迪马 皮郎	Билан, Дима Николаевич
记者	Репортёр
基本粒子	Элементарная частица
陆克文	Радд, Кевин
沙菲娅 劳塔露	Ротару, София Михайловна
些拉·班琳	Пэйлин, Сара
云南省	Юньнань
苏丹 (称谓)	Султан
德国国家足球队	Сборная Германии по футболу
山东省	Шаньдун
福楼拜	Флобер, Гюстав
英属印度洋领地	Британская территория в Индийском океане
地质年代	Геохронологическая шкала
河南省	Хэнань
乃堂雅虎	Нетаньяху, Биньямин
护照	Паспорт
遼寧省	Ляонин
件西卡 阿尔白	Альба, Джессика
桑•班	Пенн, Шон
GNOME	GNOME
台湾桃园国际机场	Тайвань-Таоюань (аэропорт)
色子	Игральная кость
吉林省	Гирин
东海	Восточно-Китайское море
2008年美国总统选举	Президентские выборы в США (2008)
阿南德	Вишванатан Ананд
湖南省	Хунань
水族馆	Аквариум
青海省	Цинхай
柏威夏寺	Прэахвихеа
豪納省	Рона (департамент)
陸龜	Сухопутные черепахи
話筒	Микрофон
山西省	Шаньси
魔方	Кубик Рубика
尼德兰国家足球队	Сборная Нидерландов по футболу
谜子	Загадка
艾西瓦娅·巴克罕	Рай, Айшвария
贵州省	Гуйчжоу
Warren Buffett	Баффетт, Уоррен
蹔𧉆	Настоящие сверчки
纸币	Банкнота
加沙城	Газа
白斯克	Баскские земли
安达曼海	Андаманское море
胡适	Ху Ши
穆斯林	Мусульманин
孛路內 (Blu-Ray)	Blu-ray Disc
法国国家足球队	Сборная Франции по футболу
后现代	Постмодернизм
宮城县	Мияги (префектура)
帕荔斯 希尔顿	Хилтон, Пэрис
陕西省	Шэньси
模板:Commonscat	Шаблон:Commonscat
岩手县	Иватэ (префектура)
死人	Труп
莱纳斯·鲍林	Полинг, Лайнус
Patrick Swayze	Суэйзи, Патрик
嫦娥1号	Чанъэ-1
純合子	Гомозигота
水彩画	Акварель
李舜臣	Ли Сунсин
香港政区	Административное деление Гонконга
巴黎地铁	Парижский метрополитен
釜山地铁	Пусанский метрополитен
清迈	Чиангмай
对马海峽	Цусимский пролив
珍珠港事件	Нападение на Пёрл-Харбор
分类:化学模板	Категория:Шаблоны:Химия
模板:Taxobox	Шаблон:Taxobox
松下电器	Panasonic
丰田汽车	Toyota
田鸡	Бесхвостые
艾奇亚	IKEA
火车站	Железнодорожная станция
洛东江	Нактонган
模板:中国历史	Шаблон:История Китая
金正恩	Ким Чен Ын
豪萨语	Хауса (язык)
闽语	Миньские языки
徐汇区	Сюйхуэй
江西省	Цзянси
台湾省 (中华人民共和国)	Тайвань (провинция Китайской Народной Республики)
纳姆耶尔·旺楚克 (不丹国王)	Джигме Кхесар Намгьял Вангчук
阮明哲	Нгуен Минь Чьет
宁夏回族自治区	Нинся-Хуэйский автономный район
拿督阿都拉萨	Наджиб Тун Разак
吉格梅·廷礼	Тинлей, Джигме
约翰·菲利普·凯伊	Кей, Джон
宿迁市	Суцянь
扬州市	Янчжоу
泰州	Тайчжоу (Цзянсу)
南通	Наньтун
镇江市	Чжэньцзян
常州市	Чанчжоу
嘉兴市	Цзясин
金华市	Цзиньхуа
衢州	Цюйчжоу
台州市	Тайчжоу (Чжэцзян)
舟山市	Чжоушань
迪斯科	Диско
阉	Кастрация
以色列国防军	Армия обороны Израиля
寿春机场	Шаованг (аэропорт)
嘟嘟車	Моторикша
海蒂·克鲁姆	Клум, Хайди
拉吉倪甘斯	Раджникант
空军	Военно-воздушные силы
大名	Даймё
太仓	Тайцан
劳莱士表	Rolex
数码照相机	Цифровой фотоаппарат
数词	Имя числительное
哈里发	Халиф
汇率	Валютный курс
青森县	Аомори (префектура)
福岛县	Фукусима (префектура)
梁思成	Лян Сычэн
青蛙	Бурые лягушки
海防市	Хайфон
斯堪的纳维亚半岛	Скандинавский полуостров
里尔克	Рильке, Райнер Мария
排列组合	Комбинаторика
鲍林标度	Электроотрицательность
街道	Улица
机器翻译	Машинный перевод
阿根廷国家足球队	Сборная Аргентины по футболу
面向对象程式编制	Объектно-ориентированное программирование
千叶县	Тиба (префектура)
定积分	Интеграл
故宫	Запретный город
泰米尔猛虎解放组织	Тигры освобождения Тамил-Илама
印度卢比	Индийская рупия
Microsoft Outlook	Microsoft Outlook
早饭	Завтрак
自动银行出纳机	Банкомат
秋田县	Акита (префектура)
乌克兰元	Украинская гривна
Ségolène Royal	Руаяль, Сеголен
通用汽车	General Motors
差头	Такси
乌赛	Регион
雷 (天气)	Гром
滇池	Дяньчи
尼扎·拉言	Райан, Низар
拿塔莎 康埔西	Кампуш, Наташа
新浪微博	Sina Weibo
模板:Cite book	Шаблон:Cite book
香农 (计算数学家)	Шеннон, Клод
宝莱坞	Болливуд
索里亚省	Муниципалитеты Сории
三角函数	Тригонометрические функции
2009年甲型H1N1流感疫情	Пандемия гриппа H1N1 в 2009 году
草	Сорные растения
文瑾莹	Мун Гынён
2004年欧洲足球冠军赛	Чемпионат Европы по футболу 2004
严重急性呼吸道综合症	Тяжёлый острый респираторный синдром
Flickr	Flickr
John C. Mather	Мазер, Джон Кромвелл
索尔·珀尔马特	Перлмуттер, Сол
希腊数字	Греческая система счисления
俞正声	Юй Чжэншэн
普吉岛	Пхукет (значения)
克里米亚鞑靼人	Крымские татары
伊斯兰圣战组织 (巴勒斯坦)	Палестинский исламский джихад
2011年亚洲杯足球比赛入围赛	Кубок Азии по футболу 2011 (отборочный турнир)
爱媛县	Эхимэ
圣灰星期三	Пепельная среда
邻舍	Нейборхуд
沙地	Степь
鸡窠生凤凰 (电影)	Миллионер из трущоб
浦东新区	Пудун (район)
天坛	Храм Неба
外滩	Набережная Вайтань
山形县	Ямагата (префектура)
基呒湖	Киву (озеро)
台湾海峡	Тайваньский пролив
神奈川县	Канагава
中国地区	Тюгоку
长野县	Нагано (префектура)
埼玉县	Сайтама (префектура)
笼	Клетка для животных
英属印度	Британская Индия
法国高速铁路	TGV
Ϝ	Дигамма
群马县	Гумма (префектура)
Ϙ	Коппа (буква)
Hugh Jackman	Джекман, Хью
兵库县	Хёго
2004年东南亚大地震搭海啸	Землетрясение в Индийском океане в 2004 году
李准基	Ли Джун Ги
安娜·库妮可娃	Курникова, Анна Сергеевна
天线	Антенна
泰国湾	Сиамский залив
2000年欧洲足球冠军赛	Чемпионат Европы по футболу 2000
Ϛ	Стигма (буква)
兵房	Казарма
石川县	Исикава
妓院	Публичный дом
国际单位制词头	Приставки СИ
静冈县	Сидзуока (префектура)
对话	Диалог
Ͳ	Сампи
农民	Фермер
葡蛮郎	Бумеранг
渧拉米酥	Тирамису
Ϻ	Сан (буква)
毛巾	Полотенце
钱包	Кошелёк
春节	Китайский Новый год
麻生太郎	Асо, Таро
无产阶级	Пролетариат
弥撒	Месса
Naomi Watts	Уоттс, Наоми
座头鲸	Горбатый кит
冈山县	Окаяма (префектура)
赌场	Казино
撒旦教	Сатанизм
彰化县	Чжанхуа (уезд)
农历	Китайский календарь
克罗地亚国家足球队	Сборная Хорватии по футболу
巴尔喀什湖	Балхаш
丹尼·波尔	Бойл, Дэнни
泰国旗	Флаг Таиланда
希腊国家足球队	Сборная Греции по футболу
峨眉山	Эмэйшань
Zip	ZIP
冰壶	Кёрлинг
巴拉同 斯里恰乓	Шричапан, Парадорн
台风	Тайфун
台南市	Тайнань
太湖	Тайху
研究生	Послевузовское профессиональное образование
加蒂诺市 (魁北克)	Гатино
针	Игла
加合拉·孛何妮	Бруни-Саркози, Карла
欧楂	Мушмула германская
袁枚	Юань Мэй
卡哟儿	Каджол
魔幻现实主义	Магический реализм
潘玉良	Пань Юйлян
勒	Узда
义和团	Ихэтуаньское восстание
李芙妮	Ливни, Ципи
列宁搿拉德围城搭仔保卫战	Блокада Ленинграда
1988年欧洲足球冠军赛	Чемпионат Европы по футболу 1988
皇家夜总会 (电影)	Казино «Рояль» (фильм, 2006)
薯条	Картофель фри
吉赛尔·邦臣	Бюндхен, Жизель
塔塔拿挪	Tata Nano
特强气旋风暴纳尔吉斯	Наргис (циклон)
2008年希腊街头骚乱	Массовые беспорядки в Греции (2008)
半岛战争	Пиренейские войны
日本杯	Japan Cup
利奧波德咖啡馆	Leopold Cafe
锅	Кастрюля
Bipasha Basu	Басу, Бипаша
纳吉丝	Наргис
英国电视电影艺术学院奖	BAFTA
毛纳洛火山	Мауна-Лоа
荷兰东印度公司	Голландская Ост-Индская компания
富牌国际机场	Хюэ (аэропорт)
铁路轨道	Железнодорожный путь
斷背山	Горбатая гора
雀巢公司	Nestlé
环球小姐	Мисс Вселенная
ADSL	ADSL
1992年欧洲足球冠军赛	Чемпионат Европы по футболу 1992
奥斯区亚国家足球队	Сборная Австрии по футболу
伦敦德里城	Дерри
新干线	Синкансэн
达新	Чиннават, Таксин
Olga Kurylenko	Куриленко, Ольга Константиновна
瑞士国家足球队	Сборная Швейцарии по футболу
莲姜国际机场	Далат Льенкхыонг (аэропорт)
金泳三	Ким Ён Сам
星海爭霸	StarCraft
波兰国家足球队	Сборная Польши по футболу
瑞穗银行	Mizuho Financial Group
环球影视城	Universal Studios
罗马尼亚国家足球队	Сборная Румынии по футболу
唐宁街10号	Даунинг-стрит, 10
小仲马	Дюма, Александр (сын)
芹苴机场	Кантхо (аэропорт)
罗杰·科恩伯格	Корнберг, Роджер
2008年末─2009年初加沙地带大规模军事行动	Операция «Литой свинец»
利息	Процентный доход
直接民主制	Прямая демократия
橡胶擦子	Стирательная резинка
幽老猫	Прятки
ا	Алиф
ت	Та (третья буква арабского алфавита)
ث	Са (буква арабского алфавита)
ج	Джим (буква арабского алфавита)
萨丽	Сари
1960年欧洲足球国家杯	Чемпионат Европы по футболу 1960
几何原本	Начала Евклида
خ	Ха (седьмая буква арабского алфавита)
د	Даль (буква арабского алфавита)
数码信号处理	Цифровая обработка сигналов
ر	Ра (буква арабского алфавита)
解热镇痛药	Анальгетик
木版画	Ксилография
世界小姐	Мисс Мира
长沙市	Чанша
阿披实	Ветчачива, Апхисит
越南国家航空公司	Vietnam Airlines
伦敦政治经济学院	Лондонская школа экономики и политических наук
油画	Масляная живопись
达乃 乌同秋克	Удомчоке, Данай
Portal:历史	Портал:История
泥石流	Сель
洲际弹道飞弹	Межконтинентальная баллистическая ракета
物流	Логистика
遗传转录	Транскрипция (биология)
繁体字	Традиционные китайские иероглифы
宦官	Евнух
虱误	Баг
阿歷克山德拉·柯倫泰	Коллонтай, Александра Михайловна
George F. Smoot	Смут, Джордж
Ϸ	Шо (буква)
锡克金庙	Хармандир-Сахиб
酋长航空公司	Emirates Airline
1996年欧洲足球冠军赛	Чемпионат Европы по футболу 1996
消费者物价指数	Индекс потребительских цен
国际足球联合会世界排名表	Рейтинг сборных ФИФА
卡本塔里亚湾	Карпентария
超级市场	Супермаркет
章子怡	Чжан Цзыи
Heineken	Heineken
威尔士国家足球队	Сборная Уэльса по футболу
千分比	Промилле
高雄市	Гаосюн
病人	Пациент
基拉尼湖	Озёра Килларни
1980年欧洲足球冠军赛	Чемпионат Европы по футболу 1980
1968年欧洲足球冠军赛	Чемпионат Европы по футболу 1968
1964年欧洲足球国家杯	Чемпионат Европы по футболу 1964
印第安纳琼斯 —— 水晶骷髅王国	Индиана Джонс и Королевство хрустального черепа
1972年欧洲足球冠军赛	Чемпионат Европы по футболу 1972
Bayes定理	Теорема Байеса
美人魚	Морская дева
普吉府	Пхукет
1984年欧洲足球冠军赛	Чемпионат Европы по футболу 1984
亚历山大	Александрия (значения)
昆明	Куньмин
老呒所依	Старикам тут не место (фильм)
东京铁塔	Телевизионная башня Токио
兰州市	Ланьчжоу
佛來崮	Ле-Пюи-ан-Веле
头趟公开募股	Первичное публичное предложение
羅迪尼亞	Родиния
欧里维娅	Ньютон-Джон, Оливия
Knol	Knol
Ͱ	Хета (буква)
法国航空447号班机	Катастрофа A330 в Атлантике
共享软件	Условно-бесплатное программное обеспечение
简化字	Упрощение иероглифов
Mike Myers	Майерс, Майк
文雅信使	Mercure de France
薄拉特 (电影)	Борат
張勉	Чан Мён
耳機	Наушники
利库德党	Ликуд
洛阳	Лоян
淞河	Сона (приток Роны)
白鳍豚	Китайский речной дельфин
1976年欧洲足球冠军赛	Чемпионат Европы по футболу 1976
平昌郡	Пхёнчхан
藤球	Сепактакрау
亚洲开发银行	Азиатский банк развития
奖学金	Стипендия
矮马	Пони
匈奴编年史	Хунну
孟子	Мэн-цзы
帝国理工	Имперский колледж Лондона
曾国藩	Цзэн Гофань
卫生	Социальная гигиена и организация здравоохранения
桂林	Гуйлинь
雪兰莪州	Селангор
海口市	Хайкоу
挪威广播公司	Норвежская вещательная корпорация
第一趟鸦片战争	Первая опиумная война
声调	Тон (лингвистика)
基督山伯爵	Граф Монте-Кристо
玛丽女王2号	Queen Mary 2
法国总统	Президент Франции
尹潽善	Юн Бо Сон
伊顿公学	Итонский колледж
越盾	Вьетнамский донг
解剖学治疗学及化学分类系统	Анатомо-терапевтическо-химическая классификация
尹致昊	Юн Чхи Хо
终结者3	Терминатор 3: Восстание машин
北卡罗莱纳大学教堂山分校	Университет Северной Каролины в Чапел-Хилл
我有一只梦	У меня есть мечта
上海世博会	Всемирная выставка (2010)
梦工厂	DreamWorks
谢列梅捷沃国际机场	Шереметьево
麵	Лапша
瑞联银行	UBS
观世音	Авалокитешвара
新曼谷国际机场	Суварнабхуми
闸北区	Чжабэй
张爱玲	Чжан Айлин
章太炎	Чжан Бинлинь
张道陵	Чжан Даолин
浙江大学	Чжэцзянский университет
郑洁	Чжэн Цзе
月饼	Юэбин
周迅	Чжоу Сюнь
株洲市	Чжучжоу
澎湖县	Пэнху (уезд)
壯學	Чжуанология
中国人民解放军	Народно-освободительная армия Китая
辛格·旺楚克 (不丹国王)	Джигме Сингье Вангчук
利尿药	Диуретики
毕升	Би Шэн
华南虎	Китайский тигр
巴黎大区高速铁路C线	Линия C (RER)
精神疾病诊断搭仔统计手冊	DSM-IV
米尔克 (电影)	Харви Милк (фильм)
高棉帝国	Камбуджадеша
狙击手	Снайпер
鼻衄	Носовое кровотечение
开脱•文斯莱脱	Уинслет, Кейт
平均	Показатели центра распределения
斯里兰卡国家板球队	Сборная Шри-Ланки по крикету
富国机场	Зыонгдонг (аэропорт)
李商隐	Ли Шанъинь
曹操	Цао Цао
火山湖	Кратерное озеро
水粉画	Гуашь
拨人忽视个真相	Неудобная правда
Isaac Hayes	Хейз, Айзек
春武里府	Чонбури (провинция)
武夷山	Уишань (горы)
塔麻可吉电子小鸡	Тамагочи
泰王国国歌	Гимн Таиланда
二氧化氮	Оксид азота(IV)
冬至	Зимнее солнцестояние
风月俏佳人	Красотка
新台币	Новый тайваньский доллар
混成词	Словослияние
法国省份一览表	Исторические области Франции
BOINC	BOINC
袁世凯	Юань Шикай
袋鼠岛	Кенгуру (остров)
泰拉 蕾	Рид, Тара
氯化氢	Хлороводород
刘翔	Лю Сян
蒙古人民共和国	Монгольская Народная Республика
DTD	DTD
开脱•末斯	Мосс, Кейт
娜塔莎·李察遜	Ричардсон, Наташа
三聚氰胺	Меламин
高隆皮亚国家足球队	Сборная Колумбии по футболу
莫尼卡-莱温斯基	Левински, Моника
雷曼兄弟公司	Lehman Brothers
大使馆	Дипломатическое представительство
金奎植	Ким Гюсик
IPod Shuffle	IPod shuffle
泼水节	Сонгкран
7-Zip	7-Zip
洋油盏	Керосиновая лампа
Julius Pokorny	Покорный, Юлиус
南沙群岛	Острова Спратли
湘潭市	Сянтань
费加罗报 (法国)	Le Figaro
汽车旅馆	Мотель
垃圾桶	Контейнер для мусора
金刚 (电影)	Кинг-Конг
泻药	Слабительное
海龜	Chelonioidea
赌城风云 (电影)	Казино (фильм, 1995)
化学品登记、评估、准许搭限制法规	REACH
ش	Шин (буква арабского алфавита)
性用品商店	Секс-шоп
ISO/IEC 8859	ISO 8859
关公	Гуань Юй
ف	Фа (буква арабского алфавита)
龟	Черепахи
东方明珠	Восточная жемчужина (телебашня)
国际足联世界冠军俱乐部杯赛	Клубный чемпионат мира по футболу
卢旺达旅馆	Отель «Руанда»
重见日头 (1996年电影)	Дневной свет (фильм, 1996)
苹果 (消歧义)	Apple (значения)
非洲国家列表	Список государств и зависимых территорий Африки
Isla Fisher	Фишер, Айла
石泰凡妮 莱斯	Райс, Стефани
印度空间研究组织	Индийская организация космических исследований
臺灣 (消歧義)	Тайвань (значения)
酱油	Соевый соус
新山	Джохор-Бару
MT	MT
泰-老友谊大桥二号桥	Второй мост тайско-лаосской дружбы
国富论	Исследование о природе и причинах богатства народов
清迈府	Чиангмай (провинция)
蔡英文	Цай Инвэнь
宋卡府	Сонгкхла (провинция)
玫瑰人生 (2007年电影)	Жизнь в розовом цвете
沙吞府	Сатун (провинция)
泰文字母表	Тайское письмо
清莱府	Чианграй (провинция)
拉廊府	Ранонг (провинция)
披集府	Пхичит (провинция)
We Are the Champions	We Are the Champions
九龙	Коулун
末尔悬岩	Утёсы Мохер
IT狂人	Компьютерщики
北榄坡府	Накхонсаван (провинция)
碧差汶府	Пхетчабун (провинция)
普吉国际机场	Пхукет (аэропорт)
抗心律失常药	Антиаритмические препараты
陈艳青	Чэнь Яньцин
2008年欧洲足球冠军赛	Чемпионат Европы по футболу 2008
五代十国	Эпоха пяти династий и десяти царств
森理世	Мори, Риё
索马里内战	Гражданская война в Сомали
沙马	Сунтхаравет, Самак
金砖国家	БРИКС
安纳乍能府	Амнатчарен (провинция)
董里府	Транг (провинция)
博他仑府	Пхаттхалунг (провинция)
纳戈尔诺-卡拉巴赫	Нагорно-Карабахская Республика
血色将至	Нефть (фильм)
乌泰他尼府	Утхайтхани (провинция)
新北市	Синьбэй
臺中市	Тайчжун
真爱个火焰 (印度电影)	Девдас (фильм, 2002)
新竹市	Синьчжу
鹅	Домашний гусь
年号	Девиз правления
高丽航空	Air Koryo
环球银行金融电信协会	SWIFT
Motorola	Motorola
赛义巴巴	Саи Баба из Ширди
欧洲足球冠军赛	Чемпионат Европы по футболу
汽水	Газированная вода
天狼星号油轮	Sirius Star
三沙市	Саньша
保合多伽勒国家足球队	Сборная Португалии по футболу
苏梅岛	Самуй
爱尔兰镑	Ирландский фунт
陈冯富珍	Чан, Маргарет
中岛美嘉	Накасима, Мика
Lauren Jackson	Джексон, Лорен
安娜 米亚里斯	Мирс, Анна
Prapawadee Jaroenrattanatarakoon	Прапавади Чаренраттанатаракун
邓亚萍	Дэн Япин
里斯班斯 齐凯脱	Трикетт, Лизбет
西跋榭滴	Шетти, Шилпа
Melissa Etheridge	Этеридж, Мелисса
陈冲	Чэнь, Джоан
陈若琳 (运动员)	Чэнь Жолинь
Jennifer Hawkins	Хоукинс, Дженнифер
张柏芝	Чун, Сесилия
Sheryl Swoopes	Свупс, Шерил
Pamela Jelimo	Джелимо, Памела
莱索尔 强斯	Джонс, Лизель
汤唯	Тан Вэй
诗丽黛玮	Шридеви
郭晶晶	Го Цзинцзин
陈燮霞	Чэнь Сеся
头孢菌素	Цефалоспорины
沙没巴干府	Самутпракан (провинция)
呵叻府	Накхонратчасима (провинция)
藏羚羊	Оронго
生个利亚酒	Сангрия
浮罗交怡	Лангкави
攀牙府	Пхангнга (провинция)
抗酸剂	Антациды
早稻田大学	Университет Васэда
吴 (三国)	У (Троецарствие)
氯霉素	Хлорамфеникол
猜也贲府	Чайяпхум (провинция)
计程车3	Такси 3
英特尔砂桥	Sandy Bridge
马肖·米切姆	Митчем, Мэттью
耶莲娜	Докич, Елена
硫酸镁	Сульфат магния
拉喇·杜打	Датта, Лара
汽车租赁	Прокат автомобилей
ک	Кяф (буква арабского алфавита)
ل	Лям (буква арабского алфавита)
م	Мим (буква арабского алфавита)
ن	Нун (буква арабского алфавита)
澳大利亚搭新西兰军团纪念日	День АНЗАК
ANZ大球场	Австралия (стадион)
杨玉环	Ян-гуйфэй
素拉育	Чуланонт, Сураюд
颂猜·旺沙瓦	Вонгсават, Сомчай
拍凤裕庭 (泰国将军)	Пхахон Пхаюхасена
奥特莱•导都	Тоту, Одри
Β－内酰胺类抗生素	Бета-лактамные антибиотики
金城武	Канэсиро, Такэси
周星驰	Чоу, Стивен
EXist	EXist
WHO	Who
多尼尔228	Dornier Do 228
孙权	Сунь Цюань
蒋经国	Цзян Цзинго
墨尔本胜利	Мельбурн Виктори
纳维语	На’ви (язык)
Al Burj大厦 (迪拜)	Башня Накхил
神舟七号飞船	Шэньчжоу-7
鬼勒耳朵边头讲	Говорящая с призраками
Grant George Hackett	Хэкетт, Грант
松浦晃一郎	Мацуура, Коитиро
茄特 艾勒麦勒	Эльмалех, Гад
韩愈	Хань Юй
梁朝伟	Люн Чу Вай, Тони
丁俊晖	Дин Цзюньхуэй
澳大利亚总理	Премьер-министр Австралии
王安石	Ван Аньши
投资银行	Инвестиционный банк
徐載弼	Со Джэпхиль
阿宾拿夫 宾德拉	Биндра, Абхинав
巴真府	Прачинбури (провинция)
精工表	Seiko
杭州灣大橋	Мост через залив Ханчжоувань
武里喃府	Бурирам (провинция)
坤敬府	Кхонкэн (провинция)
德国无线通信	T-Mobile
廊开府	Нонгкхай (провинция)
基斯孔哈拉斯	Кишкунхалаш
日本中央银行	Банк Японии
Raja Ravi Varma	Рави Варма
李自成	Ли Цзычэн
哈桑式火箭弹	Кассам (оружие)
林语堂	Линь Юйтан
朴憲永	Пак Хон Ён
金枓捧	Ким Ду Бон
龙仔厝府	Самутсакхон (провинция)
信武里府	Сингбури (провинция)
包拯	Бао Чжэн
武昌起义	Учанское восстание
镐立 (泰国)	Као Лак
同心隆安足球俱乐部	Донгтам Лонган
Ad-hoc On-demand Distance Vector	AODV
VOC	VOC
阿德来德联队	Аделаида Юнайтед
芜湖市	Уху
安庆市	Аньцин
亳州市	Бочжоу
上饶	Шанжао
冯玉祥	Фэн Юйсян
佛历	Буддийский календарь
银河处女	Virgin Galactic
2007年加沙地带争夺战	Бои в секторе Газа (2007)
拗廊 (泰国)	Аонанг
新兴工业国家	Новые индустриальные страны
崇明岛	Чунминдао
李鸿章	Ли Хунчжан
塞杜沙里夫	Сайду-Шариф
中秋节	Праздник середины осени
元均	Вон Гюн
浅野忠信	Асано, Таданобу
炳·廷素拉暖	Тинсуланон, Прем
雷锋	Лэй Фэн
梁启超	Лян Цичао
多尔衮	Доргонь
素可泰府	Сукхотхай (провинция)
卡茂尔·哈珊	Камал Хасан
彭德怀	Пэн Дэхуай
依善	Исан (регион)
紫峰大厦	Финансовый центр Наньцзин-Гринлэнд
姚文元	Яо Вэньюань
Khao Yai National Park	Кхауяй
应召女郎个秘密日记	Тайный дневник девушки по вызову
斯瓦特县	Сват (Пакистан)
悉尼晨锋报	The Sydney Morning Herald
The quick brown fox jumps over the lazy dog	The quick brown fox jumps over the lazy dog
TCL	TCL
静安寺	Цзинъаньсы
亚洲航空	AirAsia
秋叶原	Акихабара
徐光启	Сюй Гуанци
林可酰胺类抗生素	Линкозамиды
强心苷	Сердечные гликозиды
SDS	Лаурилсульфат натрия
四环素类抗生素	Тетрациклины
大环内酯类抗生素	Макролиды
恒生指数	Hang Seng
喹诺酮	Хинолоны
新苏格兰银行	Scotiabank
Моа	Моа
掸邦	Шан (штат)
1976年河北唐山大地震	Таншаньское землетрясение
上海地铁	Шанхайский метрополитен
以色列空军	Военно-воздушные силы Израиля
玩转身前事	Пока не сыграл в ящик
崇礼门	Намдэмун
嫦娥	Чанъэ
安娜 孛莱	Блай, Анна
Liudmila Blonska	Блонская, Людмила Леонидовна
吴三桂	У Саньгуй
孙亮	Сунь Лян
宋吉 (拳手)	Чонгчохор, Сомчит
韩寒	Хань Хань
滑水	Воднолыжный спорт
泰国人	Тайцы
亚罗士打	Алор-Сетар
世界佛教徒聯誼會	Всемирное братство буддистов
新山一国际机场	Таншоннят
宏碁电脑	Acer
运动场	Стадион
朝鲜半岛	Корейский полуостров
圣保罗地铁	Метрополитен Сан-Паулу
亚运会	Азиатские игры
捷克国家足球队	Сборная Чехии по футболу
朝鲜族	Корейцы
吕克·贝松	Бессон, Люк
Tesco	Tesco
萨尔浒之战	Битва у горы Сарху
傲游浏览器	Maxthon
供应链管理	Управление цепями поставок
复旦大学	Фуданьский университет
仁川地铁	Метрополитен Инчхона
李光洙	Ли Гвансу
朴重陽	Пак Чжон-ян
奶粉	Сухое молоко
班地戈 (维克多利亚)	Бендиго
朝鲜核问题	Ракетно-ядерная программа КНДР
韩国放送公社	Korean Broadcasting System
莎阿南	Шах-Алам
玉山	Юйшань
雜合子	Гетерозигота
西湖	Сиху
澳大利亚日	День Австралии
大屿山	Лантау
60秒惊天动地	Угнать за 60 секунд (фильм, 2000)
伊斯兰祈愿团	Джемаа Исламия
Andry Laffita	Лаффита, Андри
中庸	Чжун юн
德文语法	Грамматика немецкого языка
输入法	IME
托忒蒙古文	Тодо-бичиг
卡卡	Кака
南印度	Южная Индия
2009年枪击斯里兰卡板球队事件	Террористический акт в Лахоре (2009)
星期四岛	Терсди
陈英雄	Чан, Ань Хунг
徐志摩	Сюй Чжимо
蒙古简介	Монгольское плато
巴彦淖尔	Баян-Нур
稷下學宮	Академия Цзися
南京路	Нанкинская улица
意大利杂菜汤	Минестроне
算筹	Счётные палочки
咳嗽药	Противокашлевые средства
罗得乃斯脱岛	Роттнест
世界大婶	Миссис мира
SourceWatch	SourceWatch
泰国旅游	Туризм в Таиланде
琅琴表	Longines
奠边府战役	Битва при Дьенбьенфу
窝同搿 (维克多利亚)	Уодонга
胡志明	Хошимин (значения)
List of Thailand cities	Города Таиланда
法拉备拉矮马	Фалабелла
水 (2005年电影)	Вода (фильм, 2005)
西非国家中央银行	Центральный банк государств Западной Африки
依夫城堡	Замок Иф
皮蛋	Столетнее яйцо
庐山	Лушань
必和必拓矿业公司	BHP Billiton
零假设	Нулевая гипотеза
电脑语言	Компьютерный язык
世纪报	The Age
霍元甲 (电影)	Бесстрашный (фильм, 2006)
布鲁塞尔皇宫	Королевский дворец (Брюссель)
饺子	Цзяоцзы
山猜 拉蒂伐塔娜	Ративатана, Санчай
乃米湖	Неми (озеро)
维杰式坦克 (印度)	Виджаянта
黄浦区	Хуанпу (Шанхай)
长宁区	Чаннин (Шанхай)
广州地铁	Метрополитен Гуанчжоу
静安区	Цзинъань
普陀区 (上海)	Путо (район)
虹口区	Хункоу
杨浦区	Янпу
闵行区	Миньхан
宝山区 (上海)	Баошань (Шанхай)
嘉定区	Цзядин
金山区 (上海市)	Цзиньшань (Шанхай)
松江区	Сунцзян (район)
青浦区	Цинпу (Шанхай)
奉贤区	Фэнсянь (Шанхай)
性旅游者	Секс-туризм
卡里平	Вест-Индия
素岳山	Дойсутхеп
教堂山 (北卡罗来纳州)	Чапел-Хилл
启德机场	Кайтак
昆剧	Куньцюй
意大利国家足球队	Сборная Италии по футболу
国际先驱论坛报	International Herald Tribune
流亡政府	Правительство в изгнании
发声态	Фонация
日本色情业	Порнография в Японии
中文数字大写	Китайские числительные
南京大學	Нанкинский университет
輔仁大學	Католический университет Фужэнь
鹰式教练机	Hawker Siddeley Hawk
搿连搭罗格 (爱尔兰)	Глендалох
快门	Фотографический затвор
白朗	Blaupunkt
Shooting Dogs	Отстреливая собак
金刚	Ваджра
谥号	Посмертное имя
吴佩孚	У Пэйфу
吴敬梓	У Цзинцзы
四庫全書	Сыку цюаньшу
杭州湾	Ханчжоувань
张士诚	Чжан Шичэн
网球王子	The Prince of Tennis
段祺瑞	Дуань Цижуй
中法战争	Франко-китайская война
台湾高速铁路	Тайваньская высокоскоростная железная дорога
Twins	Twins (поп-группа)
庙号	Храмовое имя
刘嘉玲	Лау, Карина
汤恩伯	Тан Эньбо
罗慧娟	Лоу, Жаклин
李定国	Ли Динго
溫州話	Вэньчжоуский диалект
西德	Федеративная Республика Германии (до 1990)
油条	Ютяо
陈良宇	Чэнь Лянъюй
亚洲国家列表	Список государств и зависимых территорий Азии
张献忠	Чжан Сяньчжун
杨采妮	Ян, Чарли
攀牙湾	Пхангнга (залив)
色，戒	Вожделение (фильм)
鲸体爆炸事件	Взрыв кита
中子彈	Нейтронное оружие
澳大利亚电信公司	Telstra
上海申花足球俱乐部	Шанхай Шэньхуа
俄罗斯国家足球队	Сборная России по футболу
计程车(1998年电影)	Такси (фильм)
XUL	XUL
蓝天处女	Virgin Australia
現代標準漢語	Путунхуа
پ	Пе (буква персидского алфавита)
赛义德·西扬姆	Сиам, Саид
圆仁	Эннин
James Angleton	Энглтон, Джеймс Хесус
宋恰脱 拉蒂伐塔娜	Ративатана, Сончат
中国国家图书馆	Национальная библиотека Китая
大漠孤雄 (电影)	Монгол (фильм)
墨尔本机场。	Мельбурн (аэропорт)
西昌卫星发射中心	Сичан (космодром)
镇	Посёлок (КНР)
鲁国	Лу (княжество)
捧景配启 (拳手)	Кингпетч, Поне
神户机场	Кобе (аэропорт)
巴黎大区高速铁路A线	Линия A (RER)
泰国人妖	Катой
丢勒个犀牛	Носорог (гравюра Дюрера)
泰国北部	Северный Таиланд
凯山丰威汉市	Саваннакхет (город)
高分子化学	Химия полимеров
苏州码子	Цифры Сучжоу
克里米亚共和国	Автономная Республика Крым
计程车2	Такси 2
计程车4	Такси 4
医疗游客	Медицинский туризм
捷星航空	Jetstar Airways
暖武里市	Нонтхабури
素叻国际机场	Сураттхани (аэропорт)
岘港国际机场	Дананг (аэропорт)
百越	Байюэ
共同語	Койне (лингвистика)
崇明县	Чунмин
国王岛	Кинг (остров, Тасмания)
宋卡市	Сонгкхла
巴卡西半岛	Бакасси
挽甲必区	Бангкапи
盘谷银行	Bangkok Bank
马来西亚国家银行	Банк Негара Малайзия
爱尔兰银行	Bank of Ireland
赞比亚国家银行	Банк Замбии
泰国国家银行	Банк Таиланда
应召女郎	Девушка по вызову
赤壁(2008年电影)	Битва у Красной скалы (фильм)
普腾汽车	Proton Edar Sdr Holding
码头	Причальная стенка
购物	Шопинг
富通银行	Fortis
远古侵略	Портал юрского периода
白云山 (广州)	Байюньшань (Гуандун)
韶山市	Шаошань
Schweppes	Schweppes
傣族	Дайцы
东突厥斯坦	Восточный Туркестан
內排国际机场	Ханой (аэропорт)
普吉市	Пхукет (город)
F-15雷暴式战斗机	McDonnell Douglas F-15E Strike Eagle
抗病毒药	Противовирусные препараты
史弥远	Ши Миюань
國際語音學學會	Международная фонетическая ассоциация
火锅	Хого
阿嘞白拿湖	Альбано
冠军	Чемпион
越捷航空	VietJet Air
巴乃到乃	Панеттоне
拉玛九世	Пхумипон Адульядет
流浪者 (印度电影)	Бродяга (фильм, 1951)
嫦娥工程	Лунная программа Китая
日落大道	Бульвар Сансет
科索沃宣布独立事件（2008年）	Провозглашение независимости Косова
东南亚国家杯足球比赛	Чемпионат АСЕАН по футболу
苏丹航空公司	Sudan Airways
石头城	Каменный город (Нанкин)
苏梅国际机场	Самуи (аэропорт)
那空沙旺府教区	Епархия Накхонсавана
阴蒂	Клитор
三清山	Саньциншань
胡志明纪念堂	Мавзолей Хо Ши Мина
喃字	Тьы-ном
性奴隶	Сексуальное рабство
天主教上海教区	Епархия Шанхая
坤敬市	Кхонкэн
粥	Рисовый отвар
孛拉尼城堡	Замок Бларни
1993年印度孟买炸弹大爆炸	Взрывы в Бомбее (1993)
孛拉先拿湖	Браччано (озеро)
金瓯机场	Камау (аэропорт)
Debian自由软件指导方针	Критерии Debian по определению свободного программного обеспечения
外蒙古	Внешняя Монголия
挥发性有机化合物	Летучие органические вещества
2009年以色列国会大选	Парламентские выборы в Израиле (2009)
动力大厦 (迪拜)	Вращающаяся башня
吴国	У (царство, Чуньцю)
合艾国际机场	Хатъяй (аэропорт)
南美洲国家列表	Список государств и зависимых территорий Южной Америки
苏州地铁	Метрополитен Сучжоу
帮助:目录	Википедия:Справка
Wikipedia:Tutorial	Википедия:Первые шаги
龙虎山	Лунхушань
泰-老友谊大桥一号桥	Мост тайско-лаосской дружбы
澎湖列岛	Пэнху
中国画	Китайская живопись
盖代拉	Гедера
澳大利亚国家气象局	Бюро метеорологии
支气管扩张剂	Бронхолитики
京津城际铁路	Междугородная железная дорога Пекин — Тяньцзинь
琼语	Хайнаньский язык
莱 (泰国)	Рай (мера площади)
弗林德斯岛 (塔斯曼尼亚)	Флиндерс (остров)
印度储备银行	Резервный банк Индии
泰国王家军队	Вооружённые силы Таиланда
河姆渡文化	Хэмуду
福布斯	Forbes
马拉浦南	Малаппурам
塔斯马尼亚州立大学	Университет Тасмании
清莱国际机场	Чианграй (аэропорт)
德天瀑布	Дэтянь
陈情中	Чаи Читчоб
破坏之王 (电影)	Доставка любви
宁波地铁	Метрополитен Нинбо
草原	Травянистые сообщества
金球奖	Золотой глобус
Wikipedia:WikiProject Spoken Wikipedia	Проект:Аудиостатьи
比拉伊	Пираи
宜兴市	Исин (Цзянсу)
维克多港	Виктор-Харбор
卢湾区	Лувань
1983年澳大利亚个圣灰星期三大火	Пожары Пепельной среды
海曙区	Хайшу
新都区	Синьду
阿拉善右旗	Алашань-Юци
龙虾	Омары
中毒债务	Мусорные облигации
后金	Поздняя Цзинь
大报恩寺（南京）	Фарфоровая пагода
南京中国近代史遗址博物馆	Музей новейшей китайской истории
宋国	Сун (царство)
清迈国际机场	Чиангмай (аэропорт)
泰鸟航空公司	Nok Air
O'Reilly Media	O’Reilly Media
后羿	Хоу И
2008年欧洲足球冠军赛资格赛A组	Чемпионат Европы по футболу 2008 (отборочный турнир, группа A)
2008年欧洲足球冠军赛资格赛E组	Чемпионат Европы по футболу 2008 (отборочный турнир, группа E)
龙井茶	Лунцзин (чай)
泰国南部	Южный Таиланд
越南南方共和国	Временное правительство Республики Южный Вьетнам
中国国家博物馆	Национальный музей Китая
百万富豪	Миллионер
Club Méd	Club Med
2008年欧洲足球冠军赛资格赛B组	Чемпионат Европы по футболу 2008 (отборочный турнир, группа B)
人民民主联盟 (泰国)	Народный союз за демократию
韓國 (消歧義)	Корея (значения)
库克船长个小房子	Коттедж капитана Джеймса Кука
گ	Гаф
迪拜大商场	Dubai Mall
婚礼歌手	Певец на свадьбе
异食癖	Извращение вкуса
本田爵士 (汽车)	Honda Jazz
越国	Юэ (царство)
为泰党 (泰国)	Пхыа Тхаи
巩金瓯	Золотой кубок (гимн)
澳大利亚邮政局	Почта Австралии
大中华地区	Большой Китай
中华人民共和国国庆节	День образования КНР
2008年欧洲足球冠军赛资格赛D组	Чемпионат Европы по футболу 2008 (отборочный турнир, группа D)
佛统大塔寺	Пхра Патом Чеди
1931年个江淮大水	Наводнение в Китае (1931)
还剑湖	Хоанкьем
愛科蘭舞	Futari wa Pretty Cure
阿含经	Агамы (буддизм)
西施	Си Ши
当涂县	Данту
侬	Вы
蒙古	Монголия (значения)
法国人口	Население Франции
梅林	Мерлин (телесериал)
泰国民主党	Демократическая партия (Таиланд)
西湖 (河内)	Тай (озеро)
东亚运动会	Восточноазиатские игры
法师旅馆 (日本)	Хоси (отель)
长江三角洲	Дельта Янцзы
南明	Династия Южная Мин
泰国个佛教	Буддизм в Таиланде
九龙半岛	Цзюлун (полуостров)
机场	Аэропорт
世界大桥长度排名	Список самых длинных мостов
男妓	Мужская проституция
千字文	Тысячесловие
勾践	Гоуцзянь
伍子胥	У Цзы-сюй
新西兰护照	Паспорт гражданина Новой Зеландии
澳大利亚护照	Паспорт гражданина Австралии
街妓	Уличная проституция
朱温	Тай-цзу (Поздняя Лян)
轻率女子 (电影)	Лёгкое поведение (фильм, 2008)
土星运载火箭	Сатурн (ракеты)
核放射事故	Список радиационных аварий
墨尔本杯	Мельбурнский кубок
办酒窠	Дочки-матери (игра)
京滨急行电铁	Keikyu Corporation
泰国人民反独裁民主联盟	Объединённый фронт за демократию против диктатуры
寶貝計劃	Роб-Би-Гуд
汉服	Ханьфу
中山陵	Мавзолей Сунь Ятсена
上海大学	Шанхайский университет
彭世洛机场	Пхитсанулок (аэропорт)
巴黎大区高速铁路B线	Линия B (RER)
罗皇节	Лосар
富劳里友半岛	Флоро
江南	Цзяннань
开县	Кайсянь
西密朗群岛	Симилан
乌达抛飞机场 (泰国)	Паттайя (аэропорт)
范蠡	Фань Ли
洛坤机场	Накхонситхаммарат (аэропорт)
法朗 (泰语)	Фаранг
分类:德国	Категория:Германия
分类:意大利	Категория:Италия
分类:美国	Категория:США
分类:俄罗斯	Категория:Россия
分类:英国	Категория:Великобритания
分类:西班牙	Категория:Испания
分类:中国	Категория:Китай
分类:日本	Категория:Япония
分类:澳大利亚	Категория:Австралия
分类:墨西哥	Категория:Мексика
分类:印度	Категория:Индия
分类:阿根廷	Категория:Аргентина
门牌号码	Нумерация домов
火•1996 (电影)	Огонь (фильм)
富国国际机场	Международный аэропорт Фукуок
吉碑国际机场	Хайфон Катби (аэропорт)
水灯节 (东南亚)	Лойкратхонг
密封剂	Герметик
武里喃机场	Бурирам (аэропорт)
湄宏顺机场	Мэхонгсон (аэропорт)
楠府机场	Нан (аэропорт)
鸟汶机场	Убонратчатхани (аэропорт)
چ	Че (буква персидского алфавита)
分类:印度尼西亚	Категория:Индонезия
分类:乃特朗特	Категория:Нидерланды
分类:新加坡	Категория:Сингапур
分类:韩国	Категория:Южная Корея
分类:泰国	Категория:Таиланд
分类:越南	Категория:Вьетнам
分类:哺乳动物	Категория:Млекопитающие
分类:植物	Категория:Растения
分类:物理	Категория:Физика
分类:生物学	Категория:Биология
分类:化学	Категория:Химия
分类:历史	Категория:История
分类:地理	Категория:География
分类:社会	Категория:Общество
分类:宗教	Категория:Религия
分类:体育运动	Категория:Спорт
分类:科学	Категория:Наука
分类:建筑物	Категория:Здания и сооружения
维曼默宫	Виманмек
乡	Волости Китая
素岳寺	Ват Прахат Дой Сутхеп
军人银行 (泰国)	TMB Bank
先锋号潜水艇 (英国)	HMS Vanguard (1992)
韓國 (戰國)	Хань (царство)
华欣	Хуахин
宋卡湖	Тхалелуанг
制片公司	Продюсерская компания
小珊瑚岛 (泰国)	Лан (остров)
涂改液	Канцелярский корректор
神舟十号	Шэньчжоу-10
韦伯斯特大字典	Словарь Уэбстера
越南语音系	Фонология вьетнамского языка
囚犯	Заключённый
巴士底獄	Бастилия
泰国足球联赛	Чемпионат Таиланда по футболу
乍都节公园	Чатучак
清迈夜市	Ночной рынок
定向圖	Спортивная карта
生肖	Китайский зодиак
中国人口	Население Китайской Народной Республики
分类:消歧义	Категория:Многозначные термины
分类:佛教	Категория:Буддизм
分类:基督教	Категория:Христианство
分类:伊斯兰教	Категория:Ислам
蓝星行动 (印度)	Операция «Голубая звезда»
江孜	Гьянгдзе
邪恶圣经	Злая Библия
2008年印度因帕尔炸弹爆炸	Террористический акт в Импхале
华东师范大学	Восточно-китайский педагогический университет
渠	Канава
运动员	Атлет
澳大利亚人口	Население Австралии
The Triffids (乐队)	The Triffids
Poise	Пуаз
印度语言及方言	Список языков Индии по количеству носителей
罗津	Раджин-гуёк
吴	У
女阴	Вульва
越南国家银行	Государственный банк Вьетнама
巴亭广场	Бадинь (площадь)
吞武里区	Тхонбури
饭岛真理	Иидзима, Мари
2009年年孟加拉国步枪队哗变	Бунт пограничников
Bochotnica	Бохотница
东盟宪章	Устав АСЕАН
砂岩大学	Песчаниковые университеты
堤岸 (越南)	Тёлон
泰国华人	Китайцы в Таиланде
背越式	Фосбери-флоп
2008年丹麦驻巴基斯坦大使馆爆炸	Атака террористов на посольство Дании в Исламабаде
紫砂壶	Исинская глина
隆宾尼拳场	Стадион Лумпхини
常州天宁寺	Пагода Тяньнин (Цзянсу)
剑桥高级英语证书	Certificate in Advanced English
2005年安曼炸弹爆炸	Террористический акт в Аммане 9 ноября 2005 года
2008年头一趟印度德里炸弹爆炸	Серия терактов в Дели 13 сентября 2008 года
玛格达·苏邦斯基	Шубански, Магда
梧桐河	Ынтхун
2008年末全球汽车工业危机	Кризис в мировом автопроме
正一派	Школа Истинного Единства
迪斯科 (2008年电影)	Диско (фильм)
文白异读	Местные чтения китайских иероглифов
无锡地铁	Метрополитен Уси
非典型性肺炎	Атипичная пневмония
斯维斯(Switzerland) 勒欧罗维竞唱歌比赛表现:年份 2008	Швейцария на конкурсе песни Евровидение 2008
选美	Конкурс красоты
淀山湖	Дяньшань
Suka	Сука (музыкальный инструмент)
止泻药	Противодиарейные средства
春晚	Новогодний гала-концерт на CCTV
分类:未完个文章	Категория:Незавершённые статьи
分类:维基百科分类	Категория:Википедия:Категоризация
分类:维基百科管理	Категория:Википедия:Служебные
分类:文化	Категория:Культура
分类:大洲	Категория:Континенты
分类:地质学	Категория:Геология
张格尔	Джахангир-ходжа
小城之春	Весна в маленьком городке
Wikipedia:Selected anniversaries	Проект:События дня
Wikipedia:命名常规	Википедия:Именование статей
剃刀	Бритвенный станок
太古城	Тхайкусин
Portal:地理	Портал:География
TAFE	TAFE
春蓬机场	Чумпхон (аэропорт)
可口可乐公司	The Coca-Cola Company
Wikipedia:HotCat	Википедия:Гаджеты/HotCat
龙纳度 费拉拉	Филарас, Леонардос
分类:维基百科机器人	Категория:Участники:Боты
大阪	Осака (значения)
Portal:艺术	Портал:Искусство
分类:美国人	Категория:Персоналии:США
分类:演员	Категория:Актёры
分类:英国人	Категория:Персоналии:Великобритания
分类:法国人	Категория:Персоналии:Франция
模板:Tl	Шаблон:Tl
模板:Userbox	Шаблон:Userbox
模板:Wikipedialang	Шаблон:Wikipedialang
模板:Itn	Шаблон:Актуальные события
Wikipedia:问题	Википедия:Форум/Справочное бюро
分类:自由软件	Категория:Свободное программное обеспечение
分类:国家	Категория:Страны
Wikipedia:Changing username	Википедия:Запросы на переименование учётных записей
Wikipedia:管理员	Википедия:Администраторы
模板:Sport-stub	Шаблон:Sport-stub
分类:人物	Категория:Люди
分类:职业	Категория:Профессии
分类:各行各业个人	Категория:Люди по профессиям
Wikipedia:机器人	Википедия:Бот
分类:货币	Категория:Деньги
分类:工程學	Категория:Инженерия
Wikipedia:AutoWikiBrowser	Википедия:AutoWikiBrowser
分类:医学	Категория:Медицина
分类:政治	Категория:Политика
分类:教育	Категория:Образование
分类:光学	Категория:Оптика
分类:艺术	Категория:Искусство
埃及	Египет
Wikipedia:手傀儡	Википедия:Многоликость
Wikipedia:Categorization	Википедия:Категоризация
芭堤雅—小小泰国乐园	Мини-Сиам
模板:Bot	Шаблон:Bot
加拿大	Канада
分类:倍尔奇姆	Категория:Бельгия
分类:捷克	Категория:Чехия
Wikipedia:版权	Википедия:Авторские права
Wikipedia:关于	Википедия:Описание
细川澄元	Хосокава Сумимото
分类:电子游戏	Категория:Компьютерные игры
分类:游戏	Категория:Игры
工业工程	Промышленная инженерия
帮助:編輯摘要	Википедия:Описание изменений
Portal:科学	Портал:Наука
模板:Flagicon	Шаблон:Флаг
分类:欧洲国家	Категория:Страны Европы
分类:欧洲	Категория:Европа
Wikipedia:Subpages	Википедия:Подстраницы
Wikipedia:近段辰光个事体	Портал:Текущие события
模板:Documentation	Шаблон:Doc
Wikipedia:User access levels	Википедия:Права участников
Wikipedia:聊天频道	Википедия:IRC
分类:维基人	Категория:Википедия:Участники
Wikipedia:社区门堂	Википедия:Портал сообщества
分类:User by languages	Категория:Википедия:Участники по языкам
帮助:用词指南	Википедия:Избегайте неопределённых выражений
成在基	Сон Джэги
模板:Soft redirect	Шаблон:Soft redirect
模板:Delete	Шаблон:К быстрому удалению
分类:维基百科版权	Категория:Википедия:Авторские права
分类:技术	Категория:Технология
湄公河威士忌 (泰国)	Тайский виски
卫星天线	Зеркальная антенна
分类:言话	Категория:Языки
分类:历法	Категория:Календарь
分类:维基百科	Категория:Википедия
分类:各样言话个维基百科	Категория:Разделы Википедии
分类:朆索引个页	Категория:Неиндексируемые страницы
分类:有无用文件链接个页	Категория:Страницы со ссылками на отсутствующие файлы
分类:現在正發生個事體	Категория:Текущие события
Wikipedia:維基休息	Википедия:Вики-отпуск
模板:-	Шаблон:-
模板:Navbox	Шаблон:Navbox
市辖区	Район городского подчинения (КНР)
模板:Fact	Шаблон:Нет источника
分类:維基百科維護	Категория:Википедия:Статьи для улучшения
分类:泰国网球运动员	Категория:Теннисисты Таиланда
模板:Error	Шаблон:Error
模板:((	Шаблон:((
模板:))	Шаблон:))
模板:!!	Шаблон:!!
模板:=	Шаблон:=
模板:Tnavbar	Шаблон:Tnavbar
模板:Code	Шаблон:Code
模板:0	Шаблон:0
模板:Unicode	Шаблон:Unicode
模板:Small	Шаблон:Small
模板:Clear	Шаблон:Clear
模板:Col-break	Шаблон:Столбец
模板:Col-begin	Шаблон:Столбцы
模板:Col-end	Шаблон:Столбцы/конец
模板:Nowrap	Шаблон:Nobr
模板:Bots	Шаблон:Bots
Wikipedia:必有个页面	Википедия:Список статей, которые должны быть во всех языковых версиях
分类:非洲	Категория:Африка
分类:數字	Категория:Числа
分类:电子学	Категория:Электроника
分类:书	Категория:Книги
模板:Wikisource	Шаблон:Викитека
模板:Babel	Шаблон:Babel
模板:Commons	Шаблон:Commons
模板:Reflist	Шаблон:Примечания
模板:AFG	Шаблон:AFG
Wikipedia:列明來源	Википедия:Ссылки на источники
模板:Stub	Шаблон:Заготовка
模板:See also	Шаблон:См. также
模板:User de	Шаблон:User de
模板:User de-1	Шаблон:User de-1
模板:User es	Шаблон:User es
模板:User de-3	Шаблон:User de-3
模板:User en-3	Шаблон:User en-3
模板:User en-1	Шаблон:User en-1
模板:User en-2	Шаблон:User en-2
模板:User en-4	Шаблон:User en-4
模板:User en	Шаблон:User en
模板:User de-2	Шаблон:User de-2
模板:User es-1	Шаблон:User es-1
模板:User fa	Шаблон:User fa
模板:User fr-1	Шаблон:User fr-1
分类:各国个文化	Категория:Культура по странам
分类:物质	Категория:Материя
模板:User ja-4	Шаблон:User ja-4
模板:User sk	Шаблон:User sk
模板:User fr-2	Шаблон:User fr-2
模板:User ja	Шаблон:User ja
模板:User ja-1	Шаблон:User ja-1
模板:User it-1	Шаблон:User it-1
模板:User fr	Шаблон:User fr
模板:Unsigned	Шаблон:Unsigned
模板:HRV	Шаблон:HRV
分类:亚洲	Категория:Азия
分类:智利	Категория:Чили
分类:21世紀	Категория:XXI век
分类:User uk	Категория:User uk
分类:南美洲	Категория:Южная Америка
分类:User uk-N	Категория:User uk-N
模板:Intricate template	Шаблон:Эзотерика
分类:马来西亚	Категория:Малайзия
分类:食物	Категория:Пища
分类:足球	Категория:Футбол
模板:Mod	Шаблон:Mod
模板:User uk	Шаблон:User uk
模板:User es-2	Шаблон:User es-2
模板:WikipediaSister	Шаблон:Сообщество Википедии
模板:USA	Шаблон:USA
分类:年历	Категория:Альманахи
分类:组织	Категория:Организации
分类:语言学	Категория:Лингвистика
模板:ITA	Шаблон:ITA
模板:GEO	Шаблон:GEO
模板:BOL	Шаблон:BOL
分类:鏈接模板	Категория:Шаблоны:Ссылки
模板:MEX	Шаблон:MEX
分类:User fr-1	Категория:User fr-1
模板:Wikiquote	Шаблон:Викицитатник
模板:Image label	Шаблон:Метка изображения
模板:Translated page	Шаблон:Переведённая статья
模板:MAR	Шаблон:MAR
模板:Ja icon	Шаблон:Ref-ja
模板:Korea-stub	Шаблон:Korea-stub
模板:PSE	Шаблон:PSE
模板:Sidebar	Шаблон:Боковая навигационная таблица
模板:Es icon	Шаблон:Ref-es
模板:Ambox	Шаблон:Ambox
模板:Update	Шаблон:Обновить
模板:SVK	Шаблон:SVK
模板:TWN	Шаблон:TWN
模板:EGY	Шаблон:EGY
模板:Quotation	Шаблон:Quotation
模板:KGZ	Шаблон:KGZ
模板:Infobox School	Шаблон:Школа
模板:ISR	Шаблон:ISR
模板:Nobel Prize in Physics	Шаблон:Нобелевская премия по физике
模板:Infobox Country	Шаблон:Государство
模板:Column-count	Шаблон:Column-count
模板:VEN	Шаблон:VEN
模板:Airline infobox	Шаблон:Карточка авиакомпании
模板:Wide image	Шаблон:Панорама
模板:UKR	Шаблон:UKR
模板:Px	Шаблон:Px
模板:好哉	Шаблон:Сделано
模板:Audio	Шаблон:Audio
模板:Flatlist	Шаблон:Flatlist
模板:PHL	Шаблон:PHL
模板:ROU	Шаблон:ROU
模板:BHR	Шаблон:BHR
模板:TUR	Шаблон:TUR
模板:Expand section	Шаблон:Заготовка раздела
模板:Tmbox	Шаблон:Tmbox
模板:清理	Шаблон:Чистить
模板:DJI	Шаблон:DJI
模板:Infobox university	Шаблон:Карточка университета
模板:BRN	Шаблон:BRN
模板:Wikibooks	Шаблон:Викиучебник
模板:Hatnote	Шаблон:Другое значение
模板:S-after	Шаблон:S-aft
分类:巴黎	Категория:Париж
分类:User en-4	Категория:User en-4
分类:User en	Категория:User en
分类:User zh	Категория:User zh
分类:User zh-N	Категория:User zh-N
分类:User en-2	Категория:User en-2
模板:Infobox	Шаблон:Карточка
模板:Right TOC	Шаблон:TOC right
模板:Main other	Шаблон:Main other
模板:User zh	Шаблон:User zh
模板:Template other	Шаблон:Template other
模板:Legend	Шаблон:Легенда
模板:Cite web	Шаблон:Cite web
模板:Youtube	Шаблон:YouTube
模板:Current	Шаблон:Текущие события
分类:軍事裝備	Категория:Военная техника
模板:Infobox WS	Шаблон:Письменность
模板:Ombox	Шаблон:Ombox
分类:女模特	Категория:Фотомодели по алфавиту
模板:IMDb title	Шаблон:Imdb title
模板:User ru-4	Шаблон:User ru-4
分类:饮食	Категория:Еда и напитки
模板:Wiktionary	Шаблон:Викисловарь
模板:Mbox templates	Шаблон:Mbox templates
薄拉特	Борат Сагдиев
模板:Multi-listen start	Шаблон:Multi-listen start
模板:Languageicon	Шаблон:Ref-lang
分类:英国个博物馆	Категория:Музеи Великобритании
模板:大韩民国行政区划	Шаблон:Административное деление Республики Корея
Wikipedia:Selected anniversaries/October 3	Шаблон:События дня:10-3
分类:总统	Категория:Президенты государств
模板:User ru	Шаблон:User ru
分类:20世紀	Категория:XX век
模板:IPA	Шаблон:IPA1
分类:美洲	Категория:Америка
模板:Otheruses	Шаблон:Другие значения
模板:Rellink	Шаблон:Rellink
模板:Did you know	Шаблон:Знаете ли вы
模板:MONTHNAME	Шаблон:MONTHNAME
模板:CPV	Шаблон:CPV
模板:Death date and age	Шаблон:Умер
模板:Infobox Model	Шаблон:Фотомодель
模板:MONTHNUMBER	Шаблон:MONTHNUMBER
模板:(	Шаблон:(
分类:人物小作品	Категория:Незавершённые статьи о людях
模板:Top icon	Шаблон:Right-uppermost image
模板:Namespace detect	Шаблон:Namespace detect
模板:)	Шаблон:)
模板:Fmbox	Шаблон:Fmbox
分类:作家	Категория:Писатели
分类:軍事	Категория:Вооружённые силы
分类:大学	Категория:Университеты
模板:Hidden begin	Шаблон:Начало скрытого блока
模板:Talkback	Шаблон:Ответ
模板:MYS	Шаблон:MYS
模板:TJK	Шаблон:TJK
模板:Infobox Website	Шаблон:Карточка сайта
模板:Image label end	Шаблон:Image label end
模板:Documentation subpage	Шаблон:Docpage
模板:Winners	Шаблон:Победитель
模板:Ref label	Шаблон:Ref label
模板:GHA	Шаблон:GHA
模板:GMB	Шаблон:GMB
模板:Uncategorized	Шаблон:Нет категорий
模板:IDN	Шаблон:IDN
模板:FRO	Шаблон:FRO
模板:ZAF	Шаблон:ZAF
模板:POL	Шаблон:POL
模板:URY	Шаблон:URY
模板:CUB	Шаблон:CUB
模板:CMR	Шаблон:CMR
模板:BIH	Шаблон:BIH
模板:FIN	Шаблон:FIN
模板:CAN	Шаблон:CAN
模板:Purge	Шаблон:Очистить кэш
模板:Cc-by-3.0	Шаблон:CC-BY-3.0
模板:DNK	Шаблон:DNK
模板:Empty category	Шаблон:Не удаляйте категорию
模板:Infobox Cyrillic	Шаблон:Кириллица
模板:Dead link	Шаблон:Недоступная ссылка
分类:跨性别	Категория:Трансгендерность
模板:Provinces of China	Шаблон:Провинции КНР
模板:SAU	Шаблон:SAU
模板:Userpage	Шаблон:Userpage
模板:DEU	Шаблон:DEU
模板:BEN	Шаблон:BEN
模板:CIS	Шаблон:СНГ
模板:SWE	Шаблон:SWE
模板:Note label	Шаблон:Note
模板:Food-stub	Шаблон:Food-stub
分类:中国个建筑	Категория:Архитектура Китая
模板:User	Шаблон:User
模板:YEM	Шаблон:YEM
模板:Spoken Wikipedia	Шаблон:Слушать статью
模板:Lorem ipsum	Шаблон:Lorem ipsum
分类:中学	Категория:Лицеи
模板:YearTOC	Шаблон:Навигация для года
分类:越南机场	Категория:Аэропорты Вьетнама
分类:公司	Категория:Компании
模板:Footballbox	Шаблон:Отчёт о матче
模板:Renameuser	Шаблон:Renameuser
模板:Image label small	Шаблон:Image label small
模板:Iaaf name	Шаблон:IAAF
模板:AddNewSection	Шаблон:AddNewSection
模板:Japanese	Шаблон:Нихонго
模板:User fr-3	Шаблон:User fr-3
模板:UEFA	Шаблон:Чемпионаты Европы по футболу
模板:Infobox Military Unit	Шаблон:Воинское формирование
模板:美国地图含州名	Шаблон:Карта США с метками
模板:IMDb name	Шаблон:Imdb name
模板:Ar icon	Шаблон:Ref-ar
模板:ABW	Шаблон:ABW
分类:突尼斯	Категория:Тунис
模板:Th	Шаблон:Ref-th
模板:S-title	Шаблон:S-ttl
分类:泰国个寺庙	Категория:Буддийские храмы Таиланда
模板:JPN	Шаблон:JPN
分类:韩国电视	Категория:Телевидение в Южной Корее
模板:Japan	Шаблон:Регионы и административное деление Японии
模板:China-stub	Шаблон:China-stub
模板:Cmbox	Шаблон:Cmbox
模板:CSS IPA vowel chart	Шаблон:Схема гласных МФА
模板:PAN	Шаблон:PAN
模板:SOM	Шаблон:SOM
模板:SWZ	Шаблон:SWZ
模板:Infobox Spacecraft	Шаблон:Космический аппарат
模板:PAK	Шаблон:PAK
模板:User nds-1	Шаблон:User nds-1
模板:S-before	Шаблон:S-bef
分类:日本行政区划	Категория:Административное деление Японии
模板:ISL	Шаблон:ICE
模板:Oppose	Шаблон:Против
模板:COL	Шаблон:COL
模板:CCK	Шаблон:CCK
模板:ERI	Шаблон:ERI
模板:GAB	Шаблон:GAB
模板:IRN	Шаблон:IRN
模板:MLI	Шаблон:MLI
模板:JOR	Шаблон:JOR
模板:NPL	Шаблон:NPL
模板:NAM	Шаблон:NAM
模板:CAF	Шаблон:CAF
模板:MKD	Шаблон:MKD
模板:Exchange rate	Шаблон:Обменный курс
模板:LKA	Шаблон:LKA
模板:MWI	Шаблон:MWI
模板:KAZ	Шаблон:KAZ
模板:OMN	Шаблон:OMN
模板:PER	Шаблон:PER
模板:MOZ	Шаблон:MOZ
模板:SUR	Шаблон:SUR
模板:TRI	Шаблон:TTO
模板:GUY	Шаблон:GUY
模板:ETH	Шаблон:ETH
模板:HKG	Шаблон:HKG
模板:NGA	Шаблон:NGA
模板:PRK	Шаблон:PRK
模板:NIC	Шаблон:NIC
模板:LBR	Шаблон:LBR
模板:TKM	Шаблон:TKM
模板:THA	Шаблон:THA
模板:BFA	Шаблон:BFA
模板:TCD	Шаблон:TCD
模板:PRY	Шаблон:PRY
模板:ECU	Шаблон:ECU
模板:BTN	Шаблон:BTN
模板:MDV	Шаблон:MDV
模板:SLE	Шаблон:SLE
模板:LTU	Шаблон:LTU
模板:SGP	Шаблон:SGP
模板:IND	Шаблон:IND
模板:MAC	Шаблон:MAC
模板:User ar-2	Шаблон:User ar-2
模板:User fr-0	Шаблон:User fr-0
分类:User ja-N	Категория:User ja-N
分类:用戶名字空間模板	Категория:Википедия:Шаблоны:Участники
模板:CHE	Шаблон:CHE
分类:社会阶层	Категория:Социальные классы
分类:印度电影	Категория:Кинематограф Индии
模板:URL	Шаблон:URL
模板:Hidden end	Шаблон:Конец скрытого блока
模板:Disambiguation	Шаблон:Неоднозначность
分类:公共交通	Категория:Общественный транспорт
分类:中东	Категория:Средний Восток
分类:报纸	Категория:Газеты
分类:运动场	Категория:Стадионы
模板:Para	Шаблон:Para
模板:Fb	Шаблон:Футбол
模板:LAO	Шаблон:LAO
模板:ARE	Шаблон:ARE
模板:GRC	Шаблон:GRC
模板:PRT	Шаблон:PRT
模板:BGD	Шаблон:BGD
模板:BAR	Шаблон:BRB
模板:User ksh	Шаблон:User ksh
模板:AUS	Шаблон:AUS
模板:User zh-yue-1	Шаблон:User zh-yue-1
模板:CZE	Шаблон:CZE
模板:AZE	Шаблон:AZE
模板:Infobox Film	Шаблон:Фильм
模板:英文名	Шаблон:Lang-en
分类:甜品	Категория:Десерты
分类:新加坡个机场	Категория:Аэропорты Сингапура
模板:Expand language	Шаблон:Перевести
模板:WAD	Шаблон:WAD
分类:內部鏈接模板	Категория:Шаблоны:Внутренние ссылки
模板:KHM	Шаблон:KHM
模板:NLD	Шаблон:NED
模板:KWT	Шаблон:KWT
模板:Resize	Шаблон:Resize
模板:辅音	Шаблон:Согласные
模板:VNM	Шаблон:VNM
模板:LIE	Шаблон:LIE
模板:SEN	Шаблон:SEN
模板:NZL	Шаблон:NZL
分类:广州	Категория:Гуанчжоу
模板:MMR	Шаблон:MMR
模板:KOR	Шаблон:KOR
分类:各类电影	Категория:Фильмы по жанрам
模板:!(	Шаблон:Х
分类:中国外交官	Категория:Дипломаты Китая
模板:NATO	Шаблон:НАТО
分类:生物	Категория:Организмы
模板:De icon	Шаблон:Ref-de
模板:SVN	Шаблон:SLO
模板:LBN	Шаблон:LBN
模板:GUF	Шаблон:GUF
模板:GGY	Шаблон:GGY
模板:FRA	Шаблон:FRA
模板:Hang on	Шаблон:Hangon
模板:Infobox Biography	Шаблон:Персона
分类:蒙古	Категория:Монголия
模板:InterWiki	Шаблон:Языковой раздел
模板:Main Page interwikis	Шаблон:Интервики на заглавной
分类:泰国个大学	Категория:Университеты Таиланда
分类:澳大利亚个报纸	Категория:Газеты Австралии
分类:历年个电影	Категория:Фильмы по годам
分类:爱尔兰城市	Категория:Города Ирландии
分类:美国黑人	Категория:Афроамериканцы
模板:Chem-stub	Шаблон:Chem-stub
模板:Thailand-stub	Шаблон:Thailand-stub
模板:Britain-stub	Шаблон:UK-stub
分类:1992年个歌曲	Категория:Песни 1992 года
分类:姊妹计划链接模板	Категория:Шаблоны:Ссылки на проекты Викимедиа
模板:User la-1	Шаблон:User la-1
模板:APEC	Шаблон:АТЭС
模板:歐洲行政區劃	Шаблон:Страны Европы
分类:模板說明文檔	Категория:Шаблоны:Документация
分类:泰语	Категория:Тайский язык
分类:User zh-yue	Категория:User zh-yue
分类:User wuu	Категория:User wuu
分类:User sk	Категория:User sk
分类:User fr	Категория:User fr
分类:User ja	Категория:User ja
分类:User la	Категория:User la
分类:User fr-3	Категория:User fr-3
分类:User fr-2	Категория:User fr-2
分类:User ja-2	Категория:User ja-2
分类:User la-2	Категория:User la-2
分类:User wuu-N	Категория:User wuu-N
分类:User ko-N	Категория:User ko-N
分类:User fr-N	Категория:User fr-N
分类:User nl-N	Категория:User nl-N
分类:User ru-N	Категория:User ru-N
分类:泰国拳击运动员	Категория:Боксёры Таиланда
分类:政治经济学	Категория:Политическая экономия
分类:曼谷	Категория:Районы Бангкока
模板:User zh-yue	Шаблон:User zh-yue
分类:文字	Категория:Письменность
分类:中国省级行政区	Категория:Провинции КНР
分类:岛	Категория:Острова
分类:广平省	Категория:Куангбинь
分类:User sk-N	Категория:User sk-N
分类:User de	Категория:User de
分类:User de-2	Категория:User de-2
分类:User de-3	Категория:User de-3
分类:User de-4	Категория:User de-4
分类:User de-N	Категория:User de-N
分类:User en-3	Категория:User en-3
分类:User en-N	Категория:User en-N
分类:User es	Категория:User es
分类:User es-1	Категория:User es-1
分类:User es-2	Категория:User es-2
分类:User es-N	Категория:User es-N
分类:首尔	Категория:Сеул
分类:日本模板	Категория:Шаблоны:Япония
模板:User la-3	Шаблон:User la-3
分类:阿德来得	Категория:Аделаида
分类:法国个公园	Категория:Парки Франции
分类:各国个公园	Категория:Сады и парки по странам
分类:各国个政治	Категория:Политика по странам
模板:Multiple image	Шаблон:Кратное изображение
模板:Colorsample	Шаблон:Colorsample
分类:User it	Категория:User it
分类:User it-1	Категория:User it-1
分类:User ja-1	Категория:User ja-1
分类:User ko	Категория:User ko
分类:美国州	Категория:Штаты США
分类:User ksh	Категория:User ksh
分类:User ksh-N	Категория:User ksh-N
分类:User la-1	Категория:User la-1
分类:User la-3	Категория:User la-3
分类:澳大利亚地理	Категория:География Австралии
感谢倷	Thank You (значения)
分类:维基百科讨论	Категория:Википедия:Форум
分类:火山	Категория:Вулканы
模板:NOR	Шаблон:NOR
模板:He icon	Шаблон:Ref-he
分类:天灾	Категория:Опасные природные явления
分类:天气	Категория:Погода
模板:Information	Шаблон:Изображение
分类:日本个县	Категория:Префектуры Японии
分类:法国城市	Категория:Города Франции
模板:BRA	Шаблон:BRA
分类:澳大利亚女演员	Категория:Актрисы Австралии
分类:User ru-1	Категория:User ru-1
Wikipedia:巴别	Википедия:Вавилон
分类:残疾人	Категория:Инвалиды
分类:北京人	Категория:Персоналии:Пекин
分类:化学小作品	Категория:Незавершённые статьи по химии
分类:各国个军事	Категория:Вооружённые силы по странам
模板:TUN	Шаблон:TUN
分类:日本地方	Категория:Регионы Японии
分类:海	Категория:Моря
分类:泰国模板	Категория:Шаблоны:Таиланд
分类:工具书	Категория:Справочная литература
分类:计算机科学	Категория:Информатика
分类:User nds	Категория:User nds
分类:User nds-1	Категория:User nds-1
模板:LUX	Шаблон:LUX
分类:神奈川县	Категория:Префектура Канагава
分类:福岛县	Категория:Префектура Фукусима
分类:广东省	Категория:Гуандун
分类:安徽	Категория:Аньхой
分类:江西省	Категория:Цзянси
分类:江苏省	Категория:Цзянсу
模板:Title without disambig	Шаблон:Без уточнения
分类:行政区划	Категория:Административные единицы
分类:饮料	Категория:Напитки
分类:1980年代出生	Категория:Родившиеся в 1980-е годы
分类:社会科学	Категория:Общественные науки
分类:办拉路斯	Категория:Белоруссия
分类:中国电影	Категория:Кинематограф Китая
分类:澳大利亚教育	Категория:Образование в Австралии
分类:非洲国家	Категория:Страны Африки
分类:各国教育	Категория:Образование по странам
模板:)!	Шаблон:Ъ
Wikipedia:AutoWikiBrowser/Typos	Википедия:AutoWikiBrowser/Typos
模板:User ru-2	Шаблон:User ru-2
分类:科幻片	Категория:Научно-фантастические фильмы
模板:Column-width	Шаблон:Column-width
分类:User ru	Категория:User ru
分类:User ru-2	Категория:User ru-2
分类:User ru-4	Категория:User ru-4
分类:User zh-yue-1	Категория:User zh-yue-1
分类:User zh-yue-N	Категория:User zh-yue-N
模板:En icon	Шаблон:Ref-en
分类:浙江省	Категория:Чжэцзян
分类:金球奖获得者	Категория:Лауреаты премии «Золотой глобус»
模板:!((	Шаблон:!((
模板:))!	Шаблон:))!
分类:港铁车站	Категория:Станции Гонконгского метрополитена
模板:Lang	Шаблон:Lang
分类:泰国电影	Категория:Фильмы Таиланда
香港街道名录	Список улиц Гонконга
分类:社会学	Категория:Социология
模板:IRL	Шаблон:IRL
分类:美国女演员	Категория:Актрисы США
分类:1981年出生	Категория:Родившиеся в 1981 году
分类:1986年出生	Категория:Родившиеся в 1986 году
模板:ALB	Шаблон:ALB
模板:AND	Шаблон:AND
模板:ARG	Шаблон:ARG
模板:ARM	Шаблон:ARM
模板:Africa-stub	Шаблон:Africa-stub
模板:CopyrightByWikimedia	Шаблон:CopyrightByWikimedia
分类:美国慈善家	Категория:Меценаты США
分类:各国个电影	Категория:Кинематограф по странам
Wikipedia:Template sandbox and test cases	Википедия:Правка и тестирование шаблонов в песочнице
分类:人类	Категория:Человек
分类:分類名字空間模板	Категория:Шаблоны:Для категорий
模板:Australia-stub	Шаблон:Australia-stub
模板:Car-stub	Шаблон:Auto-stub
模板:BDI	Шаблон:BDI
模板:BAH	Шаблон:BHS
模板:BLR	Шаблон:BLR
模板:When on basepage	Шаблон:Basepage subpage
模板:Bhutan stub	Шаблон:Bhutan-stub
模板:CIV	Шаблон:CIV
模板:CRI	Шаблон:CRI
模板:CHY	Шаблон:CYP
分类:泰国交通	Категория:Транспорт в Таиланде
模板:Fr	Шаблон:Ref-fr
分类:文章	Категория:Статьи
模板:Ko icon	Шаблон:Ref-ko
分类:法国铁路	Категория:Железнодорожный транспорт Франции
分类:1951年个电影	Категория:Фильмы 1951 года
模板:物理学粒子	Шаблон:Частицы
分类:女演员	Категория:Актрисы
分类:佛罗里达州	Категория:Флорида
模板:EST	Шаблон:EST
分类:泰国政党	Категория:Политические партии Таиланда
Wikipedia:Lua	Википедия:Модули
分类:大規模殺傷性武器	Категория:Оружие массового поражения
模板:QAT	Шаблон:QAT
模板:RUS	Шаблон:RUS
模板:AUT	Шаблон:AUT
模板:History-stub	Шаблон:Hist-stub
分类:2009年恐怖事件	Категория:Террористические акты 2009 года
分类:2005年个歌曲	Категория:Песни 2005 года
分类:动作片	Категория:Фильмы-боевики
模板:CHL	Шаблон:CHL
分类:英语电影	Категория:Фильмы на английском языке
模板:Round8	Шаблон:Турнир8
模板:海峡群岛	Шаблон:Нормандские острова
模板:SYR	Шаблон:SYR
模板:CHN	Шаблон:CHN
模板:Switzerland-stub	Шаблон:Switzerland-stub
模板:Side box	Шаблон:Side box
分类:世界人口	Категория:Население по странам
分类:所有页面需要清理	Категория:Википедия:Статьи к переработке
模板:IRQ	Шаблон:IRQ
模板:字左	Шаблон:Chset-left
模板:Citation/core	Шаблон:Citation/core
分类:法国交通	Категория:Транспорт во Франции
分类:澳大利亚个湖	Категория:Озёра Австралии
分类:各国经济	Категория:Экономика по странам
分类:各国个报纸	Категория:Газеты по странам
分类:各国个银行	Категория:Банки по странам
分类:各国个地震	Категория:Землетрясения по странам
分类:韩国政治	Категория:Политика Южной Кореи
分类:澳大利亚个政治	Категория:Политика Австралии
分类:泰国政治	Категория:Политика Таиланда
分类:越南经济	Категория:Экономика Вьетнама
分类:柬埔寨经济	Категория:Экономика Камбоджи
分类:朝鲜民主主义人民共和国政治	Категория:Политика КНДР
分类:泰国经济	Категория:Экономика Таиланда
分类:澳大利亚体育运动	Категория:Спорт в Австралии
分类:泰国体育	Категория:Спорт в Таиланде
分类:澳大利亚足球	Категория:Футбол в Австралии
分类:河	Категория:Реки
模板:User ko	Шаблон:User ko
模板:User la-2	Шаблон:User la-2
模板:User ru-1	Шаблон:User ru-1
模板:User zh-1	Шаблон:User zh-1
模板:User zh-2	Шаблон:User zh-2
模板:User zh-3	Шаблон:User zh-3
模板:User zh-4	Шаблон:User zh-4
分类:韩国交通	Категория:Транспорт в Южной Корее
分类:中国交通	Категория:Транспорт в Китае
分类:世界各国个博物馆	Категория:Музеи по странам
分类:马来西亚经济	Категория:Экономика Малайзии
分类:泰国军事	Категория:Вооружённые силы Таиланда
分类:菲律宾模板	Категория:Шаблоны:Филиппины
模板:Multi-listen end	Шаблон:Multi-listen end
分类:澳大利亚个交通	Категория:Транспорт в Австралии
分类:蘇聯政治家	Категория:Политики СССР
分类:日本教育	Категория:Образование в Японии
分类:韩国人	Категория:Персоналии:Южная Корея
分类:台湾人	Категория:Персоналии:Тайвань
分类:菲律宾	Категория:Филиппины
分类:马来西亚歌手	Категория:Певцы и певицы Малайзии
分类:User nl	Категория:User nl
分类:User zh-1	Категория:User zh-1
分类:User zh-4	Категория:User zh-4
分类:User zh-3	Категория:User zh-3
分类:User zh-2	Категория:User zh-2
分类:泰国国王	Категория:Короли Таиланда
分类:力学	Категория:Механика
分类:不丹	Категория:Бутан
分类:澳大利亚跳水运动员	Категория:Прыгуны в воду Австралии
分类:印度模特	Категория:Фотомодели Индии
分类:印度科学技术	Категория:Наука в Индии
分类:泰国旅游	Категория:Туризм в Таиланде
分类:中国演员	Категория:Актёры Китая
分类:泰国演员	Категория:Актёры Таиланда
分类:澳大利亚游泳运动员	Категория:Пловцы Австралии
分类:电视	Категория:Телевидение
分类:中国诗人	Категория:Поэты Китая
分类:凯撒奖获得者	Категория:Лауреаты премии «Сезар»
分类:世紀	Категория:Века
分类:蘇聯外敎官	Категория:Дипломаты СССР
分类:印度演员	Категория:Актёры Индии
分类:中国田径运动员	Категория:Легкоатлеты Китая
分类:澳大利亚脚踏车运动员	Категория:Велогонщики Австралии
分类:泰国运动员	Категория:Спортсмены Таиланда
分类:中国运动员	Категория:Спортсмены Китая
分类:泰国府	Категория:Провинции Таиланда
分类:海滩	Категория:Пляжи
分类:柬埔寨人	Категория:Персоналии:Камбоджа
分类:泰国政治人物	Категория:Политики Таиланда
分类:香港人	Категория:Персоналии:Гонконг
分类:泰国人	Категория:Персоналии:Таиланд
粤语	Юэ (язык)
分类:东海	Категория:Восточно-Китайское море
分类:泰国个湖泊	Категория:Озёра Таиланда
分类:意大利个湖	Категория:Озёра Италии
分类:光学仪器	Категория:Оптические приборы
分类:机场	Категория:Аэропорты
分类:泰国机场	Категория:Аэропорты Таиланда
分类:日本个机场	Категория:Аэропорты Японии
分类:泰国个银行	Категория:Банки Таиланда
分类:化学元素	Категория:Химические элементы
分类:澳大利亚运动员	Категория:Спортсмены Австралии
分类:香港演员	Категория:Актёры Гонконга
分类:环球小姐	Категория:Мисс Вселенная
分类:不丹总理	Категория:Премьер-министры Бутана
分类:澳大利亚总理	Категория:Премьер-министры Австралии
分类:泰国总理	Категория:Премьер-министры Таиланда
分类:地理小作品	Категория:Незавершённые статьи по географии
分类:饮食小作品	Категория:Незавершённые статьи о еде и напитках
分类:朝鲜	Категория:Корейская Народно-Демократическая Республика
分类:柬埔寨	Категория:Камбоджа
分类:澳大利亚人	Категория:Персоналии:Австралия
分类:中国人	Категория:Персоналии:Китай
分类:台湾歌手	Категория:Певцы и певицы Тайваня
分类:韩国演员	Категория:Актёры Южной Кореи
分类:蘇聯作家	Категория:Писатели СССР
分类:中国历史	Категория:История Китая
分类:不丹国王	Категория:Короли Бутана
分类:老挝	Категория:Лаос
分类:缅甸	Категория:Мьянма
分类:台湾	Категория:Тайвань
分类:法国演员	Категория:Актёры Франции
分类:電影模板	Категория:Шаблоны:Кинематограф
分类:爱尔兰模板	Категория:Шаблоны:Ирландия
分类:伊朗模板	Категория:Шаблоны:Иран
分类:英国模板	Категория:Шаблоны:Великобритания
分类:美国模板	Категория:Шаблоны:США
分类:中国古代朝代	Категория:Китайские династии
分类:多語言支援模板	Категория:Шаблоны языков
分类:新加坡模板	Категория:Шаблоны:Сингапур
分类:法国模板	Категория:Шаблоны:Франция
分类:越南模板	Категория:Шаблоны:Вьетнам
分类:加拿大模板	Категория:Шаблоны:Канада
分类:马来西亚模板	Категория:Шаблоны:Малайзия
分类:精密模板	Категория:Шаблоны:Эзотерические
分类:模板名字空間模板	Категория:Шаблоны:Для шаблонов
分类:泰国个公司	Категория:Компании Таиланда
分类:马来西亚公司	Категория:Компании Малайзии
分类:安徽人	Категория:Родившиеся в Аньхое
分类:江苏人	Категория:Родившиеся в Цзянсу
分类:浙江人	Категория:Персоналии:Чжэцзян
分类:上海人	Категория:Персоналии:Шанхай
分类:出生	Категория:Персоналии по годам рождения
分类:法国总统	Категория:Президенты Франции
分类:亚洲历史	Категория:История Азии
分类:约旦	Категория:Иордания
分类:大洋洲国家	Категория:Страны Океании
分类:鱼类	Категория:Рыбы
分类:北京	Категория:Пекин
分类:国家足球队	Категория:Футбольные сборные
分类:泰国灾难	Категория:Катастрофы в Таиланде
分类:日本关东地方	Категория:Регион Канто
分类:柬埔寨电影	Категория:Фильмы Камбоджи
分类:剧情片	Категория:Фильмы-драмы
分类:1971年个电影	Категория:Фильмы 1971 года
分类:2003年个电影	Категория:Фильмы 2003 года
分类:1994年个电影	Категория:Фильмы 1994 года
分类:2004年个电影	Категория:Фильмы 2004 года
分类:2005年个电影	Категория:Фильмы 2005 года
分类:2007年个电影	Категория:Фильмы 2007 года
分类:2008年个电影	Категория:Фильмы 2008 года
分类:香港电影	Категория:Кинематограф Гонконга
分类:法国电影	Категория:Кинематограф Франции
分类:公用领域媒体	Категория:Файлы:Общественное достояние
分类:印地语	Категория:Хинди
分类:阿拉伯语	Категория:Арабский язык
分类:印度言话	Категория:Языки Индии
分类:人类学	Категория:Антропология
分类:世界小姐	Категория:Мисс Мира
分类:抗生素	Категория:Антибиотики
分类:五代十国	Категория:Пять династий и десять царств
分类:操作系统	Категория:Операционные системы
分类:昆士兰州	Категория:Квинсленд
分类:泰国政府	Категория:Государственное устройство Таиланда
分类:维克多利亚州	Категория:Виктория
分类:电影奖	Категория:Кинопремии
分类:奥斯卡金像奖	Категория:Кинопремия «Оскар»
分类:金球奖	Категория:Кинопремия «Золотой глобус»
分类:清朝	Категория:Династия Цин
分类:宋朝	Категория:Династия Сун
分类:明朝	Категория:Династия Мин
分类:汉朝	Категория:Династия Хань
分类:里昂	Категория:Лион
模板:Incubator	Шаблон:Инкубатор
分类:中国文化	Категория:Культура Китая
分类:法国文化	Категория:Культура Франции
分类:越南文化	Категория:Культура Вьетнама
分类:韩国文化	Категория:Культура Южной Кореи
分类:网络语言	Категория:Сетевой жаргон
模板:ESP	Шаблон:ESP
分类:动物	Категория:Животные
分类:泰国航空公司	Категория:Авиакомпании Таиланда
分类:製造品	Категория:Промышленные товары
分类:歌唱比赛	Категория:Конкурсы вокалистов
分类:国际象棋	Категория:Шахматы
分类:武器	Категория:Оружие
分类:核武器	Категория:Ядерное оружие
瀑瑶兰	Божоле (регион)
分类:英国女演员	Категория:Актрисы Великобритании
分类:物理量	Категория:Физические величины
分类:温标	Категория:Единицы измерения температуры
分类:汉字	Категория:Китайская письменность
分类:小吃	Категория:Снэк
分类:热力学	Категория:Термодинамика
分类:气象学	Категория:Метеорология
分类:泰国个公园	Категория:Парки Таиланда
分类:航空事故	Категория:Авиационные происшествия
分类:香港	Категория:Гонконг
分类:菲律宾群岛	Категория:Острова Филиппин
分类:大西洋岛屿	Категория:Острова Атлантического океана
分类:上海	Категория:Шанхай
分类:节日	Категория:Фестивали
分类:印度城市	Категория:Города Индии
分类:俄罗斯城市	Категория:Города России
分类:Web 2.0	Категория:Веб 2.0
分类:事体	Категория:События
分类:西亚	Категория:Западная Азия
分类:電信	Категория:Телекоммуникации
分类:流感病毒	Категория:Грипп
分类:交通	Категория:Транспорт
分类:选美	Категория:Конкурсы красоты
分类:性行为	Категория:Сексуальные практики
分类:电视剧	Категория:Телесериалы
分类:北美洲	Категория:Северная Америка
分类:歌手	Категория:Певцы и певицы
分类:亚洲个湖泊	Категория:Озёра Азии
分类:欧洲个湖泊	Категория:Озёра Европы
分类:湖泊	Категория:Озёра
分类:大韩民国机场	Категория:Аэропорты Южной Кореи
分类:围棋棋手	Категория:Игроки го
模板:Infobox Language	Шаблон:Язык
分类:大洋洲	Категория:Океания
分类:中国城市	Категория:Города Китая
分类:瀑布	Категория:Водопады
分类:芭堤雅	Категория:Паттайя
分类:自然灾害	Категория:Стихийные бедствия
分类:日本九州	Категория:Регион Кюсю
分类:1998年个电影	Категория:Фильмы 1998 года
分类:2006年个电影	Категория:Фильмы 2006 года
分类:恐怖片	Категория:Фильмы ужасов
分类:美国电影	Категория:Кинематограф США
分类:汉语	Категория:Китайский язык
分类:泰国言话	Категория:Языки Таиланда
分类:新南威尔士州	Категория:Новый Южный Уэльс
分类:澳大利亚文化	Категория:Культура Австралии
分类:泰国文化	Категория:Культура Таиланда
分类:越南城市	Категория:Города Вьетнама
分类:澳大利亚城市	Категория:Города Австралии
分类:泰国城市	Категория:Города Таиланда
分类:泰国个岛	Категория:Острова Таиланда
分类:印度文化	Категория:Культура Индии
分类:印度尼西亚个岛	Категория:Острова Индонезии
分类:澳大利亚旅游	Категория:Туризм в Австралии
模块:URL	Модуль:URL
分类:中国个公园	Категория:Парки Китая
分类:银行	Категория:Банки
分类:霍巴特	Категория:Хобарт
Wikipedia:模板文檔	Википедия:Документация шаблонов
分类:中华人民共和国	Категория:Китайская Народная Республика
分类:維基百科文化	Категория:Википедия:Культура Википедии
分类:版权模板	Категория:Шаблоны:Авторские права
分类:维基百科媒体文件版权	Категория:Файлы:Классификация по лицензиям
分类:南欧	Категория:Южная Европа
分类:維基百科名字空間模板	Категория:Википедия:Шаблоны по пространству имён
分类:澳大利亚运动场	Категория:Спортивные сооружения Австралии
模板:FULLROOTPAGENAME	Шаблон:FULLROOTPAGENAME
分类:学堂	Категория:Школы
分类:澳大利亚风光	Категория:Достопримечательности Австралии
分类:越南航空	Категория:Авиакомпании Вьетнама
分类:中国地铁	Категория:Метрополитены Китая
模板:Geo stub	Шаблон:Geo-stub
模板:UGA	Шаблон:UGA
模板:UZB	Шаблон:UZB
模板:Comment	Шаблон:Комментарий
分类:香港交通	Категория:Транспорт в Гонконге
模板:Module other	Шаблон:Module other
Portal:数学	Портал:Математика
分类:纪元	Категория:Календарные эры
模板:Greece-stub	Шаблон:Greece-stub
分类:新南威尔士州个地方	Категория:Населённые пункты Нового Южного Уэльса
分类:朝鲜国家元首	Категория:Правители КНДР
分类:亚洲国家	Категория:Страны Азии
模板:Japan stub	Шаблон:Japan-stub
模板:Mexico-stub	Шаблон:Mexico-stub
模板:SSU	Шаблон:Однополый брак
分类:維基百科幽默	Категория:Википедия:Юмор
模板:RWA	Шаблон:RWA
模板:MLT	Шаблон:MLT
模板:KEN	Шаблон:KEN
模板:JAM	Шаблон:JAM
分类:南美洲国家模板	Категория:Шаблоны:Южная Америка
模板:CXR	Шаблон:CXR
分类:1976年个地震	Категория:Землетрясения 1976 года
模板:Sister project	Шаблон:Sister
分类:事故	Категория:Происшествия
分类:香港机场	Категория:Аэропорты Гонконга
模板:No redirect	Шаблон:No redirect
分类:澳大利亚模板	Категория:Шаблоны:Австралия
分类:宝莱坞	Категория:Болливуд
分类:大桥	Категория:Мосты
分类:布里司班	Категория:Брисбен
分类:戏曲	Категория:Китайская опера
分类:江苏城市	Категория:Города провинции Цзянсу
分类:地震	Категория:Землетрясения
分类:中国地震	Категория:Землетрясения в Китае
分类:环境	Категория:Охрана окружающей среды
分类:凯撒奖	Категория:Сезар (кинопремия)
分类:泰国个节日	Категория:Фестивали Таиланда
分类:维基媒体基金会版权	Категория:Файлы:Собственность фонда Викимедиа
模板:IAST	Шаблон:IAST
分类:中国水灾	Категория:Наводнения в Китае
分类:手册	Категория:Справочники
分类:杭州	Категория:Ханчжоу
分类:印度个寺庙	Категория:Индуистские храмы Индии
分类:香港文化	Категория:Культура Гонконга
分类:新竹市	Категория:Синьчжу
分类:印度小作品	Категория:Незавершённые статьи об Индии
分类:印度个电影奖	Категория:Кинопремии Индии
分类:爱尔兰	Категория:Ирландия
模板:India-stub	Шаблон:India-stub
分类:苏州	Категория:Сучжоу
分类:中华民国	Категория:Китайская Республика
模板:Listen	Шаблон:Listen
分类:谜语	Категория:Загадки
分类:性学	Категория:Сексология
模板:MNG	Шаблон:MNG
分类:相态	Категория:Агрегатные состояния
分类:南澳大利亚州	Категория:Южная Австралия
模板:BEL	Шаблон:BEL
分类:韩国模板	Категория:Шаблоны:Южная Корея
分类:东南亚国家联盟	Категория:АСЕАН
分类:墨尔本	Категория:Мельбурн
分类:方向	Категория:Ориентация
分类:電話號碼	Категория:Телефонные планы нумерации
分类:電話	Категория:Телефония
分类:温度	Категория:Температура
分类:印度个恐怖事体	Категория:Террористические акты, совершённые в Индии
分类:上海交通	Категория:Транспорт Шанхая
斋月	Рамадан (месяц)
分类:台风	Категория:Тайфуны
分类:悉尼	Категория:Сидней
分类:朝鲜模板	Категория:Шаблоны:КНДР
分类:热带气旋	Категория:Тропические циклоны
分类:澳大利亚个公园	Категория:Сады и парки Австралии
分类:应用科学	Категория:Прикладные науки
分类:字典	Категория:Словари китайского языка
分类:法国个报纸	Категория:Газеты Франции
模板:Image label begin	Шаблон:Image label begin
分类:澳大利亚大学	Категория:Университеты Австралии
分类:中国个银行	Категория:Банки Китая
分类:中国个报纸	Категория:Газеты Китая
分类:高分子化学	Категория:Химия полимеров
分类:日本大学	Категория:Университеты Японии
分类:宁波	Категория:Нинбо
分类:浙江城市	Категория:Города провинции Чжэцзян
分类:巴黎高速铁路	Категория:RER
分类:天津	Категория:Тяньцзинь
分类:巴黎交通	Категория:Транспорт Парижа
分类:非洲国家模板	Категория:Шаблоны:Африка
模板:HUN	Шаблон:HUN
模板:Ns has subpages	Шаблон:Ns имеет подстраницы
分类:生活	Категория:Личная жизнь
Wikipedia:生成机器人	Википедия:Рекомендации юному ботоводу
模板:Aero-stub	Шаблон:Aero-stub
分类:女性	Категория:Женщина
分类:柬埔寨文化	Категория:Культура Камбоджи
分类:各年个地震	Категория:Землетрясения по годам
分类:User en-1	Категория:User en-1
分类:PD-self	Категория:Файлы:Переданные в общественное достояние участниками
分类:User de-1	Категория:User de-1
分类:法国省份	Категория:Департаменты Франции
分类:工具	Категория:Инструменты
分类:德国城市	Категория:Города Германии
分类:美国演员	Категория:Актёры США
模板:France-stub	Шаблон:France-stub
分类:瑞典贵族	Категория:Дворянство Швеции
分类:古巴拳击运动员	Категория:Боксёры Кубы
模板:Lua	Шаблон:OnLua
模板:勿是吳語	Шаблон:Закончить перевод
Wikipedia:弗要犯常见个错误	Википедия:Избегайте распространённых ошибок
Wikipedia:How to read a taxobox	Википедия:Как читать карточку организма
Wikipedia:Media help	Википедия:Помощь с медиафайлами
模板:Italy-stub	Шаблон:Italy-stub
模板:OIC	Шаблон:ОИК
模板:Testcases notice	Шаблон:Тесты шаблона
模板:Start date	Шаблон:Start date
琉球群岛	Рюкю
模板:Bio-stub	Шаблон:Bio-stub
模板:User wuu	Шаблон:User wuu
模板:Indonesia stub	Шаблон:Indonesia-stub
模板:Wayback	Шаблон:Wayback
模板:Ireland stub	Шаблон:Ireland-stub
模板:Philippines-stub	Шаблон:Philippines-stub
模板:海南省行政区划	Шаблон:Хайнань
Wikipedia:VisualEditor	Википедия:Визуальный редактор
Wikipedia:AutoWikiBrowser/CheckPage	Википедия:AutoWikiBrowser/CheckPage
模板:Contains special characters	Шаблон:Спецсимволы
Wikipedia:Spoken articles	Википедия:Список аудиостатей
Wikipedia:CC-BY-SA-3.0协议文本	Википедия:Текст лицензии Creative Commons Attribution-ShareAlike 3.0 Unported
模板:Nobots	Шаблон:Nobots
模板:Thailand geo stub	Шаблон:Thailand-geo-stub
曼谷枪手 2	Опасный Бангкок (фильм, 2008)
模板:里昂大区城区	Шаблон:Большой Лион
模板:Vietnam stub	Шаблон:Vietnam-stub
模板:Reply to	Шаблон:Reply to
惡病質	Кахексия
模块:Arguments	Модуль:Arguments
特殊:最近更改	Служебная:Свежие правки
模块:HtmlBuilder	Модуль:HtmlBuilder
模块:String	Модуль:String
模块:InfoboxImage	Модуль:InfoboxImage
模块:Navbox	Модуль:Navbox
模块:Infobox	Модуль:Карточка
馬來西亞航空17號班機空难	Катастрофа Boeing 777 в Донецкой области
雨傘運動	Протесты в Гонконге в 2014 году
